"report_period","foreign_region","foreign_country","uk_apt","foreign_apt","Total","Scheduled","Charter"
2015,"WESTERN EUROPE-EU","AUSTRIA","GATWICK","GRAZ",622,0,622
2015,"WESTERN EUROPE-EU","AUSTRIA","GATWICK","INNSBRUCK",189040,128271,60769
2015,"WESTERN EUROPE-EU","AUSTRIA","GATWICK","SALZBURG",141008,110710,30298
2015,"WESTERN EUROPE-EU","AUSTRIA","GATWICK","VIENNA",203630,203529,101
2015,"WESTERN EUROPE-EU","AUSTRIA","HEATHROW","SALZBURG",1585,1585,0
2015,"WESTERN EUROPE-EU","AUSTRIA","HEATHROW","VIENNA",787631,787631,0
2015,"WESTERN EUROPE-EU","AUSTRIA","LUTON","GRAZ",613,0,613
2015,"WESTERN EUROPE-EU","AUSTRIA","LUTON","INNSBRUCK",850,782,68
2015,"WESTERN EUROPE-EU","AUSTRIA","LUTON","KLAGENFURT",75,0,75
2015,"WESTERN EUROPE-EU","AUSTRIA","LUTON","SALZBURG",8614,4841,3773
2015,"WESTERN EUROPE-EU","AUSTRIA","LUTON","VIENNA",5498,5434,64
2015,"WESTERN EUROPE-EU","AUSTRIA","STANSTED","INNSBRUCK",8995,0,8995
2015,"WESTERN EUROPE-EU","AUSTRIA","STANSTED","LINZ",45734,45734,0
2015,"WESTERN EUROPE-EU","AUSTRIA","STANSTED","SALZBURG",97864,93705,4159
2015,"WESTERN EUROPE-EU","AUSTRIA","STANSTED","VIENNA",13766,13663,103
2015,"WESTERN EUROPE-EU","BELGIUM","GATWICK","BRUSSELS",93791,93791,0
2015,"WESTERN EUROPE-EU","BELGIUM","HEATHROW","BRUSSELS",628148,628148,0
2015,"WESTERN EUROPE-EU","BELGIUM","LONDON CITY","ANTWERP",58548,58548,0
2015,"WESTERN EUROPE-EU","BELGIUM","LUTON","ANTWERP",0,0,0
2015,"WESTERN EUROPE-EU","BELGIUM","LUTON","BRUSSELS",168,0,168
2015,"WESTERN EUROPE-EU","BELGIUM","LUTON","CHARLEROI",0,0,0
2015,"WESTERN EUROPE-EU","BELGIUM","LUTON","LIEGE",99,0,99
2015,"WESTERN EUROPE-EU","BELGIUM","LUTON","OSTEND",74,0,74
2015,"WESTERN EUROPE-EU","BELGIUM","SOUTHEND","ANTWERP",663,663,0
2015,"WESTERN EUROPE-EU","BELGIUM","STANSTED","BRUSSELS",98,0,98
2015,"WESTERN EUROPE-EU","CROATIA","GATWICK","DUBROVNIK",199741,199109,632
2015,"WESTERN EUROPE-EU","CROATIA","GATWICK","PULA",31582,16226,15356
2015,"WESTERN EUROPE-EU","CROATIA","GATWICK","SPLIT",124661,118420,6241
2015,"WESTERN EUROPE-EU","CROATIA","GATWICK","ZAGREB",0,0,0
2015,"WESTERN EUROPE-EU","CROATIA","HEATHROW","RIJEKA",89,89,0
2015,"WESTERN EUROPE-EU","CROATIA","HEATHROW","SPLIT",18445,18445,0
2015,"WESTERN EUROPE-EU","CROATIA","HEATHROW","ZAGREB",181789,181479,310
2015,"WESTERN EUROPE-EU","CROATIA","LUTON","DUBROVNIK",0,0,0
2015,"WESTERN EUROPE-EU","CROATIA","LUTON","PULA",0,0,0
2015,"WESTERN EUROPE-EU","CROATIA","LUTON","SPLIT",49424,49424,0
2015,"WESTERN EUROPE-EU","CROATIA","LUTON","ZAGREB",194,0,194
2015,"WESTERN EUROPE-EU","CROATIA","STANSTED","DUBROVNIK",19137,19137,0
2015,"WESTERN EUROPE-EU","CROATIA","STANSTED","OSIJEK",20980,20980,0
2015,"WESTERN EUROPE-EU","CROATIA","STANSTED","PULA",22927,22927,0
2015,"WESTERN EUROPE-EU","CROATIA","STANSTED","RIJEKA",8670,8670,0
2015,"WESTERN EUROPE-EU","CROATIA","STANSTED","SPLIT",16002,16002,0
2015,"WESTERN EUROPE-EU","CROATIA","STANSTED","ZADAR",33211,33211,0
2015,"WESTERN EUROPE-EU","CYPRUS","GATWICK","LARNACA",273777,193429,80348
2015,"WESTERN EUROPE-EU","CYPRUS","GATWICK","PAPHOS",357614,248397,109217
2015,"WESTERN EUROPE-EU","CYPRUS","HEATHROW","LARNACA",279038,279038,0
2015,"WESTERN EUROPE-EU","CYPRUS","LUTON","LARNACA",53307,44367,8940
2015,"WESTERN EUROPE-EU","CYPRUS","LUTON","PAPHOS",77908,48363,29545
2015,"WESTERN EUROPE-EU","CYPRUS","STANSTED","LARNACA",2413,2287,126
2015,"WESTERN EUROPE-EU","CYPRUS","STANSTED","PAPHOS",156241,134665,21576
2015,"WESTERN EUROPE-EU","DENMARK","GATWICK","AALBORG",28221,28221,0
2015,"WESTERN EUROPE-EU","DENMARK","GATWICK","COPENHAGEN",724417,724417,0
2015,"WESTERN EUROPE-EU","DENMARK","HEATHROW","COPENHAGEN",997988,997988,0
2015,"WESTERN EUROPE-EU","DENMARK","LONDON CITY","BILLUND",23428,23428,0
2015,"WESTERN EUROPE-EU","DENMARK","LUTON","BILLUND",25,0,25
2015,"WESTERN EUROPE-EU","DENMARK","LUTON","COPENHAGEN",408929,408929,0
2015,"WESTERN EUROPE-EU","DENMARK","LUTON","ODENSE",46,0,46
2015,"WESTERN EUROPE-EU","DENMARK","LUTON","ROSKILDE",112,0,112
2015,"WESTERN EUROPE-EU","DENMARK","LUTON","SONDERBORG",0,0,0
2015,"WESTERN EUROPE-EU","DENMARK","STANSTED","AARHUS (TIRSTRUP)",90344,90344,0
2015,"WESTERN EUROPE-EU","DENMARK","STANSTED","BILLUND",258203,258203,0
2015,"WESTERN EUROPE-EU","DENMARK","STANSTED","COPENHAGEN",22551,22551,0
2015,"WESTERN EUROPE-EU","FINLAND","GATWICK","ENONTEKIO",4015,0,4015
2015,"WESTERN EUROPE-EU","FINLAND","GATWICK","HELSINKI",183174,183174,0
2015,"WESTERN EUROPE-EU","FINLAND","GATWICK","IVALO",8738,0,8738
2015,"WESTERN EUROPE-EU","FINLAND","GATWICK","KITTILA",19581,177,19404
2015,"WESTERN EUROPE-EU","FINLAND","GATWICK","KUUSAMO",3579,0,3579
2015,"WESTERN EUROPE-EU","FINLAND","GATWICK","ROVANIEMI",10721,0,10721
2015,"WESTERN EUROPE-EU","FINLAND","GATWICK","TAMPERE",0,0,0
2015,"WESTERN EUROPE-EU","FINLAND","HEATHROW","HELSINKI",655532,655532,0
2015,"WESTERN EUROPE-EU","FINLAND","LUTON","ENONTEKIO",378,0,378
2015,"WESTERN EUROPE-EU","FINLAND","LUTON","IVALO",317,0,317
2015,"WESTERN EUROPE-EU","FINLAND","LUTON","KITTILA",62,0,62
2015,"WESTERN EUROPE-EU","FINLAND","LUTON","TAMPERE",59,0,59
2015,"WESTERN EUROPE-EU","FINLAND","STANSTED","ENONTEKIO",1634,0,1634
2015,"WESTERN EUROPE-EU","FINLAND","STANSTED","IVALO",1079,0,1079
2015,"WESTERN EUROPE-EU","FINLAND","STANSTED","ROVANIEMI",374,0,374
2015,"WESTERN EUROPE-EU","FINLAND","STANSTED","TAMPERE",42021,42021,0
2015,"WESTERN EUROPE-EU","FRANCE","GATWICK","AJACCIO",7290,7290,0
2015,"WESTERN EUROPE-EU","FRANCE","GATWICK","BASTIA",11313,10984,329
2015,"WESTERN EUROPE-EU","FRANCE","GATWICK","BIARRITZ",22046,22046,0
2015,"WESTERN EUROPE-EU","FRANCE","GATWICK","BORDEAUX",293052,292783,269
2015,"WESTERN EUROPE-EU","FRANCE","GATWICK","BREST",5592,5592,0
2015,"WESTERN EUROPE-EU","FRANCE","GATWICK","CANNES",0,0,0
2015,"WESTERN EUROPE-EU","FRANCE","GATWICK","CHAMBERY",45671,0,45671
2015,"WESTERN EUROPE-EU","FRANCE","GATWICK","CLERMONT FERRAND",1012,0,1012
2015,"WESTERN EUROPE-EU","FRANCE","GATWICK","FIGARI",8201,8201,0
2015,"WESTERN EUROPE-EU","FRANCE","GATWICK","GRENOBLE",121002,40325,80677
2015,"WESTERN EUROPE-EU","FRANCE","GATWICK","LA ROCHELLE",22242,22242,0
2015,"WESTERN EUROPE-EU","FRANCE","GATWICK","LILLE",144,0,144
2015,"WESTERN EUROPE-EU","FRANCE","GATWICK","LYON",215791,186746,29045
2015,"WESTERN EUROPE-EU","FRANCE","GATWICK","MARSEILLE",149453,149031,422
2015,"WESTERN EUROPE-EU","FRANCE","GATWICK","MONTPELLIER",117963,117963,0
2015,"WESTERN EUROPE-EU","FRANCE","GATWICK","NANTES",117851,117536,315
2015,"WESTERN EUROPE-EU","FRANCE","GATWICK","NICE",649357,647242,2115
2015,"WESTERN EUROPE-EU","FRANCE","GATWICK","PARIS (CHARLES DE GAULLE)",206338,206128,210
2015,"WESTERN EUROPE-EU","FRANCE","GATWICK","PARIS (LE BOURGET)",705,0,705
2015,"WESTERN EUROPE-EU","FRANCE","GATWICK","STRASBOURG",49387,49387,0
2015,"WESTERN EUROPE-EU","FRANCE","GATWICK","TARBES-LOURDES INTERNATIONAL",1730,0,1730
2015,"WESTERN EUROPE-EU","FRANCE","GATWICK","TOULON / HYERES",751,0,751
2015,"WESTERN EUROPE-EU","FRANCE","GATWICK","TOULOUSE (BLAGNAC)",274756,266760,7996
2015,"WESTERN EUROPE-EU","FRANCE","HEATHROW","BASTIA",5299,0,5299
2015,"WESTERN EUROPE-EU","FRANCE","HEATHROW","FIGARI",3132,0,3132
2015,"WESTERN EUROPE-EU","FRANCE","HEATHROW","GRENOBLE",6044,0,6044
2015,"WESTERN EUROPE-EU","FRANCE","HEATHROW","LYON",232631,232631,0
2015,"WESTERN EUROPE-EU","FRANCE","HEATHROW","MARSEILLE",228226,228226,0
2015,"WESTERN EUROPE-EU","FRANCE","HEATHROW","NICE",497290,496805,485
2015,"WESTERN EUROPE-EU","FRANCE","HEATHROW","PARIS (CHARLES DE GAULLE)",1252777,1252777,0
2015,"WESTERN EUROPE-EU","FRANCE","HEATHROW","PARIS (LE BOURGET)",33,0,33
2015,"WESTERN EUROPE-EU","FRANCE","HEATHROW","PARIS (ORLY)",321622,321622,0
2015,"WESTERN EUROPE-EU","FRANCE","HEATHROW","TOULOUSE (BLAGNAC)",259567,259567,0
2015,"WESTERN EUROPE-EU","FRANCE","LONDON CITY","ANGERS- MARCE",3285,3285,0
2015,"WESTERN EUROPE-EU","FRANCE","LONDON CITY","AVIGNON",1400,1400,0
2015,"WESTERN EUROPE-EU","FRANCE","LONDON CITY","BREST",0,0,0
2015,"WESTERN EUROPE-EU","FRANCE","LONDON CITY","BRIVE-LA-GAILLARDE",2445,2445,0
2015,"WESTERN EUROPE-EU","FRANCE","LONDON CITY","CHAMBERY",6019,6019,0
2015,"WESTERN EUROPE-EU","FRANCE","LONDON CITY","DEAUVILLE",0,0,0
2015,"WESTERN EUROPE-EU","FRANCE","LONDON CITY","MARSEILLE",20,0,20
2015,"WESTERN EUROPE-EU","FRANCE","LONDON CITY","NANTES",22281,22281,0
2015,"WESTERN EUROPE-EU","FRANCE","LONDON CITY","NICE",32438,32438,0
2015,"WESTERN EUROPE-EU","FRANCE","LONDON CITY","PARIS (CHARLES DE GAULLE)",0,0,0
2015,"WESTERN EUROPE-EU","FRANCE","LONDON CITY","PARIS (ORLY)",123214,123214,0
2015,"WESTERN EUROPE-EU","FRANCE","LONDON CITY","QUIMPER",4539,4539,0
2015,"WESTERN EUROPE-EU","FRANCE","LONDON CITY","RENNES",0,0,0
2015,"WESTERN EUROPE-EU","FRANCE","LONDON CITY","TOULON / HYERES",4252,4252,0
2015,"WESTERN EUROPE-EU","FRANCE","LUTON","BEZIERS",56284,56284,0
2015,"WESTERN EUROPE-EU","FRANCE","LUTON","BIARRITZ",0,0,0
2015,"WESTERN EUROPE-EU","FRANCE","LUTON","BORDEAUX",75177,73782,1395
2015,"WESTERN EUROPE-EU","FRANCE","LUTON","CHAMBERY",327,0,327
2015,"WESTERN EUROPE-EU","FRANCE","LUTON","CLERMONT FERRAND",3164,0,3164
2015,"WESTERN EUROPE-EU","FRANCE","LUTON","DEAUVILLE",12,0,12
2015,"WESTERN EUROPE-EU","FRANCE","LUTON","GRENOBLE",5382,5382,0
2015,"WESTERN EUROPE-EU","FRANCE","LUTON","LILLE",86,0,86
2015,"WESTERN EUROPE-EU","FRANCE","LUTON","LYON",86499,85519,980
2015,"WESTERN EUROPE-EU","FRANCE","LUTON","LYON(BRON)",133,0,133
2015,"WESTERN EUROPE-EU","FRANCE","LUTON","MARSEILLE",0,0,0
2015,"WESTERN EUROPE-EU","FRANCE","LUTON","METZ",10,0,10
2015,"WESTERN EUROPE-EU","FRANCE","LUTON","MONTPELLIER",16753,16670,83
2015,"WESTERN EUROPE-EU","FRANCE","LUTON","NANTES",0,0,0
2015,"WESTERN EUROPE-EU","FRANCE","LUTON","NICE",153468,152405,1063
2015,"WESTERN EUROPE-EU","FRANCE","LUTON","NIMES",78292,78292,0
2015,"WESTERN EUROPE-EU","FRANCE","LUTON","PARIS (CHARLES DE GAULLE)",267014,266971,43
2015,"WESTERN EUROPE-EU","FRANCE","LUTON","PARIS (LE BOURGET)",223,0,223
2015,"WESTERN EUROPE-EU","FRANCE","LUTON","PAU",369,0,369
2015,"WESTERN EUROPE-EU","FRANCE","LUTON","PERPIGNAN",0,0,0
2015,"WESTERN EUROPE-EU","FRANCE","LUTON","POITIERS",38,0,38
2015,"WESTERN EUROPE-EU","FRANCE","LUTON","ST ETIENNE",204,0,204
2015,"WESTERN EUROPE-EU","FRANCE","LUTON","STRASBOURG",9,0,9
2015,"WESTERN EUROPE-EU","FRANCE","LUTON","TOULON / HYERES",1046,0,1046
2015,"WESTERN EUROPE-EU","FRANCE","LUTON","TOULOUSE (BLAGNAC)",1452,0,1452
2015,"WESTERN EUROPE-EU","FRANCE","LUTON","VARY (CHALONS SUR MARNE)",0,0,0
2015,"WESTERN EUROPE-EU","FRANCE","SOUTHEND","CAEN",10363,10363,0
2015,"WESTERN EUROPE-EU","FRANCE","SOUTHEND","LYON",498,498,0
2015,"WESTERN EUROPE-EU","FRANCE","SOUTHEND","PARIS (LE BOURGET)",0,0,0
2015,"WESTERN EUROPE-EU","FRANCE","SOUTHEND","PAU",366,0,366
2015,"WESTERN EUROPE-EU","FRANCE","SOUTHEND","RENNES",34468,34468,0
2015,"WESTERN EUROPE-EU","FRANCE","STANSTED","BERGERAC",105474,105474,0
2015,"WESTERN EUROPE-EU","FRANCE","STANSTED","BIARRITZ",98115,98115,0
2015,"WESTERN EUROPE-EU","FRANCE","STANSTED","BORDEAUX",46757,46574,183
2015,"WESTERN EUROPE-EU","FRANCE","STANSTED","BRIVE-LA-GAILLARDE",18548,18548,0
2015,"WESTERN EUROPE-EU","FRANCE","STANSTED","CALVI",4369,0,4369
2015,"WESTERN EUROPE-EU","FRANCE","STANSTED","CARCASSONNE",100016,100016,0
2015,"WESTERN EUROPE-EU","FRANCE","STANSTED","CHAMBERY",19143,0,19143
2015,"WESTERN EUROPE-EU","FRANCE","STANSTED","CLERMONT FERRAND",5894,5894,0
2015,"WESTERN EUROPE-EU","FRANCE","STANSTED","DEAUVILLE",17612,17612,0
2015,"WESTERN EUROPE-EU","FRANCE","STANSTED","DINARD",86654,86654,0
2015,"WESTERN EUROPE-EU","FRANCE","STANSTED","GRENOBLE",20048,16624,3424
2015,"WESTERN EUROPE-EU","FRANCE","STANSTED","LA ROCHELLE",60970,60970,0
2015,"WESTERN EUROPE-EU","FRANCE","STANSTED","LIMOGES",94681,94681,0
2015,"WESTERN EUROPE-EU","FRANCE","STANSTED","LYON",584,0,584
2015,"WESTERN EUROPE-EU","FRANCE","STANSTED","MARSEILLE",140144,140144,0
2015,"WESTERN EUROPE-EU","FRANCE","STANSTED","NICE",65330,65206,124
2015,"WESTERN EUROPE-EU","FRANCE","STANSTED","PARIS (CHARLES DE GAULLE)",252,0,252
2015,"WESTERN EUROPE-EU","FRANCE","STANSTED","PAU",27,0,27
2015,"WESTERN EUROPE-EU","FRANCE","STANSTED","PERPIGNAN",59463,59463,0
2015,"WESTERN EUROPE-EU","FRANCE","STANSTED","POITIERS",59550,59550,0
2015,"WESTERN EUROPE-EU","FRANCE","STANSTED","RODEZ",26382,26382,0
2015,"WESTERN EUROPE-EU","FRANCE","STANSTED","STRASBOURG",42579,42579,0
2015,"WESTERN EUROPE-EU","FRANCE","STANSTED","TARBES-LOURDES INTERNATIONAL",42951,36811,6140
2015,"WESTERN EUROPE-EU","FRANCE","STANSTED","TOULON / HYERES",0,0,0
2015,"WESTERN EUROPE-EU","FRANCE","STANSTED","TOURS",57072,57072,0
2015,"WESTERN EUROPE-EU","GERMANY","GATWICK","BERLIN (SCHONEFELD)",523645,522208,1437
2015,"WESTERN EUROPE-EU","GERMANY","GATWICK","BERLIN (TEGEL)",213,0,213
2015,"WESTERN EUROPE-EU","GERMANY","GATWICK","COLOGNE BONN",103592,103570,22
2015,"WESTERN EUROPE-EU","GERMANY","GATWICK","DUSSELDORF",93910,93910,0
2015,"WESTERN EUROPE-EU","GERMANY","GATWICK","ERFURT",9308,9308,0
2015,"WESTERN EUROPE-EU","GERMANY","GATWICK","FRIEDRICHSHAFEN",19294,12270,7024
2015,"WESTERN EUROPE-EU","GERMANY","GATWICK","HAMBURG",174641,174641,0
2015,"WESTERN EUROPE-EU","GERMANY","GATWICK","LEIPZIG",133,0,133
2015,"WESTERN EUROPE-EU","GERMANY","GATWICK","MUNICH",231744,231532,212
2015,"WESTERN EUROPE-EU","GERMANY","GATWICK","MUNSTER-OSNABRUCK",0,0,0
2015,"WESTERN EUROPE-EU","GERMANY","GATWICK","STUTTGART",103540,103540,0
2015,"WESTERN EUROPE-EU","GERMANY","HEATHROW","BERLIN (TEGEL)",822496,822496,0
2015,"WESTERN EUROPE-EU","GERMANY","HEATHROW","COLOGNE BONN",168657,168657,0
2015,"WESTERN EUROPE-EU","GERMANY","HEATHROW","DUSSELDORF",663142,663142,0
2015,"WESTERN EUROPE-EU","GERMANY","HEATHROW","FRANKFURT MAIN",1530986,1530986,0
2015,"WESTERN EUROPE-EU","GERMANY","HEATHROW","FRIEDRICHSHAFEN",797,0,797
2015,"WESTERN EUROPE-EU","GERMANY","HEATHROW","HAMBURG",577653,577653,0
2015,"WESTERN EUROPE-EU","GERMANY","HEATHROW","HANOVER",199781,199781,0
2015,"WESTERN EUROPE-EU","GERMANY","HEATHROW","MUNICH",1230618,1230618,0
2015,"WESTERN EUROPE-EU","GERMANY","HEATHROW","STUTTGART",333656,333656,0
2015,"WESTERN EUROPE-EU","GERMANY","LONDON CITY","DRESDEN",14097,14097,0
2015,"WESTERN EUROPE-EU","GERMANY","LONDON CITY","DUSSELDORF",59830,59830,0
2015,"WESTERN EUROPE-EU","GERMANY","LONDON CITY","FRANKFURT MAIN",240973,240973,0
2015,"WESTERN EUROPE-EU","GERMANY","LONDON CITY","HAMBURG",12455,12455,0
2015,"WESTERN EUROPE-EU","GERMANY","LONDON CITY","MUNSTER-OSNABRUCK",0,0,0
2015,"WESTERN EUROPE-EU","GERMANY","LONDON CITY","NUREMBERG",0,0,0
2015,"WESTERN EUROPE-EU","GERMANY","LONDON CITY","PADERBORN",0,0,0
2015,"WESTERN EUROPE-EU","GERMANY","LUTON","BERLIN (SCHONEFELD)",182834,182458,376
2015,"WESTERN EUROPE-EU","GERMANY","LUTON","BERLIN (TEGEL)",149,0,149
2015,"WESTERN EUROPE-EU","GERMANY","LUTON","COLOGNE BONN",447,0,447
2015,"WESTERN EUROPE-EU","GERMANY","LUTON","DORTMUND",108709,108709,0
2015,"WESTERN EUROPE-EU","GERMANY","LUTON","DUSSELDORF",0,0,0
2015,"WESTERN EUROPE-EU","GERMANY","LUTON","FRANKFURT MAIN",42,0,42
2015,"WESTERN EUROPE-EU","GERMANY","LUTON","FRIEDRICHSHAFEN",157,0,157
2015,"WESTERN EUROPE-EU","GERMANY","LUTON","HAMBURG",84039,84003,36
2015,"WESTERN EUROPE-EU","GERMANY","LUTON","HANOVER",452,0,452
2015,"WESTERN EUROPE-EU","GERMANY","LUTON","INGOLSTADT-MANCHING",41,0,41
2015,"WESTERN EUROPE-EU","GERMANY","LUTON","KARLSRUHE/BADEN BADEN",3,0,3
2015,"WESTERN EUROPE-EU","GERMANY","LUTON","LEIPZIG",0,0,0
2015,"WESTERN EUROPE-EU","GERMANY","LUTON","MAGDEBURG COCHSTEDT",11,0,11
2015,"WESTERN EUROPE-EU","GERMANY","LUTON","MUNICH",61626,61162,464
2015,"WESTERN EUROPE-EU","GERMANY","LUTON","MUNSTER-OSNABRUCK",90,0,90
2015,"WESTERN EUROPE-EU","GERMANY","LUTON","NUREMBERG",24,0,24
2015,"WESTERN EUROPE-EU","GERMANY","LUTON","PADERBORN",102,0,102
2015,"WESTERN EUROPE-EU","GERMANY","SOUTHEND","BERLIN (SCHONEFELD)",54904,54904,0
2015,"WESTERN EUROPE-EU","GERMANY","SOUTHEND","MUNSTER-OSNABRUCK",13761,13761,0
2015,"WESTERN EUROPE-EU","GERMANY","STANSTED","BERLIN (SCHONEFELD)",331488,331488,0
2015,"WESTERN EUROPE-EU","GERMANY","STANSTED","BERLIN (TEGEL)",94,0,94
2015,"WESTERN EUROPE-EU","GERMANY","STANSTED","BREMEN",195930,195854,76
2015,"WESTERN EUROPE-EU","GERMANY","STANSTED","COLOGNE BONN",389788,389788,0
2015,"WESTERN EUROPE-EU","GERMANY","STANSTED","DORTMUND",109469,109469,0
2015,"WESTERN EUROPE-EU","GERMANY","STANSTED","DUSSELDORF",35518,35239,279
2015,"WESTERN EUROPE-EU","GERMANY","STANSTED","HAHN",237194,237194,0
2015,"WESTERN EUROPE-EU","GERMANY","STANSTED","HAMBURG",97,0,97
2015,"WESTERN EUROPE-EU","GERMANY","STANSTED","HANOVER",77445,77445,0
2015,"WESTERN EUROPE-EU","GERMANY","STANSTED","KARLSRUHE/BADEN BADEN",105207,105207,0
2015,"WESTERN EUROPE-EU","GERMANY","STANSTED","LEIPZIG",59259,59259,0
2015,"WESTERN EUROPE-EU","GERMANY","STANSTED","MEMMINGEN ALLGAU",103681,103681,0
2015,"WESTERN EUROPE-EU","GERMANY","STANSTED","MUNICH",107084,105417,1667
2015,"WESTERN EUROPE-EU","GERMANY","STANSTED","MUNSTER-OSNABRUCK",89,0,89
2015,"WESTERN EUROPE-EU","GERMANY","STANSTED","NIEDERRHEIN",125665,125665,0
2015,"WESTERN EUROPE-EU","GERMANY","STANSTED","NUREMBERG",121858,121858,0
2015,"WESTERN EUROPE-EU","GERMANY","STANSTED","STUTTGART",69423,69382,41
2015,"WESTERN EUROPE-EU","GIBRALTAR","GATWICK","GIBRALTAR",133882,133882,0
2015,"WESTERN EUROPE-EU","GIBRALTAR","HEATHROW","GIBRALTAR",118688,118688,0
2015,"WESTERN EUROPE-EU","GIBRALTAR","LUTON","GIBRALTAR",60821,60821,0
2015,"WESTERN EUROPE-EU","GREECE","GATWICK","ATHENS",186693,186693,0
2015,"WESTERN EUROPE-EU","GREECE","GATWICK","CHANIA",73421,49741,23680
2015,"WESTERN EUROPE-EU","GREECE","GATWICK","CORFU",227753,125924,101829
2015,"WESTERN EUROPE-EU","GREECE","GATWICK","HERAKLION",286863,186455,100408
2015,"WESTERN EUROPE-EU","GREECE","GATWICK","KALAMATA",38093,31141,6952
2015,"WESTERN EUROPE-EU","GREECE","GATWICK","KAVALA",13544,0,13544
2015,"WESTERN EUROPE-EU","GREECE","GATWICK","KEFALLINIA",114962,50202,64760
2015,"WESTERN EUROPE-EU","GREECE","GATWICK","KOS",104173,26934,77239
2015,"WESTERN EUROPE-EU","GREECE","GATWICK","LEMNOS",162,0,162
2015,"WESTERN EUROPE-EU","GREECE","GATWICK","MIKONOS",75402,67696,7706
2015,"WESTERN EUROPE-EU","GREECE","GATWICK","MYTILINI",9972,0,9972
2015,"WESTERN EUROPE-EU","GREECE","GATWICK","PATRAS",0,0,0
2015,"WESTERN EUROPE-EU","GREECE","GATWICK","PREVEZA",79610,31021,48589
2015,"WESTERN EUROPE-EU","GREECE","GATWICK","RHODES",165510,75633,89877
2015,"WESTERN EUROPE-EU","GREECE","GATWICK","SALONIKA",137430,127335,10095
2015,"WESTERN EUROPE-EU","GREECE","GATWICK","SAMOS",11248,0,11248
2015,"WESTERN EUROPE-EU","GREECE","GATWICK","SKIATHOS",47191,0,47191
2015,"WESTERN EUROPE-EU","GREECE","GATWICK","THIRA (SANTORINI)",101313,81922,19391
2015,"WESTERN EUROPE-EU","GREECE","GATWICK","VOLOS",4973,0,4973
2015,"WESTERN EUROPE-EU","GREECE","GATWICK","ZAKINTHOS",159235,52736,106499
2015,"WESTERN EUROPE-EU","GREECE","HEATHROW","ATHENS",699094,697046,2048
2015,"WESTERN EUROPE-EU","GREECE","HEATHROW","CORFU",25663,21399,4264
2015,"WESTERN EUROPE-EU","GREECE","HEATHROW","KALAMATA",10401,0,10401
2015,"WESTERN EUROPE-EU","GREECE","HEATHROW","KOS",20708,11142,9566
2015,"WESTERN EUROPE-EU","GREECE","HEATHROW","LEMNOS",14644,0,14644
2015,"WESTERN EUROPE-EU","GREECE","HEATHROW","MIKONOS",10213,10213,0
2015,"WESTERN EUROPE-EU","GREECE","HEATHROW","PREVEZA",6216,0,6216
2015,"WESTERN EUROPE-EU","GREECE","HEATHROW","RHODES",11633,0,11633
2015,"WESTERN EUROPE-EU","GREECE","HEATHROW","THIRA (SANTORINI)",15511,15511,0
2015,"WESTERN EUROPE-EU","GREECE","LONDON CITY","MIKONOS",5440,5440,0
2015,"WESTERN EUROPE-EU","GREECE","LONDON CITY","THIRA (SANTORINI)",2513,2513,0
2015,"WESTERN EUROPE-EU","GREECE","LUTON","ATHENS",678,2,676
2015,"WESTERN EUROPE-EU","GREECE","LUTON","CORFU",51248,40037,11211
2015,"WESTERN EUROPE-EU","GREECE","LUTON","HERAKLION",30213,20739,9474
2015,"WESTERN EUROPE-EU","GREECE","LUTON","KEFALLINIA",7478,0,7478
2015,"WESTERN EUROPE-EU","GREECE","LUTON","MIKONOS",12662,12644,18
2015,"WESTERN EUROPE-EU","GREECE","LUTON","PATRAS",318,0,318
2015,"WESTERN EUROPE-EU","GREECE","LUTON","RHODES",16601,0,16601
2015,"WESTERN EUROPE-EU","GREECE","LUTON","SKIATHOS",8219,0,8219
2015,"WESTERN EUROPE-EU","GREECE","LUTON","ZAKINTHOS",17478,10047,7431
2015,"WESTERN EUROPE-EU","GREECE","STANSTED","ATHENS",247544,247544,0
2015,"WESTERN EUROPE-EU","GREECE","STANSTED","CHANIA",24724,24724,0
2015,"WESTERN EUROPE-EU","GREECE","STANSTED","CORFU",40476,23468,17008
2015,"WESTERN EUROPE-EU","GREECE","STANSTED","HERAKLION",15956,0,15956
2015,"WESTERN EUROPE-EU","GREECE","STANSTED","KALAMATA",0,0,0
2015,"WESTERN EUROPE-EU","GREECE","STANSTED","KEFALLINIA",26424,11443,14981
2015,"WESTERN EUROPE-EU","GREECE","STANSTED","KOS",38028,21784,16244
2015,"WESTERN EUROPE-EU","GREECE","STANSTED","PREVEZA",1882,0,1882
2015,"WESTERN EUROPE-EU","GREECE","STANSTED","RHODES",59726,34546,25180
2015,"WESTERN EUROPE-EU","GREECE","STANSTED","SALONIKA",117625,117212,413
2015,"WESTERN EUROPE-EU","GREECE","STANSTED","SKIATHOS",6082,0,6082
2015,"WESTERN EUROPE-EU","GREECE","STANSTED","THIRA (SANTORINI)",0,0,0
2015,"WESTERN EUROPE-EU","GREECE","STANSTED","ZAKINTHOS",20945,4,20941
2015,"WESTERN EUROPE-EU","IRISH REPUBLIC","GATWICK","CORK",118177,118177,0
2015,"WESTERN EUROPE-EU","IRISH REPUBLIC","GATWICK","DUBLIN",1083542,1083399,143
2015,"WESTERN EUROPE-EU","IRISH REPUBLIC","GATWICK","IRELAND WEST(KNOCK)",74658,74658,0
2015,"WESTERN EUROPE-EU","IRISH REPUBLIC","GATWICK","SHANNON",110125,110125,0
2015,"WESTERN EUROPE-EU","IRISH REPUBLIC","HEATHROW","CORK",384831,384831,0
2015,"WESTERN EUROPE-EU","IRISH REPUBLIC","HEATHROW","DUBLIN",1682855,1682855,0
2015,"WESTERN EUROPE-EU","IRISH REPUBLIC","HEATHROW","SHANNON",234066,234066,0
2015,"WESTERN EUROPE-EU","IRISH REPUBLIC","LONDON CITY","CORK",16961,16961,0
2015,"WESTERN EUROPE-EU","IRISH REPUBLIC","LONDON CITY","DUBLIN",451474,451474,0
2015,"WESTERN EUROPE-EU","IRISH REPUBLIC","LUTON","CORK",0,0,0
2015,"WESTERN EUROPE-EU","IRISH REPUBLIC","LUTON","DUBLIN",337349,336668,681
2015,"WESTERN EUROPE-EU","IRISH REPUBLIC","LUTON","IRELAND WEST(KNOCK)",126117,126117,0
2015,"WESTERN EUROPE-EU","IRISH REPUBLIC","LUTON","KERRY COUNTY",108083,107839,244
2015,"WESTERN EUROPE-EU","IRISH REPUBLIC","LUTON","SHANNON",0,0,0
2015,"WESTERN EUROPE-EU","IRISH REPUBLIC","LUTON","WATERFORD",23123,23090,33
2015,"WESTERN EUROPE-EU","IRISH REPUBLIC","SOUTHEND","DUBLIN",4450,4450,0
2015,"WESTERN EUROPE-EU","IRISH REPUBLIC","STANSTED","CORK",320140,320140,0
2015,"WESTERN EUROPE-EU","IRISH REPUBLIC","STANSTED","DUBLIN",879764,879574,190
2015,"WESTERN EUROPE-EU","IRISH REPUBLIC","STANSTED","IRELAND WEST(KNOCK)",157012,157012,0
2015,"WESTERN EUROPE-EU","IRISH REPUBLIC","STANSTED","KERRY COUNTY",72487,72487,0
2015,"WESTERN EUROPE-EU","IRISH REPUBLIC","STANSTED","SHANNON",231941,231941,0
2015,"WESTERN EUROPE-EU","ITALY","GATWICK","ALGHERO (FERTILIA)",9283,0,9283
2015,"WESTERN EUROPE-EU","ITALY","GATWICK","BARI (PALESE)",79979,79979,0
2015,"WESTERN EUROPE-EU","ITALY","GATWICK","BERGAMO",0,0,0
2015,"WESTERN EUROPE-EU","ITALY","GATWICK","BOLOGNA",90775,90089,686
2015,"WESTERN EUROPE-EU","ITALY","GATWICK","BRESCIA/MONTICHIARI",0,0,0
2015,"WESTERN EUROPE-EU","ITALY","GATWICK","BRINDISI",14449,14449,0
2015,"WESTERN EUROPE-EU","ITALY","GATWICK","CAGLIARI (ELMAS)",20355,20355,0
2015,"WESTERN EUROPE-EU","ITALY","GATWICK","CATANIA (FONTANAROSSA)",179054,168270,10784
2015,"WESTERN EUROPE-EU","ITALY","GATWICK","FLORENCE",88196,88094,102
2015,"WESTERN EUROPE-EU","ITALY","GATWICK","GENOA",93027,87020,6007
2015,"WESTERN EUROPE-EU","ITALY","GATWICK","MILAN (LINATE)",146681,146681,0
2015,"WESTERN EUROPE-EU","ITALY","GATWICK","MILAN (MALPENSA)",528232,528232,0
2015,"WESTERN EUROPE-EU","ITALY","GATWICK","NAPLES",416099,376433,39666
2015,"WESTERN EUROPE-EU","ITALY","GATWICK","OLBIA",78789,78789,0
2015,"WESTERN EUROPE-EU","ITALY","GATWICK","PALERMO",59502,59502,0
2015,"WESTERN EUROPE-EU","ITALY","GATWICK","PISA",213521,213242,279
2015,"WESTERN EUROPE-EU","ITALY","GATWICK","ROME (CIAMPINO)",11757,11757,0
2015,"WESTERN EUROPE-EU","ITALY","GATWICK","ROME (FIUMICINO)",726151,725700,451
2015,"WESTERN EUROPE-EU","ITALY","GATWICK","TURIN",148961,121317,27644
2015,"WESTERN EUROPE-EU","ITALY","GATWICK","VENICE",657709,644180,13529
2015,"WESTERN EUROPE-EU","ITALY","GATWICK","VERONA VILLAFRANCA",282084,262505,19579
2015,"WESTERN EUROPE-EU","ITALY","HEATHROW","BOLOGNA",243953,243953,0
2015,"WESTERN EUROPE-EU","ITALY","HEATHROW","CAGLIARI (ELMAS)",12934,0,12934
2015,"WESTERN EUROPE-EU","ITALY","HEATHROW","FLORENCE",0,0,0
2015,"WESTERN EUROPE-EU","ITALY","HEATHROW","MILAN (LINATE)",672882,672882,0
2015,"WESTERN EUROPE-EU","ITALY","HEATHROW","MILAN (MALPENSA)",236022,236022,0
2015,"WESTERN EUROPE-EU","ITALY","HEATHROW","OLBIA",14999,9912,5087
2015,"WESTERN EUROPE-EU","ITALY","HEATHROW","PISA",104601,104601,0
2015,"WESTERN EUROPE-EU","ITALY","HEATHROW","ROME (FIUMICINO)",972111,968068,4043
2015,"WESTERN EUROPE-EU","ITALY","HEATHROW","VENICE",121326,119268,2058
2015,"WESTERN EUROPE-EU","ITALY","LONDON CITY","FLORENCE",95725,95725,0
2015,"WESTERN EUROPE-EU","ITALY","LONDON CITY","MILAN (LINATE)",164168,164168,0
2015,"WESTERN EUROPE-EU","ITALY","LONDON CITY","ROME (CIAMPINO)",85,85,0
2015,"WESTERN EUROPE-EU","ITALY","LONDON CITY","ROME (FIUMICINO)",45779,45779,0
2015,"WESTERN EUROPE-EU","ITALY","LONDON CITY","VENICE",15607,15607,0
2015,"WESTERN EUROPE-EU","ITALY","LUTON","ALGHERO (FERTILIA)",0,0,0
2015,"WESTERN EUROPE-EU","ITALY","LUTON","BOLOGNA",0,0,0
2015,"WESTERN EUROPE-EU","ITALY","LUTON","CATANIA (FONTANAROSSA)",41747,41711,36
2015,"WESTERN EUROPE-EU","ITALY","LUTON","CUNEO",71,0,71
2015,"WESTERN EUROPE-EU","ITALY","LUTON","FLORENCE",0,0,0
2015,"WESTERN EUROPE-EU","ITALY","LUTON","GROSETTO",0,0,0
2015,"WESTERN EUROPE-EU","ITALY","LUTON","MILAN (MALPENSA)",135219,134653,566
2015,"WESTERN EUROPE-EU","ITALY","LUTON","NAPLES",81108,72508,8600
2015,"WESTERN EUROPE-EU","ITALY","LUTON","OLBIA",12975,12805,170
2015,"WESTERN EUROPE-EU","ITALY","LUTON","PARMA",49,0,49
2015,"WESTERN EUROPE-EU","ITALY","LUTON","PISA",52240,52066,174
2015,"WESTERN EUROPE-EU","ITALY","LUTON","RIMINI",353,0,353
2015,"WESTERN EUROPE-EU","ITALY","LUTON","ROME (CIAMPINO)",10063,9995,68
2015,"WESTERN EUROPE-EU","ITALY","LUTON","ROME (FIUMICINO)",100941,100837,104
2015,"WESTERN EUROPE-EU","ITALY","LUTON","TREVISO",0,0,0
2015,"WESTERN EUROPE-EU","ITALY","LUTON","TRIESTE (RONCHI DEI LEGIONARI)",0,0,0
2015,"WESTERN EUROPE-EU","ITALY","LUTON","TURIN",285,0,285
2015,"WESTERN EUROPE-EU","ITALY","LUTON","VENICE",58904,58904,0
2015,"WESTERN EUROPE-EU","ITALY","LUTON","VERONA VILLAFRANCA",0,0,0
2015,"WESTERN EUROPE-EU","ITALY","SOUTHEND","ROME (CIAMPINO)",188,0,188
2015,"WESTERN EUROPE-EU","ITALY","SOUTHEND","VENICE",54318,54318,0
2015,"WESTERN EUROPE-EU","ITALY","STANSTED","ALGHERO (FERTILIA)",82963,82963,0
2015,"WESTERN EUROPE-EU","ITALY","STANSTED","ANCONA",124623,124623,0
2015,"WESTERN EUROPE-EU","ITALY","STANSTED","BARI (PALESE)",122615,122615,0
2015,"WESTERN EUROPE-EU","ITALY","STANSTED","BERGAMO",495005,495005,0
2015,"WESTERN EUROPE-EU","ITALY","STANSTED","BOLOGNA",180909,180642,267
2015,"WESTERN EUROPE-EU","ITALY","STANSTED","BRINDISI",76145,76145,0
2015,"WESTERN EUROPE-EU","ITALY","STANSTED","CAGLIARI (ELMAS)",79302,79302,0
2015,"WESTERN EUROPE-EU","ITALY","STANSTED","COMISO",34368,34368,0
2015,"WESTERN EUROPE-EU","ITALY","STANSTED","FLORENCE",0,0,0
2015,"WESTERN EUROPE-EU","ITALY","STANSTED","GENOA",84317,84317,0
2015,"WESTERN EUROPE-EU","ITALY","STANSTED","LAMETIA-TERME",54676,54676,0
2015,"WESTERN EUROPE-EU","ITALY","STANSTED","MILAN (LINATE)",0,0,0
2015,"WESTERN EUROPE-EU","ITALY","STANSTED","MILAN (MALPENSA)",16829,16829,0
2015,"WESTERN EUROPE-EU","ITALY","STANSTED","NAPLES",163142,162852,290
2015,"WESTERN EUROPE-EU","ITALY","STANSTED","OLBIA",3013,2308,705
2015,"WESTERN EUROPE-EU","ITALY","STANSTED","PALERMO",107412,107412,0
2015,"WESTERN EUROPE-EU","ITALY","STANSTED","PARMA",50491,50491,0
2015,"WESTERN EUROPE-EU","ITALY","STANSTED","PERUGIA",92396,92396,0
2015,"WESTERN EUROPE-EU","ITALY","STANSTED","PESCARA",101336,101336,0
2015,"WESTERN EUROPE-EU","ITALY","STANSTED","PISA",333111,332962,149
2015,"WESTERN EUROPE-EU","ITALY","STANSTED","ROME (CIAMPINO)",515514,515514,0
2015,"WESTERN EUROPE-EU","ITALY","STANSTED","ROME (FIUMICINO)",1234,0,1234
2015,"WESTERN EUROPE-EU","ITALY","STANSTED","TREVISO",266219,266219,0
2015,"WESTERN EUROPE-EU","ITALY","STANSTED","TRIESTE (RONCHI DEI LEGIONARI)",106900,106900,0
2015,"WESTERN EUROPE-EU","ITALY","STANSTED","TURIN",132979,127621,5358
2015,"WESTERN EUROPE-EU","ITALY","STANSTED","VENICE",0,0,0
2015,"WESTERN EUROPE-EU","ITALY","STANSTED","VERONA VILLAFRANCA",7376,7376,0
2015,"WESTERN EUROPE-EU","LUXEMBOURG","GATWICK","LUXEMBOURG",61460,61460,0
2015,"WESTERN EUROPE-EU","LUXEMBOURG","HEATHROW","LUXEMBOURG",145659,145659,0
2015,"WESTERN EUROPE-EU","LUXEMBOURG","LONDON CITY","LUXEMBOURG",186941,186913,28
2015,"WESTERN EUROPE-EU","LUXEMBOURG","LUTON","LUXEMBOURG",0,0,0
2015,"WESTERN EUROPE-EU","LUXEMBOURG","STANSTED","LUXEMBOURG",1134,1134,0
2015,"WESTERN EUROPE-EU","MALTA","GATWICK","MALTA",341116,317514,23602
2015,"WESTERN EUROPE-EU","MALTA","HEATHROW","MALTA",189409,189409,0
2015,"WESTERN EUROPE-EU","MALTA","LUTON","MALTA",116114,116100,14
2015,"WESTERN EUROPE-EU","MALTA","STANSTED","MALTA",68195,67906,289
2015,"WESTERN EUROPE-EU","NETHERLANDS","GATWICK","AMSTERDAM",977713,976835,878
2015,"WESTERN EUROPE-EU","NETHERLANDS","HEATHROW","AMSTERDAM",1587605,1587605,0
2015,"WESTERN EUROPE-EU","NETHERLANDS","HEATHROW","EINDHOVEN",2,0,2
2015,"WESTERN EUROPE-EU","NETHERLANDS","HEATHROW","ROTTERDAM",22285,22285,0
2015,"WESTERN EUROPE-EU","NETHERLANDS","LONDON CITY","AMSTERDAM",488104,488104,0
2015,"WESTERN EUROPE-EU","NETHERLANDS","LONDON CITY","ROTTERDAM",208725,208725,0
2015,"WESTERN EUROPE-EU","NETHERLANDS","LUTON","AMSTERDAM",418006,417643,363
2015,"WESTERN EUROPE-EU","NETHERLANDS","LUTON","MAASTRICHT",121,0,121
2015,"WESTERN EUROPE-EU","NETHERLANDS","LUTON","ROTTERDAM",10,0,10
2015,"WESTERN EUROPE-EU","NETHERLANDS","SOUTHEND","AMSTERDAM",214462,214462,0
2015,"WESTERN EUROPE-EU","NETHERLANDS","SOUTHEND","GRONINGEN",21505,21505,0
2015,"WESTERN EUROPE-EU","NETHERLANDS","SOUTHEND","MAASTRICHT",205,205,0
2015,"WESTERN EUROPE-EU","NETHERLANDS","STANSTED","AMSTERDAM",300571,299953,618
2015,"WESTERN EUROPE-EU","NETHERLANDS","STANSTED","EINDHOVEN",242424,242424,0
2015,"WESTERN EUROPE-EU","NETHERLANDS","STANSTED","MAASTRICHT",0,0,0
2015,"WESTERN EUROPE-EU","PORTUGAL(EXCLUDING MADEIRA)","GATWICK","AZORES PONTA DELGADA",5855,5855,0
2015,"WESTERN EUROPE-EU","PORTUGAL(EXCLUDING MADEIRA)","GATWICK","FARO",749514,722096,27418
2015,"WESTERN EUROPE-EU","PORTUGAL(EXCLUDING MADEIRA)","GATWICK","LISBON",302884,302884,0
2015,"WESTERN EUROPE-EU","PORTUGAL(EXCLUDING MADEIRA)","GATWICK","OPORTO (PORTUGAL)",239742,239634,108
2015,"WESTERN EUROPE-EU","PORTUGAL(EXCLUDING MADEIRA)","HEATHROW","AZORES SANTA MARIA",146,0,146
2015,"WESTERN EUROPE-EU","PORTUGAL(EXCLUDING MADEIRA)","HEATHROW","FARO",17019,17019,0
2015,"WESTERN EUROPE-EU","PORTUGAL(EXCLUDING MADEIRA)","HEATHROW","LISBON",768043,768043,0
2015,"WESTERN EUROPE-EU","PORTUGAL(EXCLUDING MADEIRA)","HEATHROW","OPORTO (PORTUGAL)",14343,14343,0
2015,"WESTERN EUROPE-EU","PORTUGAL(EXCLUDING MADEIRA)","LONDON CITY","FARO",4815,4815,0
2015,"WESTERN EUROPE-EU","PORTUGAL(EXCLUDING MADEIRA)","LUTON","FARO",220089,199788,20301
2015,"WESTERN EUROPE-EU","PORTUGAL(EXCLUDING MADEIRA)","LUTON","LISBON",163959,163516,443
2015,"WESTERN EUROPE-EU","PORTUGAL(EXCLUDING MADEIRA)","LUTON","OPORTO (PORTUGAL)",30405,29878,527
2015,"WESTERN EUROPE-EU","PORTUGAL(EXCLUDING MADEIRA)","SOUTHEND","FARO",93956,93956,0
2015,"WESTERN EUROPE-EU","PORTUGAL(EXCLUDING MADEIRA)","STANSTED","AZORES PONTA DELGADA",12275,12275,0
2015,"WESTERN EUROPE-EU","PORTUGAL(EXCLUDING MADEIRA)","STANSTED","FARO",183016,171794,11222
2015,"WESTERN EUROPE-EU","PORTUGAL(EXCLUDING MADEIRA)","STANSTED","LISBON",369514,369133,381
2015,"WESTERN EUROPE-EU","PORTUGAL(EXCLUDING MADEIRA)","STANSTED","OPORTO (PORTUGAL)",265238,265141,97
2015,"WESTERN EUROPE-EU","PORTUGAL(MADEIRA)","GATWICK","FUNCHAL",223670,202210,21460
2015,"WESTERN EUROPE-EU","PORTUGAL(MADEIRA)","GATWICK","PORTO SANTO",9241,0,9241
2015,"WESTERN EUROPE-EU","PORTUGAL(MADEIRA)","HEATHROW","FUNCHAL",9675,9675,0
2015,"WESTERN EUROPE-EU","PORTUGAL(MADEIRA)","LUTON","FUNCHAL",8931,0,8931
2015,"WESTERN EUROPE-EU","PORTUGAL(MADEIRA)","STANSTED","FUNCHAL",0,0,0
2015,"WESTERN EUROPE-EU","SLOVENIA","GATWICK","LJUBLJANA",7547,7547,0
2015,"WESTERN EUROPE-EU","SLOVENIA","GATWICK","MARIBOR",0,0,0
2015,"WESTERN EUROPE-EU","SLOVENIA","LUTON","LJUBLJANA",52729,52212,517
2015,"WESTERN EUROPE-EU","SLOVENIA","LUTON","MARIBOR",100,0,100
2015,"WESTERN EUROPE-EU","SLOVENIA","SOUTHEND","MARIBOR",7087,7087,0
2015,"WESTERN EUROPE-EU","SLOVENIA","STANSTED","LJUBLJANA",89441,89441,0
2015,"WESTERN EUROPE-EU","SPAIN","GATWICK","A CORUNA",173,173,0
2015,"WESTERN EUROPE-EU","SPAIN","GATWICK","ALICANTE",760840,728413,32427
2015,"WESTERN EUROPE-EU","SPAIN","GATWICK","ALMERIA",91544,83148,8396
2015,"WESTERN EUROPE-EU","SPAIN","GATWICK","BARCELONA",1338598,1338206,392
2015,"WESTERN EUROPE-EU","SPAIN","GATWICK","BILBAO",52925,52177,748
2015,"WESTERN EUROPE-EU","SPAIN","GATWICK","BURGOS",328,0,328
2015,"WESTERN EUROPE-EU","SPAIN","GATWICK","GIRONA",20767,0,20767
2015,"WESTERN EUROPE-EU","SPAIN","GATWICK","IBIZA",298099,216852,81247
2015,"WESTERN EUROPE-EU","SPAIN","GATWICK","JEREZ",9192,0,9192
2015,"WESTERN EUROPE-EU","SPAIN","GATWICK","LIEIDA",6885,0,6885
2015,"WESTERN EUROPE-EU","SPAIN","GATWICK","MADRID",906550,906270,280
2015,"WESTERN EUROPE-EU","SPAIN","GATWICK","MAHON",243513,150196,93317
2015,"WESTERN EUROPE-EU","SPAIN","GATWICK","MALAGA",1041356,996226,45130
2015,"WESTERN EUROPE-EU","SPAIN","GATWICK","MURCIA SAN JAVIER",131892,131892,0
2015,"WESTERN EUROPE-EU","SPAIN","GATWICK","PALMA DE MALLORCA",710848,517719,193129
2015,"WESTERN EUROPE-EU","SPAIN","GATWICK","PAMPLONA",140,0,140
2015,"WESTERN EUROPE-EU","SPAIN","GATWICK","REUS",36848,0,36848
2015,"WESTERN EUROPE-EU","SPAIN","GATWICK","SANTIAGO DE COMPOSTELA (SPAIN)",37141,37141,0
2015,"WESTERN EUROPE-EU","SPAIN","GATWICK","SEVILLE",188202,187967,235
2015,"WESTERN EUROPE-EU","SPAIN","GATWICK","VALENCIA",239090,238956,134
2015,"WESTERN EUROPE-EU","SPAIN","GATWICK","VALLADOLID",363,0,363
2015,"WESTERN EUROPE-EU","SPAIN","HEATHROW","A CORUNA",106154,106154,0
2015,"WESTERN EUROPE-EU","SPAIN","HEATHROW","ALICANTE",0,0,0
2015,"WESTERN EUROPE-EU","SPAIN","HEATHROW","BARCELONA",673519,673218,301
2015,"WESTERN EUROPE-EU","SPAIN","HEATHROW","BILBAO",157657,157657,0
2015,"WESTERN EUROPE-EU","SPAIN","HEATHROW","IBIZA",37479,37479,0
2015,"WESTERN EUROPE-EU","SPAIN","HEATHROW","MADRID",1321558,1321558,0
2015,"WESTERN EUROPE-EU","SPAIN","HEATHROW","MALAGA",19514,19514,0
2015,"WESTERN EUROPE-EU","SPAIN","HEATHROW","PALMA DE MALLORCA",123584,123584,0
2015,"WESTERN EUROPE-EU","SPAIN","LONDON CITY","GRANADA",19550,19550,0
2015,"WESTERN EUROPE-EU","SPAIN","LONDON CITY","IBIZA",75593,75593,0
2015,"WESTERN EUROPE-EU","SPAIN","LONDON CITY","MADRID",83855,83855,0
2015,"WESTERN EUROPE-EU","SPAIN","LONDON CITY","MAHON",4899,4899,0
2015,"WESTERN EUROPE-EU","SPAIN","LONDON CITY","MALAGA",51879,51879,0
2015,"WESTERN EUROPE-EU","SPAIN","LONDON CITY","PALMA DE MALLORCA",34479,34479,0
2015,"WESTERN EUROPE-EU","SPAIN","LUTON","A CORUNA",0,0,0
2015,"WESTERN EUROPE-EU","SPAIN","LUTON","ALICANTE",212983,212886,97
2015,"WESTERN EUROPE-EU","SPAIN","LUTON","ALMERIA",48,0,48
2015,"WESTERN EUROPE-EU","SPAIN","LUTON","BARCELONA",181503,181317,186
2015,"WESTERN EUROPE-EU","SPAIN","LUTON","BILBAO",0,0,0
2015,"WESTERN EUROPE-EU","SPAIN","LUTON","GIRONA",45906,45886,20
2015,"WESTERN EUROPE-EU","SPAIN","LUTON","IBIZA",54774,36188,18586
2015,"WESTERN EUROPE-EU","SPAIN","LUTON","JEREZ",312,0,312
2015,"WESTERN EUROPE-EU","SPAIN","LUTON","MADRID",139233,139231,2
2015,"WESTERN EUROPE-EU","SPAIN","LUTON","MAHON",81683,61995,19688
2015,"WESTERN EUROPE-EU","SPAIN","LUTON","MALAGA",254198,245094,9104
2015,"WESTERN EUROPE-EU","SPAIN","LUTON","MURCIA SAN JAVIER",74147,74147,0
2015,"WESTERN EUROPE-EU","SPAIN","LUTON","PALMA DE MALLORCA",246102,197080,49022
2015,"WESTERN EUROPE-EU","SPAIN","LUTON","REUS",13159,0,13159
2015,"WESTERN EUROPE-EU","SPAIN","LUTON","SEVILLE",47,0,47
2015,"WESTERN EUROPE-EU","SPAIN","LUTON","VALENCIA",0,0,0
2015,"WESTERN EUROPE-EU","SPAIN","LUTON","VIGO",3232,2193,1039
2015,"WESTERN EUROPE-EU","SPAIN","LUTON","VITORIA",55,0,55
2015,"WESTERN EUROPE-EU","SPAIN","SOUTHEND","ALICANTE",98759,98759,0
2015,"WESTERN EUROPE-EU","SPAIN","SOUTHEND","BARCELONA",59826,59826,0
2015,"WESTERN EUROPE-EU","SPAIN","SOUTHEND","IBIZA",19237,19237,0
2015,"WESTERN EUROPE-EU","SPAIN","SOUTHEND","MAHON",4762,4762,0
2015,"WESTERN EUROPE-EU","SPAIN","SOUTHEND","MALAGA",81673,81673,0
2015,"WESTERN EUROPE-EU","SPAIN","SOUTHEND","PALMA DE MALLORCA",45058,39722,5336
2015,"WESTERN EUROPE-EU","SPAIN","STANSTED","ALICANTE",224251,224251,0
2015,"WESTERN EUROPE-EU","SPAIN","STANSTED","ALMERIA",23441,23441,0
2015,"WESTERN EUROPE-EU","SPAIN","STANSTED","ASTURIAS",84925,84925,0
2015,"WESTERN EUROPE-EU","SPAIN","STANSTED","BARCELONA",490068,490068,0
2015,"WESTERN EUROPE-EU","SPAIN","STANSTED","BILBAO",140191,140191,0
2015,"WESTERN EUROPE-EU","SPAIN","STANSTED","CASTELLON DE LA PLANA AIRPORT",15196,15196,0
2015,"WESTERN EUROPE-EU","SPAIN","STANSTED","GIRONA",56053,56053,0
2015,"WESTERN EUROPE-EU","SPAIN","STANSTED","GRANADA",339,0,339
2015,"WESTERN EUROPE-EU","SPAIN","STANSTED","IBIZA",201501,171659,29842
2015,"WESTERN EUROPE-EU","SPAIN","STANSTED","JEREZ",46036,46036,0
2015,"WESTERN EUROPE-EU","SPAIN","STANSTED","LEON",143,0,143
2015,"WESTERN EUROPE-EU","SPAIN","STANSTED","MADRID",453641,453528,113
2015,"WESTERN EUROPE-EU","SPAIN","STANSTED","MAHON",34359,0,34359
2015,"WESTERN EUROPE-EU","SPAIN","STANSTED","MALAGA",356908,356908,0
2015,"WESTERN EUROPE-EU","SPAIN","STANSTED","MURCIA SAN JAVIER",133273,133273,0
2015,"WESTERN EUROPE-EU","SPAIN","STANSTED","PALMA DE MALLORCA",320455,274141,46314
2015,"WESTERN EUROPE-EU","SPAIN","STANSTED","REUS",56437,56031,406
2015,"WESTERN EUROPE-EU","SPAIN","STANSTED","SANTANDER",99533,99533,0
2015,"WESTERN EUROPE-EU","SPAIN","STANSTED","SANTIAGO DE COMPOSTELA (SPAIN)",74871,74871,0
2015,"WESTERN EUROPE-EU","SPAIN","STANSTED","SEVILLE",131032,131032,0
2015,"WESTERN EUROPE-EU","SPAIN","STANSTED","VALENCIA",122515,122494,21
2015,"WESTERN EUROPE-EU","SPAIN","STANSTED","ZARAGOZA",85576,85576,0
2015,"WESTERN EUROPE-EU","SPAIN(CANARY ISLANDS)","GATWICK","ARRECIFE",421924,344271,77653
2015,"WESTERN EUROPE-EU","SPAIN(CANARY ISLANDS)","GATWICK","FUERTEVENTURA",235242,188547,46695
2015,"WESTERN EUROPE-EU","SPAIN(CANARY ISLANDS)","GATWICK","LAS PALMAS",278503,197328,81175
2015,"WESTERN EUROPE-EU","SPAIN(CANARY ISLANDS)","GATWICK","SANTA CRUZ DE LA PALMA",29768,3669,26099
2015,"WESTERN EUROPE-EU","SPAIN(CANARY ISLANDS)","GATWICK","TENERIFE (SURREINA SOFIA)",739089,590851,148238
2015,"WESTERN EUROPE-EU","SPAIN(CANARY ISLANDS)","HEATHROW","LAS PALMAS",51376,51376,0
2015,"WESTERN EUROPE-EU","SPAIN(CANARY ISLANDS)","HEATHROW","TENERIFE (NORTE LOS RODEOS)",25300,25300,0
2015,"WESTERN EUROPE-EU","SPAIN(CANARY ISLANDS)","LUTON","ARRECIFE",104372,71544,32828
2015,"WESTERN EUROPE-EU","SPAIN(CANARY ISLANDS)","LUTON","FUERTEVENTURA",31383,21800,9583
2015,"WESTERN EUROPE-EU","SPAIN(CANARY ISLANDS)","LUTON","LAS PALMAS",40078,22113,17965
2015,"WESTERN EUROPE-EU","SPAIN(CANARY ISLANDS)","LUTON","TENERIFE (SURREINA SOFIA)",121783,84523,37260
2015,"WESTERN EUROPE-EU","SPAIN(CANARY ISLANDS)","SOUTHEND","ARRECIFE",4195,4195,0
2015,"WESTERN EUROPE-EU","SPAIN(CANARY ISLANDS)","SOUTHEND","TENERIFE (SURREINA SOFIA)",14226,14226,0
2015,"WESTERN EUROPE-EU","SPAIN(CANARY ISLANDS)","STANSTED","ARRECIFE",144851,126181,18670
2015,"WESTERN EUROPE-EU","SPAIN(CANARY ISLANDS)","STANSTED","FUERTEVENTURA",102399,83926,18473
2015,"WESTERN EUROPE-EU","SPAIN(CANARY ISLANDS)","STANSTED","LAS PALMAS",103779,84877,18902
2015,"WESTERN EUROPE-EU","SPAIN(CANARY ISLANDS)","STANSTED","TENERIFE (SURREINA SOFIA)",221820,191550,30270
2015,"WESTERN EUROPE-EU","SWEDEN","GATWICK","GOTEBORG (LANDVETTER)",87020,87020,0
2015,"WESTERN EUROPE-EU","SWEDEN","GATWICK","KIRUNA",820,0,820
2015,"WESTERN EUROPE-EU","SWEDEN","GATWICK","MALMO",76,76,0
2015,"WESTERN EUROPE-EU","SWEDEN","GATWICK","PAJALA YLLAS",335,0,335
2015,"WESTERN EUROPE-EU","SWEDEN","GATWICK","STOCKHOLM (ARLANDA)",405387,405377,10
2015,"WESTERN EUROPE-EU","SWEDEN","HEATHROW","GOTEBORG (LANDVETTER)",289269,289269,0
2015,"WESTERN EUROPE-EU","SWEDEN","HEATHROW","KIRUNA",2856,0,2856
2015,"WESTERN EUROPE-EU","SWEDEN","HEATHROW","STOCKHOLM (ARLANDA)",1002530,1002530,0
2015,"WESTERN EUROPE-EU","SWEDEN","LONDON CITY","STOCKHOLM (ARLANDA)",0,0,0
2015,"WESTERN EUROPE-EU","SWEDEN","LUTON","STOCKHOLM (ARLANDA)",18,0,18
2015,"WESTERN EUROPE-EU","SWEDEN","LUTON","STOCKHOLM (BROMMA)",16,0,16
2015,"WESTERN EUROPE-EU","SWEDEN","STANSTED","GOTEBORG (LANDVETTER)",242260,242260,0
2015,"WESTERN EUROPE-EU","SWEDEN","STANSTED","GOTEBORG CITY",0,0,0
2015,"WESTERN EUROPE-EU","SWEDEN","STANSTED","MALMO",0,0,0
2015,"WESTERN EUROPE-EU","SWEDEN","STANSTED","PAJALA YLLAS",327,0,327
2015,"WESTERN EUROPE-EU","SWEDEN","STANSTED","SKELLEFTEA",21519,21519,0
2015,"WESTERN EUROPE-EU","SWEDEN","STANSTED","STOCKHOLM (SKAVSTA)",237479,237479,0
2015,"WESTERN EUROPE-EU","SWEDEN","STANSTED","VASTERAS",70256,70256,0
2015,"WESTERN-EUROPE-OTHER","FAROE ISLANDS","GATWICK","VAGAR",243,0,243
2015,"WESTERN-EUROPE-OTHER","FAROE ISLANDS","STANSTED","VAGAR",532,0,532
2015,"WESTERN-EUROPE-OTHER","ICELAND","GATWICK","EGILSSTADIR",0,0,0
2015,"WESTERN-EUROPE-OTHER","ICELAND","GATWICK","KEFLAVIK",312650,312440,210
2015,"WESTERN-EUROPE-OTHER","ICELAND","HEATHROW","KEFLAVIK",240313,240313,0
2015,"WESTERN-EUROPE-OTHER","ICELAND","LUTON","KEFLAVIK",100530,100507,23
2015,"WESTERN-EUROPE-OTHER","ICELAND","STANSTED","EGILSSTADIR",0,0,0
2015,"WESTERN-EUROPE-OTHER","ICELAND","STANSTED","KEFLAVIK",4968,4968,0
2015,"WESTERN-EUROPE-OTHER","KOSOVO","GATWICK","PRISTINA",14114,14114,0
2015,"WESTERN-EUROPE-OTHER","MACEDONIA","LUTON","OHRID",7639,7639,0
2015,"WESTERN-EUROPE-OTHER","MACEDONIA","LUTON","SKOPJE",71251,71251,0
2015,"WESTERN-EUROPE-OTHER","NORWAY","GATWICK","ALESUND",23307,23307,0
2015,"WESTERN-EUROPE-OTHER","NORWAY","GATWICK","BERGEN",180386,179130,1256
2015,"WESTERN-EUROPE-OTHER","NORWAY","GATWICK","BODO",559,0,559
2015,"WESTERN-EUROPE-OTHER","NORWAY","GATWICK","EVENES",0,0,0
2015,"WESTERN-EUROPE-OTHER","NORWAY","GATWICK","FAGERNES/LEIRIN",3106,0,3106
2015,"WESTERN-EUROPE-OTHER","NORWAY","GATWICK","OSLO (GARDERMOEN)",306246,306246,0
2015,"WESTERN-EUROPE-OTHER","NORWAY","GATWICK","SANDEFJORD(TORP)",32751,32751,0
2015,"WESTERN-EUROPE-OTHER","NORWAY","GATWICK","STAVANGER",71005,71005,0
2015,"WESTERN-EUROPE-OTHER","NORWAY","GATWICK","TROMSOE",11034,8680,2354
2015,"WESTERN-EUROPE-OTHER","NORWAY","GATWICK","TRONDHEIM (VAERNES)",68749,68749,0
2015,"WESTERN-EUROPE-OTHER","NORWAY","HEATHROW","BERGEN",126022,126022,0
2015,"WESTERN-EUROPE-OTHER","NORWAY","HEATHROW","OSLO (GARDERMOEN)",686856,686856,0
2015,"WESTERN-EUROPE-OTHER","NORWAY","HEATHROW","STAVANGER",198555,198555,0
2015,"WESTERN-EUROPE-OTHER","NORWAY","LUTON","ALESUND",0,0,0
2015,"WESTERN-EUROPE-OTHER","NORWAY","LUTON","BERGEN",37,0,37
2015,"WESTERN-EUROPE-OTHER","NORWAY","LUTON","OSLO (GARDERMOEN)",58,0,58
2015,"WESTERN-EUROPE-OTHER","NORWAY","STANSTED","BERGEN",0,0,0
2015,"WESTERN-EUROPE-OTHER","NORWAY","STANSTED","HAUGESUND",23916,23916,0
2015,"WESTERN-EUROPE-OTHER","NORWAY","STANSTED","RYGGE",286983,286983,0
2015,"WESTERN-EUROPE-OTHER","NORWAY","STANSTED","SANDEFJORD(TORP)",77594,77594,0
2015,"WESTERN-EUROPE-OTHER","NORWAY","STANSTED","TROMSOE",282,0,282
2015,"WESTERN-EUROPE-OTHER","REPUBLIC OF MONTENEGRO","GATWICK","TIVAT",13739,13739,0
2015,"WESTERN-EUROPE-OTHER","REPUBLIC OF MONTENEGRO","LUTON","TIVAT",0,0,0
2015,"WESTERN-EUROPE-OTHER","REPUBLIC OF MONTENEGRO","STANSTED","PODGORICA",36223,36223,0
2015,"WESTERN-EUROPE-OTHER","REPUBLIC OF SERBIA","HEATHROW","BELGRADE",84536,84536,0
2015,"WESTERN-EUROPE-OTHER","REPUBLIC OF SERBIA","LUTON","BELGRADE",43294,43272,22
2015,"WESTERN-EUROPE-OTHER","SWITZERLAND","GATWICK","BALE MULHOUSE",270273,270273,0
2015,"WESTERN-EUROPE-OTHER","SWITZERLAND","GATWICK","GENEVA",844939,792722,52217
2015,"WESTERN-EUROPE-OTHER","SWITZERLAND","GATWICK","ZURICH",176164,175870,294
2015,"WESTERN-EUROPE-OTHER","SWITZERLAND","HEATHROW","BALE MULHOUSE",246933,246933,0
2015,"WESTERN-EUROPE-OTHER","SWITZERLAND","HEATHROW","GENEVA",1021882,1018666,3216
2015,"WESTERN-EUROPE-OTHER","SWITZERLAND","HEATHROW","ZURICH",1075098,1074736,362
2015,"WESTERN-EUROPE-OTHER","SWITZERLAND","LONDON CITY","BALE MULHOUSE",37028,37028,0
2015,"WESTERN-EUROPE-OTHER","SWITZERLAND","LONDON CITY","BERNE",5097,5097,0
2015,"WESTERN-EUROPE-OTHER","SWITZERLAND","LONDON CITY","GENEVA",176451,176451,0
2015,"WESTERN-EUROPE-OTHER","SWITZERLAND","LONDON CITY","ZURICH",397363,397363,0
2015,"WESTERN-EUROPE-OTHER","SWITZERLAND","LUTON","BALE MULHOUSE",82807,82803,4
2015,"WESTERN-EUROPE-OTHER","SWITZERLAND","LUTON","BERNE",99,0,99
2015,"WESTERN-EUROPE-OTHER","SWITZERLAND","LUTON","GENEVA",264969,264946,23
2015,"WESTERN-EUROPE-OTHER","SWITZERLAND","LUTON","ZURICH",94030,93630,400
2015,"WESTERN-EUROPE-OTHER","SWITZERLAND","SOUTHEND","BERNE",8837,8757,80
2015,"WESTERN-EUROPE-OTHER","SWITZERLAND","SOUTHEND","GENEVA",26714,26714,0
2015,"WESTERN-EUROPE-OTHER","SWITZERLAND","STANSTED","BALE MULHOUSE",101105,101105,0
2015,"WESTERN-EUROPE-OTHER","SWITZERLAND","STANSTED","GENEVA",59540,59540,0
2015,"WESTERN-EUROPE-OTHER","SWITZERLAND","STANSTED","ZURICH",422,422,0
2015,"WESTERN-EUROPE-OTHER","TURKEY","GATWICK","ANKARA (ESENBOGA)",9,0,9
2015,"WESTERN-EUROPE-OTHER","TURKEY","GATWICK","ANTALYA",289395,88919,200476
2015,"WESTERN-EUROPE-OTHER","TURKEY","GATWICK","BODRUM (MILAS)",151055,78686,72369
2015,"WESTERN-EUROPE-OTHER","TURKEY","GATWICK","DALAMAN",452424,210540,241884
2015,"WESTERN-EUROPE-OTHER","TURKEY","GATWICK","ISTANBUL",273046,272617,429
2015,"WESTERN-EUROPE-OTHER","TURKEY","GATWICK","ISTANBUL (SABIHA GOKCEN)",150805,147644,3161
2015,"WESTERN-EUROPE-OTHER","TURKEY","GATWICK","IZMIR (ADNAN MENDERES)",73975,32361,41614
2015,"WESTERN-EUROPE-OTHER","TURKEY","HEATHROW","BODRUM (MILAS)",6788,0,6788
2015,"WESTERN-EUROPE-OTHER","TURKEY","HEATHROW","DALAMAN",18370,0,18370
2015,"WESTERN-EUROPE-OTHER","TURKEY","HEATHROW","ISTANBUL",933038,932909,129
2015,"WESTERN-EUROPE-OTHER","TURKEY","HEATHROW","ISTANBUL (SABIHA GOKCEN)",2019,0,2019
2015,"WESTERN-EUROPE-OTHER","TURKEY","LUTON","ADANA",0,0,0
2015,"WESTERN-EUROPE-OTHER","TURKEY","LUTON","ANKARA (ESENBOGA)",34,0,34
2015,"WESTERN-EUROPE-OTHER","TURKEY","LUTON","ANTALYA",26062,16706,9356
2015,"WESTERN-EUROPE-OTHER","TURKEY","LUTON","BODRUM (MILAS)",20762,11829,8933
2015,"WESTERN-EUROPE-OTHER","TURKEY","LUTON","DALAMAN",51715,31975,19740
2015,"WESTERN-EUROPE-OTHER","TURKEY","LUTON","ISTANBUL",80357,80357,0
2015,"WESTERN-EUROPE-OTHER","TURKEY","LUTON","ISTANBUL (SABIHA GOKCEN)",2,0,2
2015,"WESTERN-EUROPE-OTHER","TURKEY","LUTON","IZMIR (ADNAN MENDERES)",6905,6893,12
2015,"WESTERN-EUROPE-OTHER","TURKEY","LUTON","NEVSEHIR KAPADOKYA ",170,0,170
2015,"WESTERN-EUROPE-OTHER","TURKEY","LUTON","TRABZON",36,0,36
2015,"WESTERN-EUROPE-OTHER","TURKEY","STANSTED","ANTALYA",64197,0,64197
2015,"WESTERN-EUROPE-OTHER","TURKEY","STANSTED","BALIKESIR (KOCA SEYIT)",0,0,0
2015,"WESTERN-EUROPE-OTHER","TURKEY","STANSTED","BODRUM (MILAS)",34196,27311,6885
2015,"WESTERN-EUROPE-OTHER","TURKEY","STANSTED","DALAMAN",102896,38087,64809
2015,"WESTERN-EUROPE-OTHER","TURKEY","STANSTED","GAZIANTEP",1622,0,1622
2015,"WESTERN-EUROPE-OTHER","TURKEY","STANSTED","ISTANBUL",69,0,69
2015,"WESTERN-EUROPE-OTHER","TURKEY","STANSTED","ISTANBUL (SABIHA GOKCEN)",240429,239675,754
2015,"WESTERN-EUROPE-OTHER","TURKEY","STANSTED","IZMIR (ADNAN MENDERES)",45564,37979,7585
2015,"EASTERN EUROPE-EU","BULGARIA","GATWICK","BURGAS",37500,0,37500
2015,"EASTERN EUROPE-EU","BULGARIA","GATWICK","PLOVDIV",2918,0,2918
2015,"EASTERN EUROPE-EU","BULGARIA","GATWICK","SOFIA",126049,114923,11126
2015,"EASTERN EUROPE-EU","BULGARIA","GATWICK","VARNA",1965,0,1965
2015,"EASTERN EUROPE-EU","BULGARIA","HEATHROW","SOFIA",182313,182313,0
2015,"EASTERN EUROPE-EU","BULGARIA","LUTON","BURGAS",81774,74903,6871
2015,"EASTERN EUROPE-EU","BULGARIA","LUTON","SOFIA",231215,231215,0
2015,"EASTERN EUROPE-EU","BULGARIA","LUTON","VARNA",75005,75005,0
2015,"EASTERN EUROPE-EU","BULGARIA","STANSTED","BURGAS",2247,0,2247
2015,"EASTERN EUROPE-EU","BULGARIA","STANSTED","PLOVDIV",54612,54612,0
2015,"EASTERN EUROPE-EU","BULGARIA","STANSTED","SOFIA",11508,11508,0
2015,"EASTERN EUROPE-EU","CZECH REPUBLIC","GATWICK","PRAGUE",243500,243461,39
2015,"EASTERN EUROPE-EU","CZECH REPUBLIC","HEATHROW","PRAGUE",433345,433345,0
2015,"EASTERN EUROPE-EU","CZECH REPUBLIC","LUTON","BRNO (TURANY)",45470,45470,0
2015,"EASTERN EUROPE-EU","CZECH REPUBLIC","LUTON","PRAGUE",126735,126519,216
2015,"EASTERN EUROPE-EU","CZECH REPUBLIC","SOUTHEND","PRAGUE",33,0,33
2015,"EASTERN EUROPE-EU","CZECH REPUBLIC","STANSTED","BRNO (TURANY)",116274,116274,0
2015,"EASTERN EUROPE-EU","CZECH REPUBLIC","STANSTED","OSTRAVA",57526,57526,0
2015,"EASTERN EUROPE-EU","CZECH REPUBLIC","STANSTED","PRAGUE",333672,333444,228
2015,"EASTERN EUROPE-EU","ESTONIA","GATWICK","TALLIN",53770,53770,0
2015,"EASTERN EUROPE-EU","ESTONIA","LUTON","TALLIN",8,0,8
2015,"EASTERN EUROPE-EU","ESTONIA","STANSTED","TALLIN",72491,72491,0
2015,"EASTERN EUROPE-EU","HUNGARY","GATWICK","BUDAPEST",177393,176956,437
2015,"EASTERN EUROPE-EU","HUNGARY","HEATHROW","BUDAPEST",291955,291955,0
2015,"EASTERN EUROPE-EU","HUNGARY","LUTON","BUDAPEST",468107,467949,158
2015,"EASTERN EUROPE-EU","HUNGARY","LUTON","DEBRECEN",108515,108515,0
2015,"EASTERN EUROPE-EU","HUNGARY","STANSTED","BUDAPEST",368605,368446,159
2015,"EASTERN EUROPE-EU","LATVIA","GATWICK","RIGA",87226,87226,0
2015,"EASTERN EUROPE-EU","LATVIA","LUTON","RIGA",154227,154227,0
2015,"EASTERN EUROPE-EU","LATVIA","STANSTED","RIGA",255605,255605,0
2015,"EASTERN EUROPE-EU","LITHUANIA","GATWICK","KAUNAS",55465,55465,0
2015,"EASTERN EUROPE-EU","LITHUANIA","GATWICK","PALANGA",0,0,0
2015,"EASTERN EUROPE-EU","LITHUANIA","GATWICK","VILNIUS",415,0,415
2015,"EASTERN EUROPE-EU","LITHUANIA","LUTON","KAUNAS",86289,86289,0
2015,"EASTERN EUROPE-EU","LITHUANIA","LUTON","VILNIUS",230143,230091,52
2015,"EASTERN EUROPE-EU","LITHUANIA","STANSTED","KAUNAS",134168,134168,0
2015,"EASTERN EUROPE-EU","LITHUANIA","STANSTED","VILNIUS",128544,128544,0
2015,"EASTERN EUROPE-EU","POLAND","GATWICK","KRAKOW",105487,104640,847
2015,"EASTERN EUROPE-EU","POLAND","GATWICK","RZESZOW",359,0,359
2015,"EASTERN EUROPE-EU","POLAND","GATWICK","WARSAW (CHOPIN)",75234,75234,0
2015,"EASTERN EUROPE-EU","POLAND","HEATHROW","KRAKOW",38287,38287,0
2015,"EASTERN EUROPE-EU","POLAND","HEATHROW","WARSAW (CHOPIN)",417107,417107,0
2015,"EASTERN EUROPE-EU","POLAND","LUTON","BYDGOSZCZ",777,0,777
2015,"EASTERN EUROPE-EU","POLAND","LUTON","GDANSK",270356,270221,135
2015,"EASTERN EUROPE-EU","POLAND","LUTON","KATOWICE",299739,299739,0
2015,"EASTERN EUROPE-EU","POLAND","LUTON","KRAKOW",876,0,876
2015,"EASTERN EUROPE-EU","POLAND","LUTON","LODZ LUBLINEK",0,0,0
2015,"EASTERN EUROPE-EU","POLAND","LUTON","LUBLIN (PORT LOTNICZY)",88724,88724,0
2015,"EASTERN EUROPE-EU","POLAND","LUTON","POZNAN",136493,136493,0
2015,"EASTERN EUROPE-EU","POLAND","LUTON","RZESZOW",54681,54681,0
2015,"EASTERN EUROPE-EU","POLAND","LUTON","SZCZECIN (GOLENOW)",44842,44842,0
2015,"EASTERN EUROPE-EU","POLAND","LUTON","WARSAW (CHOPIN)",356462,356462,0
2015,"EASTERN EUROPE-EU","POLAND","LUTON","WROCLAW",103239,103239,0
2015,"EASTERN EUROPE-EU","POLAND","SOUTHEND","KRAKOW",0,0,0
2015,"EASTERN EUROPE-EU","POLAND","STANSTED","BYDGOSZCZ",113907,113907,0
2015,"EASTERN EUROPE-EU","POLAND","STANSTED","GDANSK",207284,207284,0
2015,"EASTERN EUROPE-EU","POLAND","STANSTED","KATOWICE",132461,132461,0
2015,"EASTERN EUROPE-EU","POLAND","STANSTED","KRAKOW",307139,306043,1096
2015,"EASTERN EUROPE-EU","POLAND","STANSTED","LODZ LUBLINEK",106128,106128,0
2015,"EASTERN EUROPE-EU","POLAND","STANSTED","LUBLIN (PORT LOTNICZY)",68294,68294,0
2015,"EASTERN EUROPE-EU","POLAND","STANSTED","POZNAN",124916,124916,0
2015,"EASTERN EUROPE-EU","POLAND","STANSTED","RZESZOW",140157,140157,0
2015,"EASTERN EUROPE-EU","POLAND","STANSTED","SZCZECIN (GOLENOW)",98677,98677,0
2015,"EASTERN EUROPE-EU","POLAND","STANSTED","WARSAW (MODLIN MASOVIA)",371836,371836,0
2015,"EASTERN EUROPE-EU","POLAND","STANSTED","WROCLAW",209654,209654,0
2015,"EASTERN EUROPE-EU","ROMANIA","GATWICK","BUCHAREST (OTOPENI)",13332,13332,0
2015,"EASTERN EUROPE-EU","ROMANIA","HEATHROW","BUCHAREST (BANEASA)",13,0,13
2015,"EASTERN EUROPE-EU","ROMANIA","HEATHROW","BUCHAREST (OTOPENI)",253590,253590,0
2015,"EASTERN EUROPE-EU","ROMANIA","LUTON","BACAU",72459,72459,0
2015,"EASTERN EUROPE-EU","ROMANIA","LUTON","BUCHAREST (OTOPENI)",417520,417481,39
2015,"EASTERN EUROPE-EU","ROMANIA","LUTON","CLUJ NAPOCA",190976,190955,21
2015,"EASTERN EUROPE-EU","ROMANIA","LUTON","CONSTANTA",17583,17583,0
2015,"EASTERN EUROPE-EU","ROMANIA","LUTON","CRAIOVA",27092,27092,0
2015,"EASTERN EUROPE-EU","ROMANIA","LUTON","IASI",34589,34589,0
2015,"EASTERN EUROPE-EU","ROMANIA","LUTON","SIBIU",40064,40064,0
2015,"EASTERN EUROPE-EU","ROMANIA","LUTON","TIMISOARA",75878,75878,0
2015,"EASTERN EUROPE-EU","ROMANIA","LUTON","TIRGU MURES",69163,69163,0
2015,"EASTERN EUROPE-EU","ROMANIA","STANSTED","BUCHAREST (OTOPENI)",252646,252646,0
2015,"EASTERN EUROPE-EU","SLOVAK REPUBLIC","LUTON","BRATISLAVA",72175,72127,48
2015,"EASTERN EUROPE-EU","SLOVAK REPUBLIC","LUTON","KOSICE",127734,127734,0
2015,"EASTERN EUROPE-EU","SLOVAK REPUBLIC","LUTON","TATRY-POPRAD",62428,62428,0
2015,"EASTERN EUROPE-EU","SLOVAK REPUBLIC","SOUTHEND","BRATISLAVA",33,0,33
2015,"EASTERN EUROPE-EU","SLOVAK REPUBLIC","STANSTED","BRATISLAVA",232641,232641,0
2015,"EASTERN EUROPE -OTHER","ALBANIA","GATWICK","TIRANA",74159,62687,11472
2015,"EASTERN EUROPE -OTHER","ALBANIA","STANSTED","TIRANA",2106,0,2106
2015,"EASTERN EUROPE -OTHER","AZERBAIJAN","HEATHROW","BAKU (HEYDER ALIYEV INT'L)",82685,82685,0
2015,"EASTERN EUROPE -OTHER","AZERBAIJAN","LUTON","BAKU (HEYDER ALIYEV INT'L)",12,0,12
2015,"EASTERN EUROPE -OTHER","BELARUS","GATWICK","MINSK INT'L ",22137,22137,0
2015,"EASTERN EUROPE -OTHER","KAZAKHSTAN","HEATHROW","ALMATY",23259,23259,0
2015,"EASTERN EUROPE -OTHER","KAZAKHSTAN","HEATHROW","ASTANA",26197,26197,0
2015,"EASTERN EUROPE -OTHER","KAZAKHSTAN","LUTON","ALMATY",2,0,2
2015,"EASTERN EUROPE -OTHER","KYRGYZSTAN","LUTON","BISHKEK (FRUNZE)",0,0,0
2015,"EASTERN EUROPE -OTHER","REPUBLIC OF MOLDOVA","LUTON","CHISINAU (KISHINEV)",7832,7832,0
2015,"EASTERN EUROPE -OTHER","REPUBLIC OF MOLDOVA","STANSTED","CHISINAU (KISHINEV)",33598,33598,0
2015,"EASTERN EUROPE -OTHER","RUSSIA","GATWICK","ADLER / SOCHI",0,0,0
2015,"EASTERN EUROPE -OTHER","RUSSIA","GATWICK","MOSCOW (DOMODEDOVO)",113235,113235,0
2015,"EASTERN EUROPE -OTHER","RUSSIA","HEATHROW","IRKUTSK",0,0,0
2015,"EASTERN EUROPE -OTHER","RUSSIA","HEATHROW","MOSCOW (DOMODEDOVO)",247141,247141,0
2015,"EASTERN EUROPE -OTHER","RUSSIA","HEATHROW","MOSCOW (SHEREMETYEVO)",293876,293876,0
2015,"EASTERN EUROPE -OTHER","RUSSIA","HEATHROW","MOSCOW (VNUKOVO)",90672,90672,0
2015,"EASTERN EUROPE -OTHER","RUSSIA","HEATHROW","ST PETERSBURG",79823,79823,0
2015,"EASTERN EUROPE -OTHER","RUSSIA","LUTON","ADLER / SOCHI",1230,0,1230
2015,"EASTERN EUROPE -OTHER","RUSSIA","LUTON","MOSCOW (SHEREMETYEVO)",3,0,3
2015,"EASTERN EUROPE -OTHER","RUSSIA","LUTON","MOSCOW (VNUKOVO)",3,0,3
2015,"EASTERN EUROPE -OTHER","RUSSIA","LUTON","ST PETERSBURG",2,0,2
2015,"EASTERN EUROPE -OTHER","RUSSIA","STANSTED","ST PETERSBURG",0,0,0
2015,"EASTERN EUROPE -OTHER","TAJIKISTAN","GATWICK","DUSHANBE",0,0,0
2015,"EASTERN EUROPE -OTHER","TURKMENISTAN","HEATHROW","ASHKHABAD",18493,18493,0
2015,"EASTERN EUROPE -OTHER","UKRAINE","GATWICK","KIEV (BORISPOL)",125892,125426,466
2015,"EASTERN EUROPE -OTHER","UKRAINE","HEATHROW","KIEV (BORISPOL)",72523,72523,0
2015,"EASTERN EUROPE -OTHER","UKRAINE","LUTON","KIEV (BORISPOL)",120,0,120
2015,"EASTERN EUROPE -OTHER","UKRAINE","LUTON","KIEV (ZHULYANY)",30092,30088,4
2015,"EASTERN EUROPE -OTHER","UZBEKISTAN","GATWICK","TASHKENT",205,0,205
2015,"EASTERN EUROPE -OTHER","UZBEKISTAN","HEATHROW","TASHKENT",25098,25098,0
2015,"NEAR EAST","ISRAEL","GATWICK","TEL AVIV",51911,51387,524
2015,"NEAR EAST","ISRAEL","HEATHROW","TEL AVIV",584298,584298,0
2015,"NEAR EAST","ISRAEL","LUTON","OVDA",1067,671,396
2015,"NEAR EAST","ISRAEL","LUTON","TEL AVIV",313035,310174,2861
2015,"NEAR EAST","ISRAEL","STANSTED","TEL AVIV",365,0,365
2015,"NEAR EAST","JORDAN","GATWICK","AMMAN",0,0,0
2015,"NEAR EAST","JORDAN","GATWICK","AQABA",0,0,0
2015,"NEAR EAST","JORDAN","HEATHROW","AMMAN",203783,203783,0
2015,"NEAR EAST","JORDAN","LUTON","AQABA",0,0,0
2015,"NEAR EAST","LEBANON","HEATHROW","BEIRUT",255510,255510,0
2015,"NORTH AFRICA","ALGERIA","GATWICK","ALGIERS",54914,54914,0
2015,"NORTH AFRICA","ALGERIA","GATWICK","HASSI MESSAOUD",2838,0,2838
2015,"NORTH AFRICA","ALGERIA","HEATHROW","ALGIERS",71565,71565,0
2015,"NORTH AFRICA","ALGERIA","LUTON","ALGIERS",5,0,5
2015,"NORTH AFRICA","ALGERIA","STANSTED","HASSI MESSAOUD",5752,0,5752
2015,"NORTH AFRICA","EGYPT","GATWICK","HURGHADA",150140,60339,89801
2015,"NORTH AFRICA","EGYPT","GATWICK","LUXOR",8569,0,8569
2015,"NORTH AFRICA","EGYPT","GATWICK","MARSA ALAM",16545,0,16545
2015,"NORTH AFRICA","EGYPT","GATWICK","MERSA MATROUH",150,0,150
2015,"NORTH AFRICA","EGYPT","GATWICK","SHARM EL SHEIKH (OPHIRA)",364385,192213,172172
2015,"NORTH AFRICA","EGYPT","HEATHROW","CAIRO",337505,337505,0
2015,"NORTH AFRICA","EGYPT","HEATHROW","LUXOR",11067,11067,0
2015,"NORTH AFRICA","EGYPT","LUTON","MERSA MATROUH",133,0,133
2015,"NORTH AFRICA","EGYPT","LUTON","SHARM EL SHEIKH (OPHIRA)",127600,114858,12742
2015,"NORTH AFRICA","EGYPT","STANSTED","SHARM EL SHEIKH (OPHIRA)",50202,35432,14770
2015,"NORTH AFRICA","LIBYA","GATWICK","TRIPOLI",0,0,0
2015,"NORTH AFRICA","LIBYA","HEATHROW","TRIPOLI",0,0,0
2015,"NORTH AFRICA","MOROCCO","GATWICK","AGADIR (AL MASSIRA)",84769,84507,262
2015,"NORTH AFRICA","MOROCCO","GATWICK","CASABLANCA MOHAMED V",46916,46916,0
2015,"NORTH AFRICA","MOROCCO","GATWICK","ERRACHIDIA",0,0,0
2015,"NORTH AFRICA","MOROCCO","GATWICK","MARRAKESH",307440,307052,388
2015,"NORTH AFRICA","MOROCCO","GATWICK","OUARZAZATE",928,0,928
2015,"NORTH AFRICA","MOROCCO","GATWICK","RABAT",2689,2689,0
2015,"NORTH AFRICA","MOROCCO","GATWICK","TANGIERS (IBN BATUTA)",23634,23634,0
2015,"NORTH AFRICA","MOROCCO","HEATHROW","AGADIR (AL MASSIRA)",0,0,0
2015,"NORTH AFRICA","MOROCCO","HEATHROW","CASABLANCA MOHAMED V",96311,96311,0
2015,"NORTH AFRICA","MOROCCO","HEATHROW","TANGIERS (IBN BATUTA)",0,0,0
2015,"NORTH AFRICA","MOROCCO","LUTON","CASABLANCA MOHAMED V",0,0,0
2015,"NORTH AFRICA","MOROCCO","LUTON","ESSAOUIRA",17883,17883,0
2015,"NORTH AFRICA","MOROCCO","LUTON","MARRAKESH",65905,65898,7
2015,"NORTH AFRICA","MOROCCO","LUTON","OUJDA ANGAD",0,0,0
2015,"NORTH AFRICA","MOROCCO","LUTON","RABAT",0,0,0
2015,"NORTH AFRICA","MOROCCO","LUTON","TANGIERS (IBN BATUTA)",39,0,39
2015,"NORTH AFRICA","MOROCCO","STANSTED","AGADIR (AL MASSIRA)",0,0,0
2015,"NORTH AFRICA","MOROCCO","STANSTED","FEZ",33316,33316,0
2015,"NORTH AFRICA","MOROCCO","STANSTED","MARRAKESH",146752,146752,0
2015,"NORTH AFRICA","MOROCCO","STANSTED","RABAT",51774,51774,0
2015,"NORTH AFRICA","TUNISIA","GATWICK","ENFIDHA - HAMMAMET INTL",67715,12877,54838
2015,"NORTH AFRICA","TUNISIA","GATWICK","JERBA",7231,0,7231
2015,"NORTH AFRICA","TUNISIA","GATWICK","MONASTIR",2906,0,2906
2015,"NORTH AFRICA","TUNISIA","GATWICK","TUNIS",23475,23475,0
2015,"NORTH AFRICA","TUNISIA","HEATHROW","MONASTIR",104,104,0
2015,"NORTH AFRICA","TUNISIA","HEATHROW","TUNIS",41927,41927,0
2015,"NORTH AFRICA","TUNISIA","LUTON","ENFIDHA - HAMMAMET INTL",4735,0,4735
2015,"NORTH AFRICA","TUNISIA","LUTON","MONASTIR",0,0,0
2015,"NORTH AFRICA","TUNISIA","STANSTED","ENFIDHA - HAMMAMET INTL",15493,0,15493
2015,"NORTH AFRICA","TUNISIA","STANSTED","MONASTIR",2371,2371,0
2015,"EAST AFRICA","ETHIOPIA","HEATHROW","ADDIS ABABA",161558,161558,0
2015,"EAST AFRICA","KENYA","GATWICK","MOMBASA",0,0,0
2015,"EAST AFRICA","KENYA","HEATHROW","MOMBASA",224,224,0
2015,"EAST AFRICA","KENYA","HEATHROW","NAIROBI",290217,290217,0
2015,"EAST AFRICA","UGANDA","HEATHROW","ENTEBBE",43857,43857,0
2015,"WEST AFRICA","BURKINO FASO","LUTON","OUAGADOUGOU",0,0,0
2015,"WEST AFRICA","CAMEROON","GATWICK","DOUALA",0,0,0
2015,"WEST AFRICA","GABON","LUTON","LIBREVILLE",0,0,0
2015,"WEST AFRICA","GAMBIA","GATWICK","BANJUL",42880,9023,33857
2015,"WEST AFRICA","GAMBIA","STANSTED","BANJUL",0,0,0
2015,"WEST AFRICA","GHANA","GATWICK","ACCRA",560,0,560
2015,"WEST AFRICA","GHANA","HEATHROW","ACCRA",194935,194935,0
2015,"WEST AFRICA","LIBERIA","HEATHROW","MONROVIA (ROBERTS)",0,0,0
2015,"WEST AFRICA","NIGERIA","GATWICK","LAGOS",5175,5105,70
2015,"WEST AFRICA","NIGERIA","HEATHROW","ABUJA",133971,133971,0
2015,"WEST AFRICA","NIGERIA","HEATHROW","LAGOS",448473,448473,0
2015,"WEST AFRICA","NIGERIA","STANSTED","LAGOS",0,0,0
2015,"WEST AFRICA","SENEGAL","LUTON","DAKAR",44,0,44
2015,"WEST AFRICA","SIERRA LEONE","GATWICK","FREETOWN",0,0,0
2015,"WEST AFRICA","SIERRA LEONE","HEATHROW","FREETOWN",0,0,0
2015,"CENTRAL AFRICA","ANGOLA","HEATHROW","LUANDA",29953,29953,0
2015,"CENTRAL AFRICA","CHAD","LUTON","NDJAMENA",0,0,0
2015,"SOUTHERN AFRICA","REPUBLIC OF SOUTH AFRICA","HEATHROW","CAPE TOWN",417649,417649,0
2015,"SOUTHERN AFRICA","REPUBLIC OF SOUTH AFRICA","HEATHROW","JOHANNESBURG",938503,938503,0
2015,"MIDDLE EAST","BAHRAIN","HEATHROW","BAHRAIN",282835,282835,0
2015,"MIDDLE EAST","BAHRAIN","LUTON","BAHRAIN",4,0,4
2015,"MIDDLE EAST","IRAN","HEATHROW","TEHRAN IMAM KHOMEINI",50397,50397,0
2015,"MIDDLE EAST","IRAQ","GATWICK","BAGHDAD (GECA)",12760,12760,0
2015,"MIDDLE EAST","IRAQ","GATWICK","ERBIL INTERNATIONAL",2468,2468,0
2015,"MIDDLE EAST","IRAQ","GATWICK","SULAYMANIYAH INT",12082,12082,0
2015,"MIDDLE EAST","KUWAIT","HEATHROW","KUWAIT",272975,272975,0
2015,"MIDDLE EAST","OMAN","GATWICK","MUSCAT",536,0,536
2015,"MIDDLE EAST","OMAN","HEATHROW","MUSCAT",179275,179275,0
2015,"MIDDLE EAST","OMAN","LUTON","MUSCAT",0,0,0
2015,"MIDDLE EAST","QATAR","HEATHROW","DOHA HAMAD",1072031,1072001,30
2015,"MIDDLE EAST","QATAR","LUTON","DOHA HAMAD",0,0,0
2015,"MIDDLE EAST","SAUDI ARABIA","GATWICK","JEDDAH",0,0,0
2015,"MIDDLE EAST","SAUDI ARABIA","GATWICK","MEDINA",0,0,0
2015,"MIDDLE EAST","SAUDI ARABIA","GATWICK","RIYADH",29,0,29
2015,"MIDDLE EAST","SAUDI ARABIA","HEATHROW","JEDDAH",223910,223910,0
2015,"MIDDLE EAST","SAUDI ARABIA","HEATHROW","RIYADH",258982,258982,0
2015,"MIDDLE EAST","SAUDI ARABIA","LUTON","JEDDAH",35,0,35
2015,"MIDDLE EAST","SAUDI ARABIA","LUTON","RIYADH",33,0,33
2015,"MIDDLE EAST","SAUDI ARABIA","LUTON","TABUK",7,0,7
2015,"MIDDLE EAST","UNITED ARAB EMIRATES","GATWICK","DUBAI",866101,866101,0
2015,"MIDDLE EAST","UNITED ARAB EMIRATES","HEATHROW","ABU DHABI INTERNATIONAL",835901,835901,0
2015,"MIDDLE EAST","UNITED ARAB EMIRATES","HEATHROW","DUBAI",2451738,2451738,0
2015,"MIDDLE EAST","UNITED ARAB EMIRATES","HEATHROW","DUBAI (WORLD CENTRAL)",0,0,0
2015,"MIDDLE EAST","UNITED ARAB EMIRATES","LUTON","ABU DHABI - BATEEN",10,0,10
2015,"MIDDLE EAST","UNITED ARAB EMIRATES","LUTON","DUBAI",0,0,0
2015,"MIDDLE EAST","UNITED ARAB EMIRATES","SOUTHEND","SHARJAH",8,0,8
2015,"INDIAN SUB-CONTINENT","BANGLADESH","HEATHROW","DHAKHA",68105,68105,0
2015,"INDIAN SUB-CONTINENT","BANGLADESH","HEATHROW","SYLHET",49083,49083,0
2015,"INDIAN SUB-CONTINENT","INDIA","GATWICK","GOA",42653,8389,34264
2015,"INDIAN SUB-CONTINENT","INDIA","HEATHROW","AMRITSAR",601,601,0
2015,"INDIAN SUB-CONTINENT","INDIA","HEATHROW","BANGALORE (BENGALURU)",171970,171970,0
2015,"INDIAN SUB-CONTINENT","INDIA","HEATHROW","CHENNAI",126878,126878,0
2015,"INDIAN SUB-CONTINENT","INDIA","HEATHROW","DELHI",1034172,1034172,0
2015,"INDIAN SUB-CONTINENT","INDIA","HEATHROW","HYDERABAD ( RAJIV GHANDI )",136114,136114,0
2015,"INDIAN SUB-CONTINENT","INDIA","HEATHROW","MUMBAI",949485,949354,131
2015,"INDIAN SUB-CONTINENT","INDIA","LUTON","DELHI",0,0,0
2015,"INDIAN SUB-CONTINENT","PAKISTAN","GATWICK","ISLAMABAD",1137,0,1137
2015,"INDIAN SUB-CONTINENT","PAKISTAN","HEATHROW","ISLAMABAD",114875,114875,0
2015,"INDIAN SUB-CONTINENT","PAKISTAN","HEATHROW","KARACHI",35475,35475,0
2015,"INDIAN SUB-CONTINENT","PAKISTAN","HEATHROW","LAHORE",95362,95362,0
2015,"INDIAN SUB-CONTINENT","PAKISTAN","STANSTED","ISLAMABAD",0,0,0
2015,"INDIAN SUB-CONTINENT","SRI LANKA","GATWICK","COLOMBO",19126,19126,0
2015,"INDIAN SUB-CONTINENT","SRI LANKA","HEATHROW","COLOMBO",203205,203205,0
2015,"FAR EAST","BRUNEI","HEATHROW","BANDAR SERI BEGAWAN",85594,85594,0
2015,"FAR EAST","CHINA","GATWICK","BEIJING",0,0,0
2015,"FAR EAST","CHINA","HEATHROW","BEIJING",448316,448316,0
2015,"FAR EAST","CHINA","HEATHROW","CHENGDU",56649,56649,0
2015,"FAR EAST","CHINA","HEATHROW","GUANGZHOU BAIYUN INTERNATIONAL",136498,136498,0
2015,"FAR EAST","CHINA","HEATHROW","SHANGHAI (PU DONG)",431072,431072,0
2015,"FAR EAST","CHINA","LUTON","URUMQI",0,0,0
2015,"FAR EAST","HONG KONG","HEATHROW","HONG KONG (CHEK LAP KOK)",1584486,1584486,0
2015,"FAR EAST","INDONESIA","GATWICK","JAKARTA (SOEKARNO-HATTA INTNL)",72838,72838,0
2015,"FAR EAST","JAPAN","GATWICK","OSAKA (KANSAI)",0,0,0
2015,"FAR EAST","JAPAN","HEATHROW","TOKYO (HANEDA)",429905,429905,0
2015,"FAR EAST","JAPAN","HEATHROW","TOKYO (NARITA)",181423,181423,0
2015,"FAR EAST","MALAYSIA","HEATHROW","KUALA LUMPUR (SEPANG)",606746,606746,0
2015,"FAR EAST","PHILIPPINES","HEATHROW","MANILA",85392,85392,0
2015,"FAR EAST","REPUBLIC OF KOREA","HEATHROW","SEOUL (INCHEON)",456557,456557,0
2015,"FAR EAST","SINGAPORE","HEATHROW","SINGAPORE",1150240,1150240,0
2015,"FAR EAST","TAIWAN","HEATHROW","TAIPEI",123578,123578,0
2015,"FAR EAST","THAILAND","GATWICK","PHUKET",12928,0,12928
2015,"FAR EAST","THAILAND","HEATHROW","BANGKOK SUVARNABHUMI ",599558,599558,0
2015,"FAR EAST","VIETNAM","GATWICK","HANOI",11857,11857,0
2015,"FAR EAST","VIETNAM","GATWICK","HO CHI MINH CITY",11894,11894,0
2015,"FAR EAST","VIETNAM","HEATHROW","HANOI",46106,46106,0
2015,"FAR EAST","VIETNAM","HEATHROW","HO CHI MINH CITY",36852,36852,0
2015,"AUSTRALASIA","AUSTRALIA","HEATHROW","MELBOURNE",139556,139224,332
2015,"AUSTRALASIA","AUSTRALIA","HEATHROW","SYDNEY",304131,302799,1332
2015,"AUSTRALASIA","NEW ZEALAND","HEATHROW","AUCKLAND INTERNATIONAL",125887,125887,0
2015,"CANADA","CANADA","GATWICK","CALGARY",34589,34589,0
2015,"CANADA","CANADA","GATWICK","EDMONTON",0,0,0
2015,"CANADA","CANADA","GATWICK","HALIFAX INT",5688,5688,0
2015,"CANADA","CANADA","GATWICK","MONTREAL (DORVAL)",18495,18425,70
2015,"CANADA","CANADA","GATWICK","OTTAWA INTERNATIONAL",0,0,0
2015,"CANADA","CANADA","GATWICK","TORONTO",197014,197014,0
2015,"CANADA","CANADA","GATWICK","VANCOUVER",102678,102678,0
2015,"CANADA","CANADA","HEATHROW","CALGARY",304623,304623,0
2015,"CANADA","CANADA","HEATHROW","EDMONTON",39754,39754,0
2015,"CANADA","CANADA","HEATHROW","HALIFAX INT",84120,84120,0
2015,"CANADA","CANADA","HEATHROW","MONTREAL (DORVAL)",317390,317390,0
2015,"CANADA","CANADA","HEATHROW","OTTAWA INTERNATIONAL",112635,112635,0
2015,"CANADA","CANADA","HEATHROW","ST JOHNS",41995,41995,0
2015,"CANADA","CANADA","HEATHROW","TORONTO",1032206,1032206,0
2015,"CANADA","CANADA","HEATHROW","VANCOUVER",550641,550641,0
2015,"UNITED STATES OF AMERICA","USA","GATWICK","ATLANTA",0,0,0
2015,"UNITED STATES OF AMERICA","USA","GATWICK","BALTIMORE",0,0,0
2015,"UNITED STATES OF AMERICA","USA","GATWICK","BOSTON",0,0,0
2015,"UNITED STATES OF AMERICA","USA","GATWICK","BUFFALO",382,0,382
2015,"UNITED STATES OF AMERICA","USA","GATWICK","CINCINNATI",0,0,0
2015,"UNITED STATES OF AMERICA","USA","GATWICK","DALLAS/FORT WORTH",0,0,0
2015,"UNITED STATES OF AMERICA","USA","GATWICK","DETROIT",0,0,0
2015,"UNITED STATES OF AMERICA","USA","GATWICK","FORT LAUDERDALE",40848,40848,0
2015,"UNITED STATES OF AMERICA","USA","GATWICK","JACKSONVILLE",0,0,0
2015,"UNITED STATES OF AMERICA","USA","GATWICK","LAS VEGAS",309622,309622,0
2015,"UNITED STATES OF AMERICA","USA","GATWICK","LOS ANGELES INTERNATIONAL",88490,88391,99
2015,"UNITED STATES OF AMERICA","USA","GATWICK","NEW YORK (JF KENNEDY)",147879,147879,0
2015,"UNITED STATES OF AMERICA","USA","GATWICK","OAKLAND",0,0,0
2015,"UNITED STATES OF AMERICA","USA","GATWICK","ORLANDO",737221,737221,0
2015,"UNITED STATES OF AMERICA","USA","GATWICK","SANFORD",49491,0,49491
2015,"UNITED STATES OF AMERICA","USA","GATWICK","TAMPA",158156,158156,0
2015,"UNITED STATES OF AMERICA","USA","GATWICK","WASHINGTON (DULLES)",81,0,81
2015,"UNITED STATES OF AMERICA","USA","HEATHROW","ATLANTA",611883,611883,0
2015,"UNITED STATES OF AMERICA","USA","HEATHROW","AUSTIN (BERGSTROM)",124495,124495,0
2015,"UNITED STATES OF AMERICA","USA","HEATHROW","BALTIMORE",113531,113531,0
2015,"UNITED STATES OF AMERICA","USA","HEATHROW","BOSTON",858358,858358,0
2015,"UNITED STATES OF AMERICA","USA","HEATHROW","BUFFALO",361,0,361
2015,"UNITED STATES OF AMERICA","USA","HEATHROW","CHARLOTTE",292938,292938,0
2015,"UNITED STATES OF AMERICA","USA","HEATHROW","CHICAGO (O'HARE)",1059686,1059686,0
2015,"UNITED STATES OF AMERICA","USA","HEATHROW","COLUMBUS RICKENBACKER AFB",529,0,529
2015,"UNITED STATES OF AMERICA","USA","HEATHROW","DALLAS/FORT WORTH",637977,637977,0
2015,"UNITED STATES OF AMERICA","USA","HEATHROW","DENVER INTERNATIONAL",187639,187639,0
2015,"UNITED STATES OF AMERICA","USA","HEATHROW","DETROIT",191483,191189,294
2015,"UNITED STATES OF AMERICA","USA","HEATHROW","FORT LAUDERDALE",179,0,179
2015,"UNITED STATES OF AMERICA","USA","HEATHROW","HOUSTON",564300,564300,0
2015,"UNITED STATES OF AMERICA","USA","HEATHROW","JACKSONVILLE",404,0,404
2015,"UNITED STATES OF AMERICA","USA","HEATHROW","KANSAS CITY",403,0,403
2015,"UNITED STATES OF AMERICA","USA","HEATHROW","LAS VEGAS",231104,231104,0
2015,"UNITED STATES OF AMERICA","USA","HEATHROW","LOS ANGELES INTERNATIONAL",1518903,1518903,0
2015,"UNITED STATES OF AMERICA","USA","HEATHROW","MIAMI INTERNATIONAL",1030673,1030489,184
2015,"UNITED STATES OF AMERICA","USA","HEATHROW","MINNEAPOLIS-ST PAUL",138063,138063,0
2015,"UNITED STATES OF AMERICA","USA","HEATHROW","NEW YORK (JF KENNEDY)",3050499,3050499,0
2015,"UNITED STATES OF AMERICA","USA","HEATHROW","NEW YORK (NEWARK)",999986,999577,409
2015,"UNITED STATES OF AMERICA","USA","HEATHROW","ORLANDO",653,0,653
2015,"UNITED STATES OF AMERICA","USA","HEATHROW","PHILADELPHIA INTERNATIONAL",468083,468083,0
2015,"UNITED STATES OF AMERICA","USA","HEATHROW","PHOENIX",216935,216935,0
2015,"UNITED STATES OF AMERICA","USA","HEATHROW","RALEIGH",115279,115279,0
2015,"UNITED STATES OF AMERICA","USA","HEATHROW","SAN DIEGO",177623,177623,0
2015,"UNITED STATES OF AMERICA","USA","HEATHROW","SAN FRANCISCO",1046981,1046981,0
2015,"UNITED STATES OF AMERICA","USA","HEATHROW","SEATTLE (TACOMA)",349759,349759,0
2015,"UNITED STATES OF AMERICA","USA","HEATHROW","WASHINGTON (DULLES)",866457,866457,0
2015,"UNITED STATES OF AMERICA","USA","LONDON CITY","NEW YORK (JF KENNEDY)",21375,21375,0
2015,"UNITED STATES OF AMERICA","USA","LUTON","BALTIMORE",0,0,0
2015,"UNITED STATES OF AMERICA","USA","LUTON","BOSTON",6,0,6
2015,"UNITED STATES OF AMERICA","USA","LUTON","DALLAS",2,0,2
2015,"UNITED STATES OF AMERICA","USA","LUTON","MILWAUKEE",78,0,78
2015,"UNITED STATES OF AMERICA","USA","LUTON","NEW YORK (JF KENNEDY)",27,0,27
2015,"UNITED STATES OF AMERICA","USA","LUTON","NEW YORK (NEWARK)",12660,12660,0
2015,"UNITED STATES OF AMERICA","USA","SOUTHEND","LOS ANGELES INTERNATIONAL",8,0,8
2015,"UNITED STATES OF AMERICA","USA","STANSTED","LAS VEGAS",3226,3226,0
2015,"UNITED STATES OF AMERICA","USA","STANSTED","ORLANDO",6340,6340,0
2015,"CENTRAL AMERICA","COSTA RICA","GATWICK","LIBERIA",4454,0,4454
2015,"CENTRAL AMERICA","CUBA","GATWICK","CUNAGUA (CAYO COCO)",0,0,0
2015,"CENTRAL AMERICA","CUBA","GATWICK","HAVANA",85995,85995,0
2015,"CENTRAL AMERICA","CUBA","GATWICK","HOLGUIN (FRANK PAIS)",32605,5188,27417
2015,"CENTRAL AMERICA","DOMINICAN REPUBLIC","GATWICK","PUERTO PLATA",30733,0,30733
2015,"CENTRAL AMERICA","DOMINICAN REPUBLIC","GATWICK","PUNTA CANA",139339,53046,86293
2015,"CENTRAL AMERICA","MEXICO","GATWICK","CANCUN",400189,247006,153183
2015,"CENTRAL AMERICA","MEXICO","GATWICK","PUERTO VALLARTA",29385,0,29385
2015,"CENTRAL AMERICA","MEXICO","HEATHROW","MEXICO CITY",232998,232998,0
2015,"CENTRAL AMERICA","MEXICO","STANSTED","CANCUN",3213,3213,0
2015,"SOUTH AMERICA","ARGENTINA","HEATHROW","BUENOS AIRES",151603,151190,413
2015,"SOUTH AMERICA","BRAZIL","GATWICK","BELO HORIZONTE",0,0,0
2015,"SOUTH AMERICA","BRAZIL","GATWICK","MANAUS-EDUARDO GOMES",0,0,0
2015,"SOUTH AMERICA","BRAZIL","HEATHROW","RIO DE JANEIRO (GALEAO)",166647,166647,0
2015,"SOUTH AMERICA","BRAZIL","HEATHROW","SAO PAULO (GUARULHOS)",462775,462775,0
2015,"SOUTH AMERICA","BRAZIL","LUTON","RIO DE JANEIRO (GALEAO)",0,0,0
2015,"SOUTH AMERICA","CHILE","GATWICK","SANTIAGO DE CHILE",0,0,0
2015,"SOUTH AMERICA","COLOMBIA","HEATHROW","BOGOTA",109427,109427,0
2015,"SOUTH AMERICA","VENEZUELA","HEATHROW","CARACAS",235,0,235
2015,"CARIBBEAN AREA","ANTIGUA AND BARBUDA","GATWICK","ANTIGUA",108406,108406,0
2015,"CARIBBEAN AREA","BAHAMAS","HEATHROW","NASSAU",52503,52503,0
2015,"CARIBBEAN AREA","BARBADOS","GATWICK","BRIDGETOWN",433135,373150,59985
2015,"CARIBBEAN AREA","BARBADOS","LUTON","BRIDGETOWN",38,0,38
2015,"CARIBBEAN AREA","BARBADOS","STANSTED","BRIDGETOWN",188,0,188
2015,"CARIBBEAN AREA","BERMUDA","GATWICK","BERMUDA",92674,92674,0
2015,"CARIBBEAN AREA","CAYMAN ISLANDS","HEATHROW","GRAND CAYMAN",31576,31576,0
2015,"CARIBBEAN AREA","GRENADA","GATWICK","GRENADA",98985,98985,0
2015,"CARIBBEAN AREA","ISLE OF CURACAO NETH.ANTILLES","GATWICK","ARUBA",16282,0,16282
2015,"CARIBBEAN AREA","JAMAICA","GATWICK","KINGSTON",86131,86131,0
2015,"CARIBBEAN AREA","JAMAICA","GATWICK","MONTEGO BAY",206334,115514,90820
2015,"CARIBBEAN AREA","PUERTO RICO","GATWICK","SAN JUAN (PUERTO RICO)",8181,8181,0
2015,"CARIBBEAN AREA","SAINT KITTS AND NEVIS","GATWICK","ST KITTS",52310,52310,0
2015,"CARIBBEAN AREA","SAINT KITTS AND NEVIS","STANSTED","ST KITTS",353,0,353
2015,"CARIBBEAN AREA","ST LUCIA","GATWICK","ST LUCIA (HEWANORRA)",18302,18302,0
2015,"CARIBBEAN AREA","TRINIDAD AND TOBAGO","GATWICK","PORT OF SPAIN",178170,178170,0
2015,"CARIBBEAN AREA","TRINIDAD AND TOBAGO","GATWICK","TOBAGO",81558,70539,11019
2015,"CARIBBEAN AREA","TURKS AND CAICOS ISLANDS","GATWICK","PROVIDENCIALES",22645,22645,0
2015,"CARIBBEAN AREA","TURKS AND CAICOS ISLANDS","HEATHROW","PROVIDENCIALES",1567,1567,0
2015,"INDIAN OCEAN ISLANDS","MALDIVE ISLANDS","GATWICK","MALE INTERNATIONAL",10178,10178,0
2015,"INDIAN OCEAN ISLANDS","MAURITIUS","GATWICK","MAURITIUS",109018,108782,236
2015,"INDIAN OCEAN ISLANDS","MAURITIUS","HEATHROW","MAURITIUS",81497,81497,0
2015,"INDIAN OCEAN ISLANDS","MAURITIUS","STANSTED","MAURITIUS",214,0,214
2015,"ATLANTIC OCEAN ISLANDS","CAPE VERDE ISLANDS","GATWICK","BOA VISTA (RABIL)",47141,47141,0
2015,"ATLANTIC OCEAN ISLANDS","CAPE VERDE ISLANDS","GATWICK","ILHA DO SAL C.VERDE",78621,66974,11647
2015,"ATLANTIC OCEAN ISLANDS","CAPE VERDE ISLANDS","GATWICK","SAN PEDRO (CAPE VERDE)",191,0,191
2015,"ATLANTIC OCEAN ISLANDS","CAPE VERDE ISLANDS","LUTON","ILHA DO SAL C.VERDE",0,0,0
2015,"ATLANTIC OCEAN ISLANDS","FALKLAND ISLANDS","GATWICK","MOUNT PLEASANT",426,0,426
2016,"Unknown","Unknown","GATWICK","Unknown",53,53,0
2016,"Unknown","Unknown","STANSTED","Unknown",1271,1271,0
2016,"WESTERN EUROPE-EU","AUSTRIA","GATWICK","GRAZ",0,0,0
2016,"WESTERN EUROPE-EU","AUSTRIA","GATWICK","INNSBRUCK",192361,169395,22966
2016,"WESTERN EUROPE-EU","AUSTRIA","GATWICK","SALZBURG",138933,118692,20241
2016,"WESTERN EUROPE-EU","AUSTRIA","GATWICK","VIENNA",251430,251430,0
2016,"WESTERN EUROPE-EU","AUSTRIA","HEATHROW","INNSBRUCK",3969,3969,0
2016,"WESTERN EUROPE-EU","AUSTRIA","HEATHROW","SALZBURG",8981,8981,0
2016,"WESTERN EUROPE-EU","AUSTRIA","HEATHROW","VIENNA",794806,794806,0
2016,"WESTERN EUROPE-EU","AUSTRIA","LONDON CITY","GRAZ",711,0,711
2016,"WESTERN EUROPE-EU","AUSTRIA","LUTON","GRAZ",920,0,920
2016,"WESTERN EUROPE-EU","AUSTRIA","LUTON","INNSBRUCK",6932,6932,0
2016,"WESTERN EUROPE-EU","AUSTRIA","LUTON","KLAGENFURT",19,0,19
2016,"WESTERN EUROPE-EU","AUSTRIA","LUTON","SALZBURG",8646,4980,3666
2016,"WESTERN EUROPE-EU","AUSTRIA","LUTON","VIENNA",52839,52831,8
2016,"WESTERN EUROPE-EU","AUSTRIA","STANSTED","INNSBRUCK",9260,0,9260
2016,"WESTERN EUROPE-EU","AUSTRIA","STANSTED","LINZ",32799,32799,0
2016,"WESTERN EUROPE-EU","AUSTRIA","STANSTED","SALZBURG",95893,92423,3470
2016,"WESTERN EUROPE-EU","AUSTRIA","STANSTED","VIENNA",98741,98741,0
2016,"WESTERN EUROPE-EU","BELGIUM","GATWICK","BRUSSELS",14742,14742,0
2016,"WESTERN EUROPE-EU","BELGIUM","HEATHROW","BRUSSELS",571967,571967,0
2016,"WESTERN EUROPE-EU","BELGIUM","HEATHROW","LIEGE",3076,3076,0
2016,"WESTERN EUROPE-EU","BELGIUM","LONDON CITY","ANTWERP",54885,54885,0
2016,"WESTERN EUROPE-EU","BELGIUM","LUTON","BRUSSELS",50,0,50
2016,"WESTERN EUROPE-EU","BELGIUM","LUTON","LIEGE",10,0,10
2016,"WESTERN EUROPE-EU","BELGIUM","LUTON","OSTEND",152,152,0
2016,"WESTERN EUROPE-EU","BELGIUM","SOUTHEND","ANTWERP",313,313,0
2016,"WESTERN EUROPE-EU","BELGIUM","STANSTED","BRUSSELS",0,0,0
2016,"WESTERN EUROPE-EU","CROATIA","GATWICK","DUBROVNIK",221326,220003,1323
2016,"WESTERN EUROPE-EU","CROATIA","GATWICK","PULA",44969,28127,16842
2016,"WESTERN EUROPE-EU","CROATIA","GATWICK","SPLIT",150287,141776,8511
2016,"WESTERN EUROPE-EU","CROATIA","GATWICK","ZAGREB",375,375,0
2016,"WESTERN EUROPE-EU","CROATIA","HEATHROW","DUBROVNIK",143,143,0
2016,"WESTERN EUROPE-EU","CROATIA","HEATHROW","RIJEKA",2928,2928,0
2016,"WESTERN EUROPE-EU","CROATIA","HEATHROW","SPLIT",32240,32240,0
2016,"WESTERN EUROPE-EU","CROATIA","HEATHROW","ZAGREB",179912,179912,0
2016,"WESTERN EUROPE-EU","CROATIA","LUTON","DUBROVNIK",14018,13979,39
2016,"WESTERN EUROPE-EU","CROATIA","LUTON","SPLIT",62532,62532,0
2016,"WESTERN EUROPE-EU","CROATIA","LUTON","ZAGREB",0,0,0
2016,"WESTERN EUROPE-EU","CROATIA","STANSTED","DUBROVNIK",28837,28196,641
2016,"WESTERN EUROPE-EU","CROATIA","STANSTED","OSIJEK",20702,20702,0
2016,"WESTERN EUROPE-EU","CROATIA","STANSTED","PULA",23048,23048,0
2016,"WESTERN EUROPE-EU","CROATIA","STANSTED","RIJEKA",10958,10958,0
2016,"WESTERN EUROPE-EU","CROATIA","STANSTED","SPLIT",26774,26774,0
2016,"WESTERN EUROPE-EU","CROATIA","STANSTED","ZADAR",32662,32479,183
2016,"WESTERN EUROPE-EU","CYPRUS","GATWICK","LARNACA",283878,229224,54654
2016,"WESTERN EUROPE-EU","CYPRUS","GATWICK","PAPHOS",395399,293918,101481
2016,"WESTERN EUROPE-EU","CYPRUS","HEATHROW","LARNACA",306994,306994,0
2016,"WESTERN EUROPE-EU","CYPRUS","LUTON","LARNACA",81058,71912,9146
2016,"WESTERN EUROPE-EU","CYPRUS","LUTON","PAPHOS",97412,61974,35438
2016,"WESTERN EUROPE-EU","CYPRUS","STANSTED","LARNACA",49805,49805,0
2016,"WESTERN EUROPE-EU","CYPRUS","STANSTED","PAPHOS",167666,131368,36298
2016,"WESTERN EUROPE-EU","DENMARK","GATWICK","AALBORG",33694,33694,0
2016,"WESTERN EUROPE-EU","DENMARK","GATWICK","COPENHAGEN",777585,777584,1
2016,"WESTERN EUROPE-EU","DENMARK","HEATHROW","BILLUND",82007,82007,0
2016,"WESTERN EUROPE-EU","DENMARK","HEATHROW","COPENHAGEN",949566,949566,0
2016,"WESTERN EUROPE-EU","DENMARK","LONDON CITY","BILLUND",19457,19457,0
2016,"WESTERN EUROPE-EU","DENMARK","LUTON","AARHUS (TIRSTRUP)",27,0,27
2016,"WESTERN EUROPE-EU","DENMARK","LUTON","BILLUND",0,0,0
2016,"WESTERN EUROPE-EU","DENMARK","LUTON","COPENHAGEN",767732,767723,9
2016,"WESTERN EUROPE-EU","DENMARK","LUTON","ODENSE",0,0,0
2016,"WESTERN EUROPE-EU","DENMARK","LUTON","ROSKILDE",0,0,0
2016,"WESTERN EUROPE-EU","DENMARK","SOUTHEND","BILLUND",324,287,37
2016,"WESTERN EUROPE-EU","DENMARK","STANSTED","AARHUS (TIRSTRUP)",95795,95795,0
2016,"WESTERN EUROPE-EU","DENMARK","STANSTED","BILLUND",211729,211729,0
2016,"WESTERN EUROPE-EU","DENMARK","STANSTED","COPENHAGEN",377,0,377
2016,"WESTERN EUROPE-EU","FINLAND","GATWICK","ENONTEKIO",5058,0,5058
2016,"WESTERN EUROPE-EU","FINLAND","GATWICK","HELSINKI",226870,226681,189
2016,"WESTERN EUROPE-EU","FINLAND","GATWICK","IVALO",9043,0,9043
2016,"WESTERN EUROPE-EU","FINLAND","GATWICK","KITTILA",18825,3504,15321
2016,"WESTERN EUROPE-EU","FINLAND","GATWICK","KUUSAMO",4201,0,4201
2016,"WESTERN EUROPE-EU","FINLAND","GATWICK","ROVANIEMI",17448,3903,13545
2016,"WESTERN EUROPE-EU","FINLAND","HEATHROW","HELSINKI",677413,677263,150
2016,"WESTERN EUROPE-EU","FINLAND","LUTON","ENONTEKIO",202,0,202
2016,"WESTERN EUROPE-EU","FINLAND","LUTON","IVALO",886,0,886
2016,"WESTERN EUROPE-EU","FINLAND","LUTON","KITTILA",0,0,0
2016,"WESTERN EUROPE-EU","FINLAND","LUTON","TAMPERE",0,0,0
2016,"WESTERN EUROPE-EU","FINLAND","LUTON","VAASA",21,0,21
2016,"WESTERN EUROPE-EU","FINLAND","STANSTED","ENONTEKIO",1510,0,1510
2016,"WESTERN EUROPE-EU","FINLAND","STANSTED","HELSINKI",162,0,162
2016,"WESTERN EUROPE-EU","FINLAND","STANSTED","IVALO",1443,0,1443
2016,"WESTERN EUROPE-EU","FINLAND","STANSTED","KITTILA",1179,0,1179
2016,"WESTERN EUROPE-EU","FINLAND","STANSTED","ROVANIEMI",376,0,376
2016,"WESTERN EUROPE-EU","FINLAND","STANSTED","TAMPERE",0,0,0
2016,"WESTERN EUROPE-EU","FRANCE","GATWICK","AJACCIO",7746,7568,178
2016,"WESTERN EUROPE-EU","FRANCE","GATWICK","BASTIA",10992,10992,0
2016,"WESTERN EUROPE-EU","FRANCE","GATWICK","BIARRITZ",24547,24546,1
2016,"WESTERN EUROPE-EU","FRANCE","GATWICK","BORDEAUX",313399,313397,2
2016,"WESTERN EUROPE-EU","FRANCE","GATWICK","BREST",0,0,0
2016,"WESTERN EUROPE-EU","FRANCE","GATWICK","CHAMBERY",46781,0,46781
2016,"WESTERN EUROPE-EU","FRANCE","GATWICK","CLERMONT FERRAND",0,0,0
2016,"WESTERN EUROPE-EU","FRANCE","GATWICK","FIGARI",4576,4576,0
2016,"WESTERN EUROPE-EU","FRANCE","GATWICK","GRENOBLE",125656,57000,68656
2016,"WESTERN EUROPE-EU","FRANCE","GATWICK","LA ROCHELLE",23307,23307,0
2016,"WESTERN EUROPE-EU","FRANCE","GATWICK","LE HAVRE",202,0,202
2016,"WESTERN EUROPE-EU","FRANCE","GATWICK","LILLE",0,0,0
2016,"WESTERN EUROPE-EU","FRANCE","GATWICK","LYON",213720,190325,23395
2016,"WESTERN EUROPE-EU","FRANCE","GATWICK","MARSEILLE",152311,152311,0
2016,"WESTERN EUROPE-EU","FRANCE","GATWICK","MONTPELLIER",138595,138595,0
2016,"WESTERN EUROPE-EU","FRANCE","GATWICK","NANTES",143931,143857,74
2016,"WESTERN EUROPE-EU","FRANCE","GATWICK","NICE",594693,593314,1379
2016,"WESTERN EUROPE-EU","FRANCE","GATWICK","PARIS (CHARLES DE GAULLE)",329847,329605,242
2016,"WESTERN EUROPE-EU","FRANCE","GATWICK","PARIS (LE BOURGET)",206,0,206
2016,"WESTERN EUROPE-EU","FRANCE","GATWICK","PARIS (ORLY)",1,0,1
2016,"WESTERN EUROPE-EU","FRANCE","GATWICK","RENNES",2135,2102,33
2016,"WESTERN EUROPE-EU","FRANCE","GATWICK","STRASBOURG",9527,9527,0
2016,"WESTERN EUROPE-EU","FRANCE","GATWICK","TARBES-LOURDES INTERNATIONAL",2203,0,2203
2016,"WESTERN EUROPE-EU","FRANCE","GATWICK","TOULON / HYERES",0,0,0
2016,"WESTERN EUROPE-EU","FRANCE","GATWICK","TOULOUSE (BLAGNAC)",281826,275473,6353
2016,"WESTERN EUROPE-EU","FRANCE","HEATHROW","BASTIA",4825,0,4825
2016,"WESTERN EUROPE-EU","FRANCE","HEATHROW","BIARRITZ",10131,10131,0
2016,"WESTERN EUROPE-EU","FRANCE","HEATHROW","FIGARI",5986,0,5986
2016,"WESTERN EUROPE-EU","FRANCE","HEATHROW","GRENOBLE",6409,0,6409
2016,"WESTERN EUROPE-EU","FRANCE","HEATHROW","LYON",254759,254759,0
2016,"WESTERN EUROPE-EU","FRANCE","HEATHROW","MARSEILLE",260601,260601,0
2016,"WESTERN EUROPE-EU","FRANCE","HEATHROW","NICE",541715,541715,0
2016,"WESTERN EUROPE-EU","FRANCE","HEATHROW","PARIS (CHARLES DE GAULLE)",1143213,1142954,259
2016,"WESTERN EUROPE-EU","FRANCE","HEATHROW","PARIS (LE BOURGET)",0,0,0
2016,"WESTERN EUROPE-EU","FRANCE","HEATHROW","PARIS (ORLY)",282673,282673,0
2016,"WESTERN EUROPE-EU","FRANCE","HEATHROW","TOULOUSE (BLAGNAC)",260366,260366,0
2016,"WESTERN EUROPE-EU","FRANCE","LONDON CITY","ANGERS- MARCE",6208,6208,0
2016,"WESTERN EUROPE-EU","FRANCE","LONDON CITY","AVIGNON",2801,2801,0
2016,"WESTERN EUROPE-EU","FRANCE","LONDON CITY","BERGERAC",8810,8810,0
2016,"WESTERN EUROPE-EU","FRANCE","LONDON CITY","BRIVE-LA-GAILLARDE",0,0,0
2016,"WESTERN EUROPE-EU","FRANCE","LONDON CITY","CHAMBERY",6314,6314,0
2016,"WESTERN EUROPE-EU","FRANCE","LONDON CITY","DINARD",127,0,127
2016,"WESTERN EUROPE-EU","FRANCE","LONDON CITY","GRENOBLE",174,174,0
2016,"WESTERN EUROPE-EU","FRANCE","LONDON CITY","MARSEILLE",0,0,0
2016,"WESTERN EUROPE-EU","FRANCE","LONDON CITY","NANTES",25971,25971,0
2016,"WESTERN EUROPE-EU","FRANCE","LONDON CITY","NICE",37244,37244,0
2016,"WESTERN EUROPE-EU","FRANCE","LONDON CITY","PARIS (CHARLES DE GAULLE)",13036,13036,0
2016,"WESTERN EUROPE-EU","FRANCE","LONDON CITY","PARIS (ORLY)",111015,111015,0
2016,"WESTERN EUROPE-EU","FRANCE","LONDON CITY","QUIMPER",7147,7147,0
2016,"WESTERN EUROPE-EU","FRANCE","LONDON CITY","RENNES",4241,4241,0
2016,"WESTERN EUROPE-EU","FRANCE","LONDON CITY","TOULON / HYERES",5091,5091,0
2016,"WESTERN EUROPE-EU","FRANCE","LUTON","BEZIERS",54624,54624,0
2016,"WESTERN EUROPE-EU","FRANCE","LUTON","BORDEAUX",79615,79615,0
2016,"WESTERN EUROPE-EU","FRANCE","LUTON","BREST",482,482,0
2016,"WESTERN EUROPE-EU","FRANCE","LUTON","CANNES",8,0,8
2016,"WESTERN EUROPE-EU","FRANCE","LUTON","CHAMBERY",71,0,71
2016,"WESTERN EUROPE-EU","FRANCE","LUTON","CLERMONT FERRAND",633,633,0
2016,"WESTERN EUROPE-EU","FRANCE","LUTON","DEAUVILLE",13,0,13
2016,"WESTERN EUROPE-EU","FRANCE","LUTON","GRENOBLE",6079,5852,227
2016,"WESTERN EUROPE-EU","FRANCE","LUTON","LILLE",92,0,92
2016,"WESTERN EUROPE-EU","FRANCE","LUTON","LYON",87774,87292,482
2016,"WESTERN EUROPE-EU","FRANCE","LUTON","LYON(BRON)",0,0,0
2016,"WESTERN EUROPE-EU","FRANCE","LUTON","MARSEILLE",319,0,319
2016,"WESTERN EUROPE-EU","FRANCE","LUTON","METZ",0,0,0
2016,"WESTERN EUROPE-EU","FRANCE","LUTON","MONTPELLIER",17776,17754,22
2016,"WESTERN EUROPE-EU","FRANCE","LUTON","NICE",155655,154623,1032
2016,"WESTERN EUROPE-EU","FRANCE","LUTON","NIMES",79295,79295,0
2016,"WESTERN EUROPE-EU","FRANCE","LUTON","PARIS (CHARLES DE GAULLE)",254009,253708,301
2016,"WESTERN EUROPE-EU","FRANCE","LUTON","PARIS (LE BOURGET)",140,5,135
2016,"WESTERN EUROPE-EU","FRANCE","LUTON","PARIS (ORLY)",80100,80100,0
2016,"WESTERN EUROPE-EU","FRANCE","LUTON","PAU",0,0,0
2016,"WESTERN EUROPE-EU","FRANCE","LUTON","POITIERS",0,0,0
2016,"WESTERN EUROPE-EU","FRANCE","LUTON","RODEZ",1,0,1
2016,"WESTERN EUROPE-EU","FRANCE","LUTON","ST ETIENNE",289,0,289
2016,"WESTERN EUROPE-EU","FRANCE","LUTON","STRASBOURG",39,39,0
2016,"WESTERN EUROPE-EU","FRANCE","LUTON","TOULON / HYERES",265,0,265
2016,"WESTERN EUROPE-EU","FRANCE","LUTON","TOULOUSE (BLAGNAC)",14126,13935,191
2016,"WESTERN EUROPE-EU","FRANCE","SOUTHEND","CAEN",12566,12566,0
2016,"WESTERN EUROPE-EU","FRANCE","SOUTHEND","LYON",3855,3855,0
2016,"WESTERN EUROPE-EU","FRANCE","SOUTHEND","NANTES",233,233,0
2016,"WESTERN EUROPE-EU","FRANCE","SOUTHEND","PARIS (CHARLES DE GAULLE)",38308,38308,0
2016,"WESTERN EUROPE-EU","FRANCE","SOUTHEND","PARIS (ORLY)",125,125,0
2016,"WESTERN EUROPE-EU","FRANCE","SOUTHEND","PAU",0,0,0
2016,"WESTERN EUROPE-EU","FRANCE","SOUTHEND","RENNES",41957,41957,0
2016,"WESTERN EUROPE-EU","FRANCE","SOUTHEND","TOULON / HYERES",62,62,0
2016,"WESTERN EUROPE-EU","FRANCE","STANSTED","BERGERAC",104052,104052,0
2016,"WESTERN EUROPE-EU","FRANCE","STANSTED","BIARRITZ",98183,98183,0
2016,"WESTERN EUROPE-EU","FRANCE","STANSTED","BORDEAUX",59723,59723,0
2016,"WESTERN EUROPE-EU","FRANCE","STANSTED","BREST",659,659,0
2016,"WESTERN EUROPE-EU","FRANCE","STANSTED","BRIVE-LA-GAILLARDE",19414,19414,0
2016,"WESTERN EUROPE-EU","FRANCE","STANSTED","CALVI",4340,0,4340
2016,"WESTERN EUROPE-EU","FRANCE","STANSTED","CARCASSONNE",99853,99853,0
2016,"WESTERN EUROPE-EU","FRANCE","STANSTED","CHAMBERY",19296,535,18761
2016,"WESTERN EUROPE-EU","FRANCE","STANSTED","CLERMONT FERRAND",0,0,0
2016,"WESTERN EUROPE-EU","FRANCE","STANSTED","DEAUVILLE",16892,16892,0
2016,"WESTERN EUROPE-EU","FRANCE","STANSTED","DINARD",77861,77861,0
2016,"WESTERN EUROPE-EU","FRANCE","STANSTED","GRENOBLE",22233,18005,4228
2016,"WESTERN EUROPE-EU","FRANCE","STANSTED","LA ROCHELLE",61930,61930,0
2016,"WESTERN EUROPE-EU","FRANCE","STANSTED","LIMOGES",99923,99923,0
2016,"WESTERN EUROPE-EU","FRANCE","STANSTED","LYON",493,0,493
2016,"WESTERN EUROPE-EU","FRANCE","STANSTED","MARSEILLE",141294,140727,567
2016,"WESTERN EUROPE-EU","FRANCE","STANSTED","NICE",63775,62660,1115
2016,"WESTERN EUROPE-EU","FRANCE","STANSTED","PARIS (CHARLES DE GAULLE)",0,0,0
2016,"WESTERN EUROPE-EU","FRANCE","STANSTED","PARIS (ORLY)",399,107,292
2016,"WESTERN EUROPE-EU","FRANCE","STANSTED","PAU",177,177,0
2016,"WESTERN EUROPE-EU","FRANCE","STANSTED","PERPIGNAN",47176,47176,0
2016,"WESTERN EUROPE-EU","FRANCE","STANSTED","POITIERS",57904,57904,0
2016,"WESTERN EUROPE-EU","FRANCE","STANSTED","RENNES",819,517,302
2016,"WESTERN EUROPE-EU","FRANCE","STANSTED","RODEZ",0,0,0
2016,"WESTERN EUROPE-EU","FRANCE","STANSTED","ST ETIENNE",542,542,0
2016,"WESTERN EUROPE-EU","FRANCE","STANSTED","STRASBOURG",0,0,0
2016,"WESTERN EUROPE-EU","FRANCE","STANSTED","TARBES-LOURDES INTERNATIONAL",53985,47186,6799
2016,"WESTERN EUROPE-EU","FRANCE","STANSTED","TOULOUSE (BLAGNAC)",17337,17337,0
2016,"WESTERN EUROPE-EU","FRANCE","STANSTED","TOURS",64257,64257,0
2016,"WESTERN EUROPE-EU","GERMANY","GATWICK","BERLIN (SCHONEFELD)",592605,591843,762
2016,"WESTERN EUROPE-EU","GERMANY","GATWICK","BERLIN (TEGEL)",0,0,0
2016,"WESTERN EUROPE-EU","GERMANY","GATWICK","BREMEN",10,0,10
2016,"WESTERN EUROPE-EU","GERMANY","GATWICK","COLOGNE BONN",11625,11313,312
2016,"WESTERN EUROPE-EU","GERMANY","GATWICK","DUSSELDORF",14202,14077,125
2016,"WESTERN EUROPE-EU","GERMANY","GATWICK","ERFURT",0,0,0
2016,"WESTERN EUROPE-EU","GERMANY","GATWICK","FRANKFURT MAIN",36,36,0
2016,"WESTERN EUROPE-EU","GERMANY","GATWICK","FRIEDRICHSHAFEN",25219,13344,11875
2016,"WESTERN EUROPE-EU","GERMANY","GATWICK","HAMBURG",157823,157823,0
2016,"WESTERN EUROPE-EU","GERMANY","GATWICK","LEIPZIG",0,0,0
2016,"WESTERN EUROPE-EU","GERMANY","GATWICK","MUNICH",236275,236272,3
2016,"WESTERN EUROPE-EU","GERMANY","GATWICK","STUTTGART",131095,131094,1
2016,"WESTERN EUROPE-EU","GERMANY","HEATHROW","BERLIN (TEGEL)",811434,811434,0
2016,"WESTERN EUROPE-EU","GERMANY","HEATHROW","COLOGNE BONN",178918,178918,0
2016,"WESTERN EUROPE-EU","GERMANY","HEATHROW","DORTMUND",117,117,0
2016,"WESTERN EUROPE-EU","GERMANY","HEATHROW","DUSSELDORF",718470,718470,0
2016,"WESTERN EUROPE-EU","GERMANY","HEATHROW","FRANKFURT MAIN",1493204,1493204,0
2016,"WESTERN EUROPE-EU","GERMANY","HEATHROW","FRIEDRICHSHAFEN",665,0,665
2016,"WESTERN EUROPE-EU","GERMANY","HEATHROW","HAMBURG",577265,577265,0
2016,"WESTERN EUROPE-EU","GERMANY","HEATHROW","HANOVER",202112,202112,0
2016,"WESTERN EUROPE-EU","GERMANY","HEATHROW","MUNICH",1215546,1215546,0
2016,"WESTERN EUROPE-EU","GERMANY","HEATHROW","STUTTGART",315768,315768,0
2016,"WESTERN EUROPE-EU","GERMANY","LONDON CITY","BERLIN (TEGEL)",54729,54729,0
2016,"WESTERN EUROPE-EU","GERMANY","LONDON CITY","BREMEN",1720,1720,0
2016,"WESTERN EUROPE-EU","GERMANY","LONDON CITY","DRESDEN",0,0,0
2016,"WESTERN EUROPE-EU","GERMANY","LONDON CITY","DUSSELDORF",74580,74580,0
2016,"WESTERN EUROPE-EU","GERMANY","LONDON CITY","FRANKFURT MAIN",241084,241084,0
2016,"WESTERN EUROPE-EU","GERMANY","LONDON CITY","HAMBURG",35378,35378,0
2016,"WESTERN EUROPE-EU","GERMANY","LONDON CITY","HANOVER",19,0,19
2016,"WESTERN EUROPE-EU","GERMANY","LONDON CITY","STUTTGART",144,0,144
2016,"WESTERN EUROPE-EU","GERMANY","LUTON","BERLIN (SCHONEFELD)",174320,174228,92
2016,"WESTERN EUROPE-EU","GERMANY","LUTON","BERLIN (TEGEL)",114,114,0
2016,"WESTERN EUROPE-EU","GERMANY","LUTON","COLOGNE BONN",710,154,556
2016,"WESTERN EUROPE-EU","GERMANY","LUTON","DORTMUND",90149,90149,0
2016,"WESTERN EUROPE-EU","GERMANY","LUTON","DUSSELDORF",5,0,5
2016,"WESTERN EUROPE-EU","GERMANY","LUTON","ERFURT",1,0,1
2016,"WESTERN EUROPE-EU","GERMANY","LUTON","FRANKFURT MAIN",10,0,10
2016,"WESTERN EUROPE-EU","GERMANY","LUTON","FRIEDRICHSHAFEN",8,0,8
2016,"WESTERN EUROPE-EU","GERMANY","LUTON","HAHN",50,0,50
2016,"WESTERN EUROPE-EU","GERMANY","LUTON","HAMBURG",89949,89949,0
2016,"WESTERN EUROPE-EU","GERMANY","LUTON","HANOVER",76,0,76
2016,"WESTERN EUROPE-EU","GERMANY","LUTON","INGOLSTADT-MANCHING",0,0,0
2016,"WESTERN EUROPE-EU","GERMANY","LUTON","KARLSRUHE/BADEN BADEN",0,0,0
2016,"WESTERN EUROPE-EU","GERMANY","LUTON","KASSEL",2,0,2
2016,"WESTERN EUROPE-EU","GERMANY","LUTON","MAGDEBURG COCHSTEDT",0,0,0
2016,"WESTERN EUROPE-EU","GERMANY","LUTON","MUNICH",74486,74481,5
2016,"WESTERN EUROPE-EU","GERMANY","LUTON","MUNSTER-OSNABRUCK",0,0,0
2016,"WESTERN EUROPE-EU","GERMANY","LUTON","NUREMBERG",10,0,10
2016,"WESTERN EUROPE-EU","GERMANY","LUTON","PADERBORN",0,0,0
2016,"WESTERN EUROPE-EU","GERMANY","LUTON","STUTTGART",49,0,49
2016,"WESTERN EUROPE-EU","GERMANY","SOUTHEND","BERLIN (SCHONEFELD)",4824,4824,0
2016,"WESTERN EUROPE-EU","GERMANY","SOUTHEND","BERLIN (TEGEL)",57,57,0
2016,"WESTERN EUROPE-EU","GERMANY","SOUTHEND","DUSSELDORF",225,225,0
2016,"WESTERN EUROPE-EU","GERMANY","SOUTHEND","FRANKFURT MAIN",197,197,0
2016,"WESTERN EUROPE-EU","GERMANY","SOUTHEND","MUNSTER-OSNABRUCK",178,178,0
2016,"WESTERN EUROPE-EU","GERMANY","STANSTED","BERLIN (SCHONEFELD)",456246,456246,0
2016,"WESTERN EUROPE-EU","GERMANY","STANSTED","BERLIN (TEGEL)",4032,3704,328
2016,"WESTERN EUROPE-EU","GERMANY","STANSTED","BREMEN",193273,193273,0
2016,"WESTERN EUROPE-EU","GERMANY","STANSTED","COLOGNE BONN",451630,449918,1712
2016,"WESTERN EUROPE-EU","GERMANY","STANSTED","DORTMUND",118353,118353,0
2016,"WESTERN EUROPE-EU","GERMANY","STANSTED","DUSSELDORF",0,0,0
2016,"WESTERN EUROPE-EU","GERMANY","STANSTED","FRANKFURT MAIN",361,0,361
2016,"WESTERN EUROPE-EU","GERMANY","STANSTED","FRIEDRICHSHAFEN",187,187,0
2016,"WESTERN EUROPE-EU","GERMANY","STANSTED","HAHN",218822,218822,0
2016,"WESTERN EUROPE-EU","GERMANY","STANSTED","HAMBURG",36675,36675,0
2016,"WESTERN EUROPE-EU","GERMANY","STANSTED","HANOVER",66158,65596,562
2016,"WESTERN EUROPE-EU","GERMANY","STANSTED","KARLSRUHE/BADEN BADEN",111953,111953,0
2016,"WESTERN EUROPE-EU","GERMANY","STANSTED","LEIPZIG",49310,49310,0
2016,"WESTERN EUROPE-EU","GERMANY","STANSTED","MEMMINGEN ALLGAU",99577,99577,0
2016,"WESTERN EUROPE-EU","GERMANY","STANSTED","MUNICH",109047,108035,1012
2016,"WESTERN EUROPE-EU","GERMANY","STANSTED","MUNSTER-OSNABRUCK",0,0,0
2016,"WESTERN EUROPE-EU","GERMANY","STANSTED","NIEDERRHEIN",95800,95800,0
2016,"WESTERN EUROPE-EU","GERMANY","STANSTED","NUREMBERG",137742,137742,0
2016,"WESTERN EUROPE-EU","GERMANY","STANSTED","STUTTGART",74721,74721,0
2016,"WESTERN EUROPE-EU","GIBRALTAR","GATWICK","GIBRALTAR",190333,190333,0
2016,"WESTERN EUROPE-EU","GIBRALTAR","HEATHROW","GIBRALTAR",135692,135692,0
2016,"WESTERN EUROPE-EU","GIBRALTAR","LUTON","GIBRALTAR",59625,59625,0
2016,"WESTERN EUROPE-EU","GREECE","GATWICK","ATHENS",192751,192751,0
2016,"WESTERN EUROPE-EU","GREECE","GATWICK","CHANIA",108876,85715,23161
2016,"WESTERN EUROPE-EU","GREECE","GATWICK","CORFU",241922,174113,67809
2016,"WESTERN EUROPE-EU","GREECE","GATWICK","HERAKLION",322900,253694,69206
2016,"WESTERN EUROPE-EU","GREECE","GATWICK","KALAMATA",39650,39598,52
2016,"WESTERN EUROPE-EU","GREECE","GATWICK","KAVALA",20061,6140,13921
2016,"WESTERN EUROPE-EU","GREECE","GATWICK","KEFALLINIA",109527,74036,35491
2016,"WESTERN EUROPE-EU","GREECE","GATWICK","KOS",105800,38478,67322
2016,"WESTERN EUROPE-EU","GREECE","GATWICK","LEMNOS",1194,0,1194
2016,"WESTERN EUROPE-EU","GREECE","GATWICK","MIKONOS",80598,80598,0
2016,"WESTERN EUROPE-EU","GREECE","GATWICK","MYTILINI",9901,9901,0
2016,"WESTERN EUROPE-EU","GREECE","GATWICK","PREVEZA",95843,58551,37292
2016,"WESTERN EUROPE-EU","GREECE","GATWICK","RHODES",186917,117991,68926
2016,"WESTERN EUROPE-EU","GREECE","GATWICK","SALONIKA",155848,146032,9816
2016,"WESTERN EUROPE-EU","GREECE","GATWICK","SAMOS",9959,0,9959
2016,"WESTERN EUROPE-EU","GREECE","GATWICK","SKIATHOS",45779,17336,28443
2016,"WESTERN EUROPE-EU","GREECE","GATWICK","THIRA (SANTORINI)",106961,95045,11916
2016,"WESTERN EUROPE-EU","GREECE","GATWICK","VOLOS NEA ANCHILOS",2528,0,2528
2016,"WESTERN EUROPE-EU","GREECE","GATWICK","ZAKINTHOS",153071,93082,59989
2016,"WESTERN EUROPE-EU","GREECE","HEATHROW","ATHENS",736458,734410,2048
2016,"WESTERN EUROPE-EU","GREECE","HEATHROW","CHANIA",11396,11396,0
2016,"WESTERN EUROPE-EU","GREECE","HEATHROW","CORFU",46588,41533,5055
2016,"WESTERN EUROPE-EU","GREECE","HEATHROW","HERAKLION",132,132,0
2016,"WESTERN EUROPE-EU","GREECE","HEATHROW","KALAMATA",21822,11317,10505
2016,"WESTERN EUROPE-EU","GREECE","HEATHROW","KOS",14525,12090,2435
2016,"WESTERN EUROPE-EU","GREECE","HEATHROW","LEMNOS",14685,0,14685
2016,"WESTERN EUROPE-EU","GREECE","HEATHROW","MIKONOS",11132,11132,0
2016,"WESTERN EUROPE-EU","GREECE","HEATHROW","PREVEZA",17317,0,17317
2016,"WESTERN EUROPE-EU","GREECE","HEATHROW","RHODES",11396,0,11396
2016,"WESTERN EUROPE-EU","GREECE","HEATHROW","THIRA (SANTORINI)",23994,23994,0
2016,"WESTERN EUROPE-EU","GREECE","LONDON CITY","MIKONOS",6896,6896,0
2016,"WESTERN EUROPE-EU","GREECE","LONDON CITY","THIRA (SANTORINI)",3438,3438,0
2016,"WESTERN EUROPE-EU","GREECE","LUTON","ATHENS",170,170,0
2016,"WESTERN EUROPE-EU","GREECE","LUTON","CORFU",56800,42352,14448
2016,"WESTERN EUROPE-EU","GREECE","LUTON","HERAKLION",30338,20629,9709
2016,"WESTERN EUROPE-EU","GREECE","LUTON","KALAMATA",746,0,746
2016,"WESTERN EUROPE-EU","GREECE","LUTON","KEFALLINIA",7414,0,7414
2016,"WESTERN EUROPE-EU","GREECE","LUTON","MIKONOS",12192,12192,0
2016,"WESTERN EUROPE-EU","GREECE","LUTON","PATRAS",0,0,0
2016,"WESTERN EUROPE-EU","GREECE","LUTON","RHODES",18462,0,18462
2016,"WESTERN EUROPE-EU","GREECE","LUTON","SKIATHOS",8573,0,8573
2016,"WESTERN EUROPE-EU","GREECE","LUTON","THIRA (SANTORINI)",9,0,9
2016,"WESTERN EUROPE-EU","GREECE","LUTON","ZAKINTHOS",7326,0,7326
2016,"WESTERN EUROPE-EU","GREECE","STANSTED","ATHENS",246555,246427,128
2016,"WESTERN EUROPE-EU","GREECE","STANSTED","CHANIA",25441,25441,0
2016,"WESTERN EUROPE-EU","GREECE","STANSTED","CORFU",57109,41934,15175
2016,"WESTERN EUROPE-EU","GREECE","STANSTED","HERAKLION",16014,0,16014
2016,"WESTERN EUROPE-EU","GREECE","STANSTED","KEFALLINIA",30107,21331,8776
2016,"WESTERN EUROPE-EU","GREECE","STANSTED","KOS",42820,33309,9511
2016,"WESTERN EUROPE-EU","GREECE","STANSTED","MIKONOS",91,91,0
2016,"WESTERN EUROPE-EU","GREECE","STANSTED","PREVEZA",0,0,0
2016,"WESTERN EUROPE-EU","GREECE","STANSTED","RHODES",65635,47185,18450
2016,"WESTERN EUROPE-EU","GREECE","STANSTED","SALONIKA",116452,116452,0
2016,"WESTERN EUROPE-EU","GREECE","STANSTED","SKIATHOS",9073,9073,0
2016,"WESTERN EUROPE-EU","GREECE","STANSTED","ZAKINTHOS",38292,30698,7594
2016,"WESTERN EUROPE-EU","IRISH REPUBLIC","GATWICK","CORK",119889,119889,0
2016,"WESTERN EUROPE-EU","IRISH REPUBLIC","GATWICK","DUBLIN",1306914,1306914,0
2016,"WESTERN EUROPE-EU","IRISH REPUBLIC","GATWICK","IRELAND WEST(KNOCK)",75707,75707,0
2016,"WESTERN EUROPE-EU","IRISH REPUBLIC","GATWICK","SHANNON",109791,109791,0
2016,"WESTERN EUROPE-EU","IRISH REPUBLIC","HEATHROW","CORK",390581,390581,0
2016,"WESTERN EUROPE-EU","IRISH REPUBLIC","HEATHROW","DUBLIN",1750502,1750502,0
2016,"WESTERN EUROPE-EU","IRISH REPUBLIC","HEATHROW","SHANNON",264179,264179,0
2016,"WESTERN EUROPE-EU","IRISH REPUBLIC","LONDON CITY","CORK",35361,35361,0
2016,"WESTERN EUROPE-EU","IRISH REPUBLIC","LONDON CITY","DUBLIN",449657,449562,95
2016,"WESTERN EUROPE-EU","IRISH REPUBLIC","LUTON","CORK",193,161,32
2016,"WESTERN EUROPE-EU","IRISH REPUBLIC","LUTON","DUBLIN",349852,349658,194
2016,"WESTERN EUROPE-EU","IRISH REPUBLIC","LUTON","IRELAND WEST(KNOCK)",132441,132441,0
2016,"WESTERN EUROPE-EU","IRISH REPUBLIC","LUTON","KERRY COUNTY",112476,112476,0
2016,"WESTERN EUROPE-EU","IRISH REPUBLIC","LUTON","SHANNON",5,0,5
2016,"WESTERN EUROPE-EU","IRISH REPUBLIC","LUTON","WATERFORD",10926,10926,0
2016,"WESTERN EUROPE-EU","IRISH REPUBLIC","SOUTHEND","CORK",240,240,0
2016,"WESTERN EUROPE-EU","IRISH REPUBLIC","SOUTHEND","DUBLIN",1090,1090,0
2016,"WESTERN EUROPE-EU","IRISH REPUBLIC","STANSTED","CORK",339382,339382,0
2016,"WESTERN EUROPE-EU","IRISH REPUBLIC","STANSTED","DUBLIN",914920,914857,63
2016,"WESTERN EUROPE-EU","IRISH REPUBLIC","STANSTED","IRELAND WEST(KNOCK)",162762,162762,0
2016,"WESTERN EUROPE-EU","IRISH REPUBLIC","STANSTED","KERRY COUNTY",74890,74890,0
2016,"WESTERN EUROPE-EU","IRISH REPUBLIC","STANSTED","SHANNON",238632,238632,0
2016,"WESTERN EUROPE-EU","ITALY","GATWICK","ALGHERO (FERTILIA)",8605,214,8391
2016,"WESTERN EUROPE-EU","ITALY","GATWICK","BARI (PALESE)",79954,79868,86
2016,"WESTERN EUROPE-EU","ITALY","GATWICK","BOLOGNA",92005,92005,0
2016,"WESTERN EUROPE-EU","ITALY","GATWICK","BRINDISI",10600,10600,0
2016,"WESTERN EUROPE-EU","ITALY","GATWICK","CAGLIARI (ELMAS)",26378,26378,0
2016,"WESTERN EUROPE-EU","ITALY","GATWICK","CATANIA (FONTANAROSSA)",191860,180528,11332
2016,"WESTERN EUROPE-EU","ITALY","GATWICK","FLORENCE",87116,87116,0
2016,"WESTERN EUROPE-EU","ITALY","GATWICK","GENOA",83906,78284,5622
2016,"WESTERN EUROPE-EU","ITALY","GATWICK","MILAN (LINATE)",291940,291940,0
2016,"WESTERN EUROPE-EU","ITALY","GATWICK","MILAN (MALPENSA)",550593,550593,0
2016,"WESTERN EUROPE-EU","ITALY","GATWICK","NAPLES",444187,412097,32090
2016,"WESTERN EUROPE-EU","ITALY","GATWICK","OLBIA",89661,89661,0
2016,"WESTERN EUROPE-EU","ITALY","GATWICK","PALERMO",60800,60800,0
2016,"WESTERN EUROPE-EU","ITALY","GATWICK","PISA",237093,236810,283
2016,"WESTERN EUROPE-EU","ITALY","GATWICK","ROME (CIAMPINO)",0,0,0
2016,"WESTERN EUROPE-EU","ITALY","GATWICK","ROME (FIUMICINO)",747299,745277,2022
2016,"WESTERN EUROPE-EU","ITALY","GATWICK","TURIN",160262,142471,17791
2016,"WESTERN EUROPE-EU","ITALY","GATWICK","VENICE",731801,718488,13313
2016,"WESTERN EUROPE-EU","ITALY","GATWICK","VERONA VILLAFRANCA",281322,261594,19728
2016,"WESTERN EUROPE-EU","ITALY","HEATHROW","BOLOGNA",250269,250269,0
2016,"WESTERN EUROPE-EU","ITALY","HEATHROW","CAGLIARI (ELMAS)",10713,0,10713
2016,"WESTERN EUROPE-EU","ITALY","HEATHROW","FLORENCE",140,140,0
2016,"WESTERN EUROPE-EU","ITALY","HEATHROW","MILAN (LINATE)",616405,616405,0
2016,"WESTERN EUROPE-EU","ITALY","HEATHROW","MILAN (MALPENSA)",235928,235928,0
2016,"WESTERN EUROPE-EU","ITALY","HEATHROW","OLBIA",26075,21653,4422
2016,"WESTERN EUROPE-EU","ITALY","HEATHROW","PALERMO",11194,11194,0
2016,"WESTERN EUROPE-EU","ITALY","HEATHROW","PISA",110180,110180,0
2016,"WESTERN EUROPE-EU","ITALY","HEATHROW","ROME (FIUMICINO)",988708,984145,4563
2016,"WESTERN EUROPE-EU","ITALY","HEATHROW","VENICE",149466,146942,2524
2016,"WESTERN EUROPE-EU","ITALY","LONDON CITY","BOLOGNA",98,98,0
2016,"WESTERN EUROPE-EU","ITALY","LONDON CITY","FLORENCE",98773,98773,0
2016,"WESTERN EUROPE-EU","ITALY","LONDON CITY","MILAN (LINATE)",180068,180068,0
2016,"WESTERN EUROPE-EU","ITALY","LONDON CITY","PISA",440,440,0
2016,"WESTERN EUROPE-EU","ITALY","LONDON CITY","ROME (CIAMPINO)",0,0,0
2016,"WESTERN EUROPE-EU","ITALY","LONDON CITY","ROME (FIUMICINO)",48482,48482,0
2016,"WESTERN EUROPE-EU","ITALY","LONDON CITY","VENICE",16916,16916,0
2016,"WESTERN EUROPE-EU","ITALY","LUTON","BOLOGNA",3,0,3
2016,"WESTERN EUROPE-EU","ITALY","LUTON","BRESCIA/MONTICHIARI",20,0,20
2016,"WESTERN EUROPE-EU","ITALY","LUTON","BRINDISI",8,0,8
2016,"WESTERN EUROPE-EU","ITALY","LUTON","CATANIA (FONTANAROSSA)",46194,46190,4
2016,"WESTERN EUROPE-EU","ITALY","LUTON","CUNEO",0,0,0
2016,"WESTERN EUROPE-EU","ITALY","LUTON","FLORENCE",1931,1931,0
2016,"WESTERN EUROPE-EU","ITALY","LUTON","MILAN (LINATE)",208,179,29
2016,"WESTERN EUROPE-EU","ITALY","LUTON","MILAN (MALPENSA)",145297,145013,284
2016,"WESTERN EUROPE-EU","ITALY","LUTON","NAPLES",83047,83007,40
2016,"WESTERN EUROPE-EU","ITALY","LUTON","OLBIA",13934,13827,107
2016,"WESTERN EUROPE-EU","ITALY","LUTON","PARMA",0,0,0
2016,"WESTERN EUROPE-EU","ITALY","LUTON","PISA",62422,62402,20
2016,"WESTERN EUROPE-EU","ITALY","LUTON","RIMINI",90,0,90
2016,"WESTERN EUROPE-EU","ITALY","LUTON","ROME (CIAMPINO)",1,0,1
2016,"WESTERN EUROPE-EU","ITALY","LUTON","ROME (FIUMICINO)",114291,113295,996
2016,"WESTERN EUROPE-EU","ITALY","LUTON","TURIN",39425,38899,526
2016,"WESTERN EUROPE-EU","ITALY","LUTON","VENICE",69535,69530,5
2016,"WESTERN EUROPE-EU","ITALY","LUTON","VERONA VILLAFRANCA",594,0,594
2016,"WESTERN EUROPE-EU","ITALY","SOUTHEND","FLORENCE",580,580,0
2016,"WESTERN EUROPE-EU","ITALY","SOUTHEND","PISA",151,151,0
2016,"WESTERN EUROPE-EU","ITALY","SOUTHEND","ROME (CIAMPINO)",0,0,0
2016,"WESTERN EUROPE-EU","ITALY","SOUTHEND","VENICE",40212,40212,0
2016,"WESTERN EUROPE-EU","ITALY","STANSTED","ALGHERO (FERTILIA)",50553,50553,0
2016,"WESTERN EUROPE-EU","ITALY","STANSTED","ANCONA",110166,110166,0
2016,"WESTERN EUROPE-EU","ITALY","STANSTED","BARI (PALESE)",126657,126657,0
2016,"WESTERN EUROPE-EU","ITALY","STANSTED","BERGAMO",489080,489080,0
2016,"WESTERN EUROPE-EU","ITALY","STANSTED","BOLOGNA",215932,215932,0
2016,"WESTERN EUROPE-EU","ITALY","STANSTED","BRINDISI",79836,79836,0
2016,"WESTERN EUROPE-EU","ITALY","STANSTED","CAGLIARI (ELMAS)",83790,83545,245
2016,"WESTERN EUROPE-EU","ITALY","STANSTED","COMISO",29980,29980,0
2016,"WESTERN EUROPE-EU","ITALY","STANSTED","FLORENCE",295,137,158
2016,"WESTERN EUROPE-EU","ITALY","STANSTED","GENOA",86296,86296,0
2016,"WESTERN EUROPE-EU","ITALY","STANSTED","LAMETIA-TERME",54362,54362,0
2016,"WESTERN EUROPE-EU","ITALY","STANSTED","MILAN (LINATE)",92,92,0
2016,"WESTERN EUROPE-EU","ITALY","STANSTED","MILAN (MALPENSA)",235099,235099,0
2016,"WESTERN EUROPE-EU","ITALY","STANSTED","NAPLES",165812,165592,220
2016,"WESTERN EUROPE-EU","ITALY","STANSTED","OLBIA",0,0,0
2016,"WESTERN EUROPE-EU","ITALY","STANSTED","PALERMO",111872,111872,0
2016,"WESTERN EUROPE-EU","ITALY","STANSTED","PARMA",40793,40793,0
2016,"WESTERN EUROPE-EU","ITALY","STANSTED","PERUGIA",96087,96087,0
2016,"WESTERN EUROPE-EU","ITALY","STANSTED","PESCARA",84479,84479,0
2016,"WESTERN EUROPE-EU","ITALY","STANSTED","PISA",339408,339408,0
2016,"WESTERN EUROPE-EU","ITALY","STANSTED","ROME (CIAMPINO)",601009,601009,0
2016,"WESTERN EUROPE-EU","ITALY","STANSTED","ROME (FIUMICINO)",26551,24916,1635
2016,"WESTERN EUROPE-EU","ITALY","STANSTED","TREVISO",338451,338451,0
2016,"WESTERN EUROPE-EU","ITALY","STANSTED","TRIESTE (RONCHI DEI LEGIONARI)",95496,95496,0
2016,"WESTERN EUROPE-EU","ITALY","STANSTED","TURIN",128605,123487,5118
2016,"WESTERN EUROPE-EU","ITALY","STANSTED","VENICE",679,476,203
2016,"WESTERN EUROPE-EU","ITALY","STANSTED","VERONA VILLAFRANCA",72426,72426,0
2016,"WESTERN EUROPE-EU","LUXEMBOURG","GATWICK","LUXEMBOURG",70105,70105,0
2016,"WESTERN EUROPE-EU","LUXEMBOURG","HEATHROW","LUXEMBOURG",144292,144292,0
2016,"WESTERN EUROPE-EU","LUXEMBOURG","LONDON CITY","LUXEMBOURG",183097,183097,0
2016,"WESTERN EUROPE-EU","LUXEMBOURG","LUTON","LUXEMBOURG",729,723,6
2016,"WESTERN EUROPE-EU","LUXEMBOURG","SOUTHEND","LUXEMBOURG",107,107,0
2016,"WESTERN EUROPE-EU","LUXEMBOURG","STANSTED","LUXEMBOURG",18018,18018,0
2016,"WESTERN EUROPE-EU","MALTA","GATWICK","MALTA",346896,328346,18550
2016,"WESTERN EUROPE-EU","MALTA","HEATHROW","MALTA",189847,189847,0
2016,"WESTERN EUROPE-EU","MALTA","LUTON","MALTA",121639,121307,332
2016,"WESTERN EUROPE-EU","MALTA","STANSTED","MALTA",83447,83446,1
2016,"WESTERN EUROPE-EU","NETHERLANDS","GATWICK","AMSTERDAM",1062388,1062018,370
2016,"WESTERN EUROPE-EU","NETHERLANDS","GATWICK","GRONINGEN",3,0,3
2016,"WESTERN EUROPE-EU","NETHERLANDS","HEATHROW","AMSTERDAM",1616595,1616595,0
2016,"WESTERN EUROPE-EU","NETHERLANDS","HEATHROW","EINDHOVEN",0,0,0
2016,"WESTERN EUROPE-EU","NETHERLANDS","HEATHROW","ROTTERDAM",0,0,0
2016,"WESTERN EUROPE-EU","NETHERLANDS","LONDON CITY","AMSTERDAM",517305,517305,0
2016,"WESTERN EUROPE-EU","NETHERLANDS","LONDON CITY","ROTTERDAM",219857,219720,137
2016,"WESTERN EUROPE-EU","NETHERLANDS","LUTON","AMSTERDAM",608188,607939,249
2016,"WESTERN EUROPE-EU","NETHERLANDS","LUTON","MAASTRICHT",186,0,186
2016,"WESTERN EUROPE-EU","NETHERLANDS","LUTON","ROTTERDAM",0,0,0
2016,"WESTERN EUROPE-EU","NETHERLANDS","SOUTHEND","AMSTERDAM",206077,206077,0
2016,"WESTERN EUROPE-EU","NETHERLANDS","SOUTHEND","GRONINGEN",24524,24524,0
2016,"WESTERN EUROPE-EU","NETHERLANDS","SOUTHEND","MAASTRICHT",0,0,0
2016,"WESTERN EUROPE-EU","NETHERLANDS","SOUTHEND","ROTTERDAM",639,639,0
2016,"WESTERN EUROPE-EU","NETHERLANDS","STANSTED","AMSTERDAM",325248,324381,867
2016,"WESTERN EUROPE-EU","NETHERLANDS","STANSTED","EINDHOVEN",277807,277807,0
2016,"WESTERN EUROPE-EU","NETHERLANDS","STANSTED","ROTTERDAM",95,95,0
2016,"WESTERN EUROPE-EU","PORTUGAL(EXCLUDING MADEIRA)","GATWICK","AZORES PONTA DELGADA",6039,6039,0
2016,"WESTERN EUROPE-EU","PORTUGAL(EXCLUDING MADEIRA)","GATWICK","FARO",809645,769299,40346
2016,"WESTERN EUROPE-EU","PORTUGAL(EXCLUDING MADEIRA)","GATWICK","LISBON",320686,320355,331
2016,"WESTERN EUROPE-EU","PORTUGAL(EXCLUDING MADEIRA)","GATWICK","OPORTO (PORTUGAL)",281296,281296,0
2016,"WESTERN EUROPE-EU","PORTUGAL(EXCLUDING MADEIRA)","HEATHROW","AZORES SANTA MARIA",0,0,0
2016,"WESTERN EUROPE-EU","PORTUGAL(EXCLUDING MADEIRA)","HEATHROW","FARO",17052,17052,0
2016,"WESTERN EUROPE-EU","PORTUGAL(EXCLUDING MADEIRA)","HEATHROW","LISBON",795987,795987,0
2016,"WESTERN EUROPE-EU","PORTUGAL(EXCLUDING MADEIRA)","HEATHROW","OPORTO (PORTUGAL)",0,0,0
2016,"WESTERN EUROPE-EU","PORTUGAL(EXCLUDING MADEIRA)","LONDON CITY","FARO",11676,11676,0
2016,"WESTERN EUROPE-EU","PORTUGAL(EXCLUDING MADEIRA)","LUTON","AZORES PONTA DELGADA",66,0,66
2016,"WESTERN EUROPE-EU","PORTUGAL(EXCLUDING MADEIRA)","LUTON","FARO",255398,234559,20839
2016,"WESTERN EUROPE-EU","PORTUGAL(EXCLUDING MADEIRA)","LUTON","LISBON",166032,166032,0
2016,"WESTERN EUROPE-EU","PORTUGAL(EXCLUDING MADEIRA)","LUTON","OPORTO (PORTUGAL)",42252,42252,0
2016,"WESTERN EUROPE-EU","PORTUGAL(EXCLUDING MADEIRA)","SOUTHEND","FARO",97626,97626,0
2016,"WESTERN EUROPE-EU","PORTUGAL(EXCLUDING MADEIRA)","STANSTED","AZORES PONTA DELGADA",13979,13979,0
2016,"WESTERN EUROPE-EU","PORTUGAL(EXCLUDING MADEIRA)","STANSTED","FARO",263138,241015,22123
2016,"WESTERN EUROPE-EU","PORTUGAL(EXCLUDING MADEIRA)","STANSTED","LISBON",379420,379420,0
2016,"WESTERN EUROPE-EU","PORTUGAL(EXCLUDING MADEIRA)","STANSTED","OPORTO (PORTUGAL)",302333,302333,0
2016,"WESTERN EUROPE-EU","PORTUGAL(MADEIRA)","GATWICK","FUNCHAL",301941,262604,39337
2016,"WESTERN EUROPE-EU","PORTUGAL(MADEIRA)","GATWICK","PORTO SANTO",9749,47,9702
2016,"WESTERN EUROPE-EU","PORTUGAL(MADEIRA)","HEATHROW","FUNCHAL",0,0,0
2016,"WESTERN EUROPE-EU","PORTUGAL(MADEIRA)","LUTON","FUNCHAL",12515,139,12376
2016,"WESTERN EUROPE-EU","PORTUGAL(MADEIRA)","STANSTED","PORTO SANTO",348,348,0
2016,"WESTERN EUROPE-EU","SLOVENIA","GATWICK","LJUBLJANA",10657,10657,0
2016,"WESTERN EUROPE-EU","SLOVENIA","LUTON","LJUBLJANA",63108,62392,716
2016,"WESTERN EUROPE-EU","SLOVENIA","LUTON","MARIBOR",0,0,0
2016,"WESTERN EUROPE-EU","SLOVENIA","SOUTHEND","MARIBOR",0,0,0
2016,"WESTERN EUROPE-EU","SLOVENIA","STANSTED","LJUBLJANA",106704,106616,88
2016,"WESTERN EUROPE-EU","SPAIN","GATWICK","A CORUNA",460,460,0
2016,"WESTERN EUROPE-EU","SPAIN","GATWICK","ALICANTE",824710,783008,41702
2016,"WESTERN EUROPE-EU","SPAIN","GATWICK","ALMERIA",138558,129611,8947
2016,"WESTERN EUROPE-EU","SPAIN","GATWICK","ASTURIAS",32516,32516,0
2016,"WESTERN EUROPE-EU","SPAIN","GATWICK","BARCELONA",1357124,1356606,518
2016,"WESTERN EUROPE-EU","SPAIN","GATWICK","BILBAO",95601,95197,404
2016,"WESTERN EUROPE-EU","SPAIN","GATWICK","BURGOS",0,0,0
2016,"WESTERN EUROPE-EU","SPAIN","GATWICK","GIRONA",24628,0,24628
2016,"WESTERN EUROPE-EU","SPAIN","GATWICK","IBIZA",322802,253066,69736
2016,"WESTERN EUROPE-EU","SPAIN","GATWICK","JEREZ",9183,0,9183
2016,"WESTERN EUROPE-EU","SPAIN","GATWICK","LEON",291,0,291
2016,"WESTERN EUROPE-EU","SPAIN","GATWICK","LIEIDA",11525,0,11525
2016,"WESTERN EUROPE-EU","SPAIN","GATWICK","MADRID",947394,947394,0
2016,"WESTERN EUROPE-EU","SPAIN","GATWICK","MAHON",272783,196013,76770
2016,"WESTERN EUROPE-EU","SPAIN","GATWICK","MALAGA",1166991,1092744,74247
2016,"WESTERN EUROPE-EU","SPAIN","GATWICK","MURCIA SAN JAVIER",156289,156289,0
2016,"WESTERN EUROPE-EU","SPAIN","GATWICK","PALMA DE MALLORCA",802509,643774,158735
2016,"WESTERN EUROPE-EU","SPAIN","GATWICK","PAMPLONA",0,0,0
2016,"WESTERN EUROPE-EU","SPAIN","GATWICK","REUS",35891,6284,29607
2016,"WESTERN EUROPE-EU","SPAIN","GATWICK","SANTIAGO DE COMPOSTELA (SPAIN)",50305,50305,0
2016,"WESTERN EUROPE-EU","SPAIN","GATWICK","SEVILLE",231310,231310,0
2016,"WESTERN EUROPE-EU","SPAIN","GATWICK","VALENCIA",339366,339306,60
2016,"WESTERN EUROPE-EU","SPAIN","GATWICK","VALLADOLID",0,0,0
2016,"WESTERN EUROPE-EU","SPAIN","GATWICK","ZARAGOZA",0,0,0
2016,"WESTERN EUROPE-EU","SPAIN","HEATHROW","A CORUNA",105409,105409,0
2016,"WESTERN EUROPE-EU","SPAIN","HEATHROW","ASTURIAS",23593,23593,0
2016,"WESTERN EUROPE-EU","SPAIN","HEATHROW","BARCELONA",745963,745452,511
2016,"WESTERN EUROPE-EU","SPAIN","HEATHROW","BILBAO",186350,186350,0
2016,"WESTERN EUROPE-EU","SPAIN","HEATHROW","IBIZA",40775,40775,0
2016,"WESTERN EUROPE-EU","SPAIN","HEATHROW","MADRID",1317122,1317122,0
2016,"WESTERN EUROPE-EU","SPAIN","HEATHROW","MAHON",23121,23121,0
2016,"WESTERN EUROPE-EU","SPAIN","HEATHROW","MALAGA",19951,19951,0
2016,"WESTERN EUROPE-EU","SPAIN","HEATHROW","PALMA DE MALLORCA",122474,122474,0
2016,"WESTERN EUROPE-EU","SPAIN","HEATHROW","SANTIAGO DE COMPOSTELA (SPAIN)",149,149,0
2016,"WESTERN EUROPE-EU","SPAIN","LONDON CITY","ALICANTE",6343,6343,0
2016,"WESTERN EUROPE-EU","SPAIN","LONDON CITY","GRANADA",18365,18365,0
2016,"WESTERN EUROPE-EU","SPAIN","LONDON CITY","IBIZA",88376,88376,0
2016,"WESTERN EUROPE-EU","SPAIN","LONDON CITY","MADRID",70900,70818,82
2016,"WESTERN EUROPE-EU","SPAIN","LONDON CITY","MAHON",2553,2553,0
2016,"WESTERN EUROPE-EU","SPAIN","LONDON CITY","MALAGA",57772,57772,0
2016,"WESTERN EUROPE-EU","SPAIN","LONDON CITY","PALMA DE MALLORCA",37562,37562,0
2016,"WESTERN EUROPE-EU","SPAIN","LUTON","ALICANTE",236862,236862,0
2016,"WESTERN EUROPE-EU","SPAIN","LUTON","ALMERIA",0,0,0
2016,"WESTERN EUROPE-EU","SPAIN","LUTON","ASTURIAS",31,31,0
2016,"WESTERN EUROPE-EU","SPAIN","LUTON","BARCELONA",367189,366387,802
2016,"WESTERN EUROPE-EU","SPAIN","LUTON","BILBAO",34,0,34
2016,"WESTERN EUROPE-EU","SPAIN","LUTON","CASTELLON COSTA AZAHAR",12,0,12
2016,"WESTERN EUROPE-EU","SPAIN","LUTON","GIRONA",54397,54397,0
2016,"WESTERN EUROPE-EU","SPAIN","LUTON","GRANADA",181,0,181
2016,"WESTERN EUROPE-EU","SPAIN","LUTON","IBIZA",58239,39627,18612
2016,"WESTERN EUROPE-EU","SPAIN","LUTON","JEREZ",0,0,0
2016,"WESTERN EUROPE-EU","SPAIN","LUTON","MADRID",132631,132353,278
2016,"WESTERN EUROPE-EU","SPAIN","LUTON","MAHON",89441,71355,18086
2016,"WESTERN EUROPE-EU","SPAIN","LUTON","MALAGA",304038,281615,22423
2016,"WESTERN EUROPE-EU","SPAIN","LUTON","MURCIA SAN JAVIER",88598,88598,0
2016,"WESTERN EUROPE-EU","SPAIN","LUTON","PALMA DE MALLORCA",284387,226043,58344
2016,"WESTERN EUROPE-EU","SPAIN","LUTON","REUS",9177,0,9177
2016,"WESTERN EUROPE-EU","SPAIN","LUTON","SAN SEBASTIAN",719,719,0
2016,"WESTERN EUROPE-EU","SPAIN","LUTON","SEVILLE",0,0,0
2016,"WESTERN EUROPE-EU","SPAIN","LUTON","VALENCIA",79,0,79
2016,"WESTERN EUROPE-EU","SPAIN","LUTON","VIGO",3227,3227,0
2016,"WESTERN EUROPE-EU","SPAIN","LUTON","VITORIA",0,0,0
2016,"WESTERN EUROPE-EU","SPAIN","SOUTHEND","ALICANTE",100308,100308,0
2016,"WESTERN EUROPE-EU","SPAIN","SOUTHEND","BARCELONA",43158,43158,0
2016,"WESTERN EUROPE-EU","SPAIN","SOUTHEND","IBIZA",20962,20962,0
2016,"WESTERN EUROPE-EU","SPAIN","SOUTHEND","MADRID",53,53,0
2016,"WESTERN EUROPE-EU","SPAIN","SOUTHEND","MAHON",8493,8493,0
2016,"WESTERN EUROPE-EU","SPAIN","SOUTHEND","MALAGA",81736,81736,0
2016,"WESTERN EUROPE-EU","SPAIN","SOUTHEND","PALMA DE MALLORCA",52934,52934,0
2016,"WESTERN EUROPE-EU","SPAIN","STANSTED","ALICANTE",234052,234052,0
2016,"WESTERN EUROPE-EU","SPAIN","STANSTED","ALMERIA",27450,27450,0
2016,"WESTERN EUROPE-EU","SPAIN","STANSTED","ASTURIAS",80141,80141,0
2016,"WESTERN EUROPE-EU","SPAIN","STANSTED","BARCELONA",508076,506726,1350
2016,"WESTERN EUROPE-EU","SPAIN","STANSTED","BILBAO",131520,131520,0
2016,"WESTERN EUROPE-EU","SPAIN","STANSTED","CASTELLON COSTA AZAHAR",14356,14356,0
2016,"WESTERN EUROPE-EU","SPAIN","STANSTED","CASTELLON DE LA PLANA AIRPORT",36310,36310,0
2016,"WESTERN EUROPE-EU","SPAIN","STANSTED","GIRONA",59058,59058,0
2016,"WESTERN EUROPE-EU","SPAIN","STANSTED","GRANADA",0,0,0
2016,"WESTERN EUROPE-EU","SPAIN","STANSTED","IBIZA",251136,227033,24103
2016,"WESTERN EUROPE-EU","SPAIN","STANSTED","JEREZ",53527,53527,0
2016,"WESTERN EUROPE-EU","SPAIN","STANSTED","LEON",332,0,332
2016,"WESTERN EUROPE-EU","SPAIN","STANSTED","MADRID",499574,499574,0
2016,"WESTERN EUROPE-EU","SPAIN","STANSTED","MAHON",38631,19765,18866
2016,"WESTERN EUROPE-EU","SPAIN","STANSTED","MALAGA",398718,398290,428
2016,"WESTERN EUROPE-EU","SPAIN","STANSTED","MURCIA SAN JAVIER",137691,137691,0
2016,"WESTERN EUROPE-EU","SPAIN","STANSTED","PALMA DE MALLORCA",371741,340373,31368
2016,"WESTERN EUROPE-EU","SPAIN","STANSTED","REUS",52929,52575,354
2016,"WESTERN EUROPE-EU","SPAIN","STANSTED","SALAMANCA",165,0,165
2016,"WESTERN EUROPE-EU","SPAIN","STANSTED","SANTANDER",80455,80455,0
2016,"WESTERN EUROPE-EU","SPAIN","STANSTED","SANTIAGO DE COMPOSTELA (SPAIN)",79422,79422,0
2016,"WESTERN EUROPE-EU","SPAIN","STANSTED","SEVILLE",137278,137278,0
2016,"WESTERN EUROPE-EU","SPAIN","STANSTED","VALENCIA",129668,129668,0
2016,"WESTERN EUROPE-EU","SPAIN","STANSTED","VALLADOLID",1274,0,1274
2016,"WESTERN EUROPE-EU","SPAIN","STANSTED","ZARAGOZA",86109,86109,0
2016,"WESTERN EUROPE-EU","SPAIN(CANARY ISLANDS)","GATWICK","ARRECIFE",474869,382549,92320
2016,"WESTERN EUROPE-EU","SPAIN(CANARY ISLANDS)","GATWICK","FUERTEVENTURA",278088,210528,67560
2016,"WESTERN EUROPE-EU","SPAIN(CANARY ISLANDS)","GATWICK","LAS PALMAS",323829,227903,95926
2016,"WESTERN EUROPE-EU","SPAIN(CANARY ISLANDS)","GATWICK","SANTA CRUZ DE LA PALMA",32821,6317,26504
2016,"WESTERN EUROPE-EU","SPAIN(CANARY ISLANDS)","GATWICK","TENERIFE (NORTE LOS RODEOS)",121,121,0
2016,"WESTERN EUROPE-EU","SPAIN(CANARY ISLANDS)","GATWICK","TENERIFE (SURREINA SOFIA)",862014,676278,185736
2016,"WESTERN EUROPE-EU","SPAIN(CANARY ISLANDS)","HEATHROW","LAS PALMAS",57631,57631,0
2016,"WESTERN EUROPE-EU","SPAIN(CANARY ISLANDS)","HEATHROW","TENERIFE (NORTE LOS RODEOS)",30969,30969,0
2016,"WESTERN EUROPE-EU","SPAIN(CANARY ISLANDS)","LUTON","ARRECIFE",113762,82060,31702
2016,"WESTERN EUROPE-EU","SPAIN(CANARY ISLANDS)","LUTON","FUERTEVENTURA",39961,27785,12176
2016,"WESTERN EUROPE-EU","SPAIN(CANARY ISLANDS)","LUTON","LAS PALMAS",61829,33490,28339
2016,"WESTERN EUROPE-EU","SPAIN(CANARY ISLANDS)","LUTON","TENERIFE (SURREINA SOFIA)",146670,108420,38250
2016,"WESTERN EUROPE-EU","SPAIN(CANARY ISLANDS)","SOUTHEND","ARRECIFE",16022,16022,0
2016,"WESTERN EUROPE-EU","SPAIN(CANARY ISLANDS)","SOUTHEND","LAS PALMAS",3549,3549,0
2016,"WESTERN EUROPE-EU","SPAIN(CANARY ISLANDS)","SOUTHEND","TENERIFE (SURREINA SOFIA)",15132,15132,0
2016,"WESTERN EUROPE-EU","SPAIN(CANARY ISLANDS)","STANSTED","ARRECIFE",149690,132720,16970
2016,"WESTERN EUROPE-EU","SPAIN(CANARY ISLANDS)","STANSTED","FUERTEVENTURA",118476,100016,18460
2016,"WESTERN EUROPE-EU","SPAIN(CANARY ISLANDS)","STANSTED","LAS PALMAS",117664,99056,18608
2016,"WESTERN EUROPE-EU","SPAIN(CANARY ISLANDS)","STANSTED","SANTA CRUZ DE LA PALMA",186,0,186
2016,"WESTERN EUROPE-EU","SPAIN(CANARY ISLANDS)","STANSTED","TENERIFE (SURREINA SOFIA)",234667,205676,28991
2016,"WESTERN EUROPE-EU","SWEDEN","GATWICK","GOTEBORG (LANDVETTER)",170411,170014,397
2016,"WESTERN EUROPE-EU","SWEDEN","GATWICK","KIRUNA",1109,0,1109
2016,"WESTERN EUROPE-EU","SWEDEN","GATWICK","MALMO",0,0,0
2016,"WESTERN EUROPE-EU","SWEDEN","GATWICK","OSTERSUND / FROSON",837,837,0
2016,"WESTERN EUROPE-EU","SWEDEN","GATWICK","PAJALA YLLAS",376,0,376
2016,"WESTERN EUROPE-EU","SWEDEN","GATWICK","STOCKHOLM (ARLANDA)",492461,492092,369
2016,"WESTERN EUROPE-EU","SWEDEN","HEATHROW","GOTEBORG (LANDVETTER)",256588,256588,0
2016,"WESTERN EUROPE-EU","SWEDEN","HEATHROW","KIRUNA",3332,178,3154
2016,"WESTERN EUROPE-EU","SWEDEN","HEATHROW","STOCKHOLM (ARLANDA)",1012568,1012568,0
2016,"WESTERN EUROPE-EU","SWEDEN","LUTON","NORRKOPING",19,0,19
2016,"WESTERN EUROPE-EU","SWEDEN","LUTON","STOCKHOLM (ARLANDA)",54,0,54
2016,"WESTERN EUROPE-EU","SWEDEN","LUTON","STOCKHOLM (BROMMA)",0,0,0
2016,"WESTERN EUROPE-EU","SWEDEN","STANSTED","GOTEBORG (LANDVETTER)",271384,271384,0
2016,"WESTERN EUROPE-EU","SWEDEN","STANSTED","PAJALA YLLAS",0,0,0
2016,"WESTERN EUROPE-EU","SWEDEN","STANSTED","SKELLEFTEA",0,0,0
2016,"WESTERN EUROPE-EU","SWEDEN","STANSTED","STOCKHOLM (ARLANDA)",711,0,711
2016,"WESTERN EUROPE-EU","SWEDEN","STANSTED","STOCKHOLM (SKAVSTA)",236868,236868,0
2016,"WESTERN EUROPE-EU","SWEDEN","STANSTED","VASTERAS",69417,69417,0
2016,"WESTERN EUROPE-OTHER","BOSNIA-HERZEGOVINA","LUTON","TUZLA",3005,3005,0
2016,"WESTERN EUROPE-OTHER","FAROE ISLANDS","GATWICK","VAGAR",146,146,0
2016,"WESTERN EUROPE-OTHER","FAROE ISLANDS","SOUTHEND","VAGAR",138,0,138
2016,"WESTERN EUROPE-OTHER","FAROE ISLANDS","STANSTED","VAGAR",0,0,0
2016,"WESTERN EUROPE-OTHER","ICELAND","GATWICK","EGILSSTADIR",314,0,314
2016,"WESTERN EUROPE-OTHER","ICELAND","GATWICK","KEFLAVIK",404161,392991,11170
2016,"WESTERN EUROPE-OTHER","ICELAND","HEATHROW","KEFLAVIK",305932,305932,0
2016,"WESTERN EUROPE-OTHER","ICELAND","LUTON","KEFLAVIK",112908,112908,0
2016,"WESTERN EUROPE-OTHER","ICELAND","LUTON","REYKJAVIK",3,0,3
2016,"WESTERN EUROPE-OTHER","ICELAND","STANSTED","KEFLAVIK",22975,22871,104
2016,"WESTERN EUROPE-OTHER","KOSOVO","GATWICK","PRISTINA",14954,14952,2
2016,"WESTERN EUROPE-OTHER","KOSOVO","LUTON","PRISTINA",6645,6645,0
2016,"WESTERN EUROPE-OTHER","MACEDONIA","LUTON","OHRID",21557,21557,0
2016,"WESTERN EUROPE-OTHER","MACEDONIA","LUTON","SKOPJE",70670,70670,0
2016,"WESTERN EUROPE-OTHER","NORWAY","GATWICK","ALESUND",17417,17417,0
2016,"WESTERN EUROPE-OTHER","NORWAY","GATWICK","BERGEN",185917,185706,211
2016,"WESTERN EUROPE-OTHER","NORWAY","GATWICK","BODO",573,0,573
2016,"WESTERN EUROPE-OTHER","NORWAY","GATWICK","EVENES",619,0,619
2016,"WESTERN EUROPE-OTHER","NORWAY","GATWICK","FAGERNES/LEIRIN",3223,0,3223
2016,"WESTERN EUROPE-OTHER","NORWAY","GATWICK","HAUGESUND",2388,0,2388
2016,"WESTERN EUROPE-OTHER","NORWAY","GATWICK","OSLO (GARDERMOEN)",352497,352346,151
2016,"WESTERN EUROPE-OTHER","NORWAY","GATWICK","SANDEFJORD(TORP)",0,0,0
2016,"WESTERN EUROPE-OTHER","NORWAY","GATWICK","STAVANGER",73385,73385,0
2016,"WESTERN EUROPE-OTHER","NORWAY","GATWICK","TROMSOE",18696,16547,2149
2016,"WESTERN EUROPE-OTHER","NORWAY","GATWICK","TRONDHEIM (VAERNES)",70697,69619,1078
2016,"WESTERN EUROPE-OTHER","NORWAY","HEATHROW","BERGEN",120331,120331,0
2016,"WESTERN EUROPE-OTHER","NORWAY","HEATHROW","OSLO (GARDERMOEN)",702842,702842,0
2016,"WESTERN EUROPE-OTHER","NORWAY","HEATHROW","STAVANGER",191309,191309,0
2016,"WESTERN EUROPE-OTHER","NORWAY","HEATHROW","TROMSOE",32,0,32
2016,"WESTERN EUROPE-OTHER","NORWAY","LUTON","BERGEN",0,0,0
2016,"WESTERN EUROPE-OTHER","NORWAY","LUTON","EVENES",14,0,14
2016,"WESTERN EUROPE-OTHER","NORWAY","LUTON","OSLO (GARDERMOEN)",18,0,18
2016,"WESTERN EUROPE-OTHER","NORWAY","LUTON","STAVANGER",1,0,1
2016,"WESTERN EUROPE-OTHER","NORWAY","LUTON","TRONDHEIM (VAERNES)",20,0,20
2016,"WESTERN EUROPE-OTHER","NORWAY","STANSTED","HAUGESUND",596,596,0
2016,"WESTERN EUROPE-OTHER","NORWAY","STANSTED","OSLO (GARDERMOEN)",53726,53629,97
2016,"WESTERN EUROPE-OTHER","NORWAY","STANSTED","RYGGE",221923,221923,0
2016,"WESTERN EUROPE-OTHER","NORWAY","STANSTED","SANDEFJORD(TORP)",64190,64190,0
2016,"WESTERN EUROPE-OTHER","NORWAY","STANSTED","TROMSOE",0,0,0
2016,"WESTERN EUROPE-OTHER","NORWAY","STANSTED","TRONDHEIM (VAERNES)",2130,0,2130
2016,"WESTERN EUROPE-OTHER","REPUBLIC OF MONTENEGRO","GATWICK","TIVAT",25443,25443,0
2016,"WESTERN EUROPE-OTHER","REPUBLIC OF MONTENEGRO","LUTON","TIVAT",70,0,70
2016,"WESTERN EUROPE-OTHER","REPUBLIC OF MONTENEGRO","STANSTED","PODGORICA",36724,36724,0
2016,"WESTERN EUROPE-OTHER","REPUBLIC OF MONTENEGRO","STANSTED","TIVAT",1174,1174,0
2016,"WESTERN EUROPE-OTHER","REPUBLIC OF SERBIA","GATWICK","BELGRADE",176,176,0
2016,"WESTERN EUROPE-OTHER","REPUBLIC OF SERBIA","HEATHROW","BELGRADE",88509,88509,0
2016,"WESTERN EUROPE-OTHER","REPUBLIC OF SERBIA","LUTON","BELGRADE",46385,46363,22
2016,"WESTERN EUROPE-OTHER","SWITZERLAND","GATWICK","BALE MULHOUSE",269177,269177,0
2016,"WESTERN EUROPE-OTHER","SWITZERLAND","GATWICK","GENEVA",844937,818822,26115
2016,"WESTERN EUROPE-OTHER","SWITZERLAND","GATWICK","ZURICH",154723,154316,407
2016,"WESTERN EUROPE-OTHER","SWITZERLAND","HEATHROW","BALE MULHOUSE",254206,254206,0
2016,"WESTERN EUROPE-OTHER","SWITZERLAND","HEATHROW","GENEVA",1053728,1048606,5122
2016,"WESTERN EUROPE-OTHER","SWITZERLAND","HEATHROW","ZURICH",1102296,1101677,619
2016,"WESTERN EUROPE-OTHER","SWITZERLAND","LONDON CITY","BALE MULHOUSE",18082,18082,0
2016,"WESTERN EUROPE-OTHER","SWITZERLAND","LONDON CITY","BERNE",11580,11580,0
2016,"WESTERN EUROPE-OTHER","SWITZERLAND","LONDON CITY","GENEVA",219607,219607,0
2016,"WESTERN EUROPE-OTHER","SWITZERLAND","LONDON CITY","ZURICH",385933,385933,0
2016,"WESTERN EUROPE-OTHER","SWITZERLAND","LUTON","ALTENRHEIN",22,0,22
2016,"WESTERN EUROPE-OTHER","SWITZERLAND","LUTON","BALE MULHOUSE",78190,77966,224
2016,"WESTERN EUROPE-OTHER","SWITZERLAND","LUTON","BERNE",11,0,11
2016,"WESTERN EUROPE-OTHER","SWITZERLAND","LUTON","GENEVA",268760,268697,63
2016,"WESTERN EUROPE-OTHER","SWITZERLAND","LUTON","ZURICH",135211,135177,34
2016,"WESTERN EUROPE-OTHER","SWITZERLAND","SOUTHEND","BALE MULHOUSE",124,124,0
2016,"WESTERN EUROPE-OTHER","SWITZERLAND","SOUTHEND","BERNE",0,0,0
2016,"WESTERN EUROPE-OTHER","SWITZERLAND","SOUTHEND","GENEVA",28761,28761,0
2016,"WESTERN EUROPE-OTHER","SWITZERLAND","SOUTHEND","ZURICH",58,58,0
2016,"WESTERN EUROPE-OTHER","SWITZERLAND","STANSTED","BALE MULHOUSE",109746,109088,658
2016,"WESTERN EUROPE-OTHER","SWITZERLAND","STANSTED","GENEVA",61255,60446,809
2016,"WESTERN EUROPE-OTHER","SWITZERLAND","STANSTED","ZURICH",185,185,0
2016,"WESTERN EUROPE-OTHER","TURKEY","GATWICK","ANKARA (ESENBOGA)",0,0,0
2016,"WESTERN EUROPE-OTHER","TURKEY","GATWICK","ANTALYA",221147,164861,56286
2016,"WESTERN EUROPE-OTHER","TURKEY","GATWICK","BODRUM (MILAS)",112456,93179,19277
2016,"WESTERN EUROPE-OTHER","TURKEY","GATWICK","BURSA YENISEHIR",59,0,59
2016,"WESTERN EUROPE-OTHER","TURKEY","GATWICK","DALAMAN",289475,236668,52807
2016,"WESTERN EUROPE-OTHER","TURKEY","GATWICK","ISTANBUL",257161,257161,0
2016,"WESTERN EUROPE-OTHER","TURKEY","GATWICK","ISTANBUL (SABIHA GOKCEN)",176108,176108,0
2016,"WESTERN EUROPE-OTHER","TURKEY","GATWICK","IZMIR (ADNAN MENDERES)",54163,42071,12092
2016,"WESTERN EUROPE-OTHER","TURKEY","HEATHROW","BODRUM (MILAS)",0,0,0
2016,"WESTERN EUROPE-OTHER","TURKEY","HEATHROW","DALAMAN",0,0,0
2016,"WESTERN EUROPE-OTHER","TURKEY","HEATHROW","ISTANBUL",956654,956654,0
2016,"WESTERN EUROPE-OTHER","TURKEY","HEATHROW","ISTANBUL (SABIHA GOKCEN)",0,0,0
2016,"WESTERN EUROPE-OTHER","TURKEY","HEATHROW","IZMIR (ADNAN MENDERES)",7796,0,7796
2016,"WESTERN EUROPE-OTHER","TURKEY","LUTON","ANKARA (ESENBOGA)",62,0,62
2016,"WESTERN EUROPE-OTHER","TURKEY","LUTON","ANTALYA",26911,18028,8883
2016,"WESTERN EUROPE-OTHER","TURKEY","LUTON","BODRUM (MILAS)",14477,14477,0
2016,"WESTERN EUROPE-OTHER","TURKEY","LUTON","DALAMAN",36650,18451,18199
2016,"WESTERN EUROPE-OTHER","TURKEY","LUTON","ISTANBUL",69521,69521,0
2016,"WESTERN EUROPE-OTHER","TURKEY","LUTON","ISTANBUL (SABIHA GOKCEN)",71,0,71
2016,"WESTERN EUROPE-OTHER","TURKEY","LUTON","IZMIR (ADNAN MENDERES)",6694,6694,0
2016,"WESTERN EUROPE-OTHER","TURKEY","LUTON","NEVSEHIR KAPADOKYA ",0,0,0
2016,"WESTERN EUROPE-OTHER","TURKEY","LUTON","TRABZON",51,0,51
2016,"WESTERN EUROPE-OTHER","TURKEY","STANSTED","ADANA",267,267,0
2016,"WESTERN EUROPE-OTHER","TURKEY","STANSTED","ANTALYA",44732,29011,15721
2016,"WESTERN EUROPE-OTHER","TURKEY","STANSTED","BODRUM (MILAS)",32740,32548,192
2016,"WESTERN EUROPE-OTHER","TURKEY","STANSTED","DALAMAN",89696,80178,9518
2016,"WESTERN EUROPE-OTHER","TURKEY","STANSTED","GAZIANTEP",866,163,703
2016,"WESTERN EUROPE-OTHER","TURKEY","STANSTED","ISTANBUL",14794,14794,0
2016,"WESTERN EUROPE-OTHER","TURKEY","STANSTED","ISTANBUL (SABIHA GOKCEN)",229947,229947,0
2016,"WESTERN EUROPE-OTHER","TURKEY","STANSTED","IZMIR (ADNAN MENDERES)",39563,39563,0
2016,"EASTERN EUROPE-EU","BULGARIA","GATWICK","BURGAS",50195,18908,31287
2016,"EASTERN EUROPE-EU","BULGARIA","GATWICK","PLOVDIV",0,0,0
2016,"EASTERN EUROPE-EU","BULGARIA","GATWICK","ROUSE",482,0,482
2016,"EASTERN EUROPE-EU","BULGARIA","GATWICK","SOFIA",131602,123751,7851
2016,"EASTERN EUROPE-EU","BULGARIA","GATWICK","VARNA",2865,0,2865
2016,"EASTERN EUROPE-EU","BULGARIA","HEATHROW","SOFIA",163653,163653,0
2016,"EASTERN EUROPE-EU","BULGARIA","LUTON","BURGAS",79124,72024,7100
2016,"EASTERN EUROPE-EU","BULGARIA","LUTON","SOFIA",279840,279840,0
2016,"EASTERN EUROPE-EU","BULGARIA","LUTON","VARNA",89099,89099,0
2016,"EASTERN EUROPE-EU","BULGARIA","STANSTED","BURGAS",4047,2116,1931
2016,"EASTERN EUROPE-EU","BULGARIA","STANSTED","PLOVDIV",54518,54518,0
2016,"EASTERN EUROPE-EU","BULGARIA","STANSTED","SOFIA",115885,115676,209
2016,"EASTERN EUROPE-EU","CZECH REPUBLIC","GATWICK","PRAGUE",343771,343769,2
2016,"EASTERN EUROPE-EU","CZECH REPUBLIC","HEATHROW","PRAGUE",433214,433214,0
2016,"EASTERN EUROPE-EU","CZECH REPUBLIC","LUTON","BRNO (TURANY)",46758,46758,0
2016,"EASTERN EUROPE-EU","CZECH REPUBLIC","LUTON","PRAGUE",122408,122289,119
2016,"EASTERN EUROPE-EU","CZECH REPUBLIC","SOUTHEND","PRAGUE",0,0,0
2016,"EASTERN EUROPE-EU","CZECH REPUBLIC","STANSTED","BRNO (TURANY)",113883,113883,0
2016,"EASTERN EUROPE-EU","CZECH REPUBLIC","STANSTED","OSTRAVA",61978,61978,0
2016,"EASTERN EUROPE-EU","CZECH REPUBLIC","STANSTED","PRAGUE",351882,351882,0
2016,"EASTERN EUROPE-EU","ESTONIA","GATWICK","TALLIN",31154,31154,0
2016,"EASTERN EUROPE-EU","ESTONIA","LUTON","TALLIN",0,0,0
2016,"EASTERN EUROPE-EU","ESTONIA","STANSTED","TALLIN",75076,75076,0
2016,"EASTERN EUROPE-EU","HUNGARY","GATWICK","BUDAPEST",226442,225966,476
2016,"EASTERN EUROPE-EU","HUNGARY","HEATHROW","BUDAPEST",329022,329022,0
2016,"EASTERN EUROPE-EU","HUNGARY","LUTON","BUDAPEST",572472,572472,0
2016,"EASTERN EUROPE-EU","HUNGARY","LUTON","DEBRECEN",135199,135199,0
2016,"EASTERN EUROPE-EU","HUNGARY","STANSTED","BUDAPEST",369838,369838,0
2016,"EASTERN EUROPE-EU","LATVIA","GATWICK","RIGA",108894,108894,0
2016,"EASTERN EUROPE-EU","LATVIA","LUTON","RIGA",171218,171218,0
2016,"EASTERN EUROPE-EU","LATVIA","STANSTED","RIGA",258113,258113,0
2016,"EASTERN EUROPE-EU","LITHUANIA","GATWICK","KAUNAS",46823,46823,0
2016,"EASTERN EUROPE-EU","LITHUANIA","GATWICK","VILNIUS",25,0,25
2016,"EASTERN EUROPE-EU","LITHUANIA","LUTON","KAUNAS",177131,177131,0
2016,"EASTERN EUROPE-EU","LITHUANIA","LUTON","PALANGA",36263,36263,0
2016,"EASTERN EUROPE-EU","LITHUANIA","LUTON","VILNIUS",297840,297840,0
2016,"EASTERN EUROPE-EU","LITHUANIA","STANSTED","KAUNAS",47462,47462,0
2016,"EASTERN EUROPE-EU","LITHUANIA","STANSTED","PALANGA",29129,29129,0
2016,"EASTERN EUROPE-EU","LITHUANIA","STANSTED","VILNIUS",129487,129487,0
2016,"EASTERN EUROPE-EU","POLAND","GATWICK","KRAKOW",133952,133083,869
2016,"EASTERN EUROPE-EU","POLAND","GATWICK","RZESZOW",359,0,359
2016,"EASTERN EUROPE-EU","POLAND","GATWICK","WARSAW (CHOPIN)",66994,66994,0
2016,"EASTERN EUROPE-EU","POLAND","GATWICK","WROCLAW",107,0,107
2016,"EASTERN EUROPE-EU","POLAND","HEATHROW","KRAKOW",84174,84174,0
2016,"EASTERN EUROPE-EU","POLAND","HEATHROW","WARSAW (CHOPIN)",408657,408657,0
2016,"EASTERN EUROPE-EU","POLAND","LUTON","BYDGOSZCZ",145,145,0
2016,"EASTERN EUROPE-EU","POLAND","LUTON","GDANSK",268657,268643,14
2016,"EASTERN EUROPE-EU","POLAND","LUTON","KATOWICE",314117,314117,0
2016,"EASTERN EUROPE-EU","POLAND","LUTON","KRAKOW",808,0,808
2016,"EASTERN EUROPE-EU","POLAND","LUTON","LUBLIN (PORT LOTNICZY)",106103,106103,0
2016,"EASTERN EUROPE-EU","POLAND","LUTON","POZNAN",168258,168258,0
2016,"EASTERN EUROPE-EU","POLAND","LUTON","RZESZOW",56588,56588,0
2016,"EASTERN EUROPE-EU","POLAND","LUTON","SZCZECIN (GOLENOW)",47079,47079,0
2016,"EASTERN EUROPE-EU","POLAND","LUTON","SZYMANY (MAZURY)",22897,22897,0
2016,"EASTERN EUROPE-EU","POLAND","LUTON","WARSAW (CHOPIN)",400944,400736,208
2016,"EASTERN EUROPE-EU","POLAND","LUTON","WROCLAW",116274,116274,0
2016,"EASTERN EUROPE-EU","POLAND","STANSTED","BYDGOSZCZ",120188,120188,0
2016,"EASTERN EUROPE-EU","POLAND","STANSTED","GDANSK",214893,214893,0
2016,"EASTERN EUROPE-EU","POLAND","STANSTED","KATOWICE",132021,132021,0
2016,"EASTERN EUROPE-EU","POLAND","STANSTED","KRAKOW",352119,351737,382
2016,"EASTERN EUROPE-EU","POLAND","STANSTED","LODZ LUBLINEK",109484,109484,0
2016,"EASTERN EUROPE-EU","POLAND","STANSTED","LUBLIN (PORT LOTNICZY)",69556,69556,0
2016,"EASTERN EUROPE-EU","POLAND","STANSTED","POZNAN",131277,131277,0
2016,"EASTERN EUROPE-EU","POLAND","STANSTED","RZESZOW",144844,144844,0
2016,"EASTERN EUROPE-EU","POLAND","STANSTED","SZCZECIN (GOLENOW)",111168,111168,0
2016,"EASTERN EUROPE-EU","POLAND","STANSTED","SZYMANY (MAZURY)",7262,7262,0
2016,"EASTERN EUROPE-EU","POLAND","STANSTED","WARSAW (CHOPIN)",150,150,0
2016,"EASTERN EUROPE-EU","POLAND","STANSTED","WARSAW (MODLIN MASOVIA)",432509,432509,0
2016,"EASTERN EUROPE-EU","POLAND","STANSTED","WROCLAW",224462,224462,0
2016,"EASTERN EUROPE-EU","ROMANIA","GATWICK","BUCHAREST (OTOPENI)",70183,70183,0
2016,"EASTERN EUROPE-EU","ROMANIA","HEATHROW","BUCHAREST (BANEASA)",0,0,0
2016,"EASTERN EUROPE-EU","ROMANIA","HEATHROW","BUCHAREST (OTOPENI)",263321,263321,0
2016,"EASTERN EUROPE-EU","ROMANIA","LUTON","BACAU",77591,77591,0
2016,"EASTERN EUROPE-EU","ROMANIA","LUTON","BUCHAREST (OTOPENI)",513647,513647,0
2016,"EASTERN EUROPE-EU","ROMANIA","LUTON","CLUJ NAPOCA",240485,240465,20
2016,"EASTERN EUROPE-EU","ROMANIA","LUTON","CONSTANTA",32844,32844,0
2016,"EASTERN EUROPE-EU","ROMANIA","LUTON","CRAIOVA",79203,79203,0
2016,"EASTERN EUROPE-EU","ROMANIA","LUTON","IASI",140416,140416,0
2016,"EASTERN EUROPE-EU","ROMANIA","LUTON","SATU MARE",5328,5328,0
2016,"EASTERN EUROPE-EU","ROMANIA","LUTON","SIBIU",60676,60676,0
2016,"EASTERN EUROPE-EU","ROMANIA","LUTON","SUCEAVA",20364,20364,0
2016,"EASTERN EUROPE-EU","ROMANIA","LUTON","TIMISOARA",106716,106603,113
2016,"EASTERN EUROPE-EU","ROMANIA","LUTON","TIRGU MURES",62356,62356,0
2016,"EASTERN EUROPE-EU","ROMANIA","STANSTED","BUCHAREST (BANEASA)",59,0,59
2016,"EASTERN EUROPE-EU","ROMANIA","STANSTED","BUCHAREST (OTOPENI)",257720,257720,0
2016,"EASTERN EUROPE-EU","ROMANIA","STANSTED","TIMISOARA",38818,38818,0
2016,"EASTERN EUROPE-EU","SLOVAK REPUBLIC","LUTON","BRATISLAVA",59167,58986,181
2016,"EASTERN EUROPE-EU","SLOVAK REPUBLIC","LUTON","KOSICE",135116,135116,0
2016,"EASTERN EUROPE-EU","SLOVAK REPUBLIC","LUTON","TATRY-POPRAD",62002,62002,0
2016,"EASTERN EUROPE-EU","SLOVAK REPUBLIC","SOUTHEND","BRATISLAVA",0,0,0
2016,"EASTERN EUROPE-EU","SLOVAK REPUBLIC","STANSTED","BRATISLAVA",236563,236563,0
2016,"EASTERN EUROPE -OTHER","ALBANIA","GATWICK","TIRANA",84525,73389,11136
2016,"EASTERN EUROPE -OTHER","ALBANIA","STANSTED","TIRANA",2468,0,2468
2016,"EASTERN EUROPE -OTHER","AZERBAIJAN","HEATHROW","BAKU (HEYDER ALIYEV INT'L)",57801,57801,0
2016,"EASTERN EUROPE -OTHER","AZERBAIJAN","LUTON","BAKU (HEYDER ALIYEV INT'L)",756,0,756
2016,"EASTERN EUROPE -OTHER","BELARUS","GATWICK","MINSK INT'L ",24733,24733,0
2016,"EASTERN EUROPE -OTHER","GEORGIA","LUTON","TBILISI",6,0,6
2016,"EASTERN EUROPE -OTHER","KAZAKHSTAN","HEATHROW","ALMATY",200,0,200
2016,"EASTERN EUROPE -OTHER","KAZAKHSTAN","HEATHROW","ASTANA",32872,32872,0
2016,"EASTERN EUROPE -OTHER","KAZAKHSTAN","LUTON","ALMATY",212,0,212
2016,"EASTERN EUROPE -OTHER","REPUBLIC OF MOLDOVA","LUTON","CHISINAU (KISHINEV)",61699,61699,0
2016,"EASTERN EUROPE -OTHER","REPUBLIC OF MOLDOVA","STANSTED","CHISINAU (KISHINEV)",43885,43885,0
2016,"EASTERN EUROPE -OTHER","RUSSIA","GATWICK","ADLER / SOCHI",1160,0,1160
2016,"EASTERN EUROPE -OTHER","RUSSIA","GATWICK","MOSCOW (DOMODEDOVO)",19894,19894,0
2016,"EASTERN EUROPE -OTHER","RUSSIA","GATWICK","MOSCOW (SHEREMETYEVO)",8995,8995,0
2016,"EASTERN EUROPE -OTHER","RUSSIA","HEATHROW","KHANTY-MANSIYSK",184,184,0
2016,"EASTERN EUROPE -OTHER","RUSSIA","HEATHROW","MOSCOW (DOMODEDOVO)",247423,247423,0
2016,"EASTERN EUROPE -OTHER","RUSSIA","HEATHROW","MOSCOW (SHEREMETYEVO)",366209,366209,0
2016,"EASTERN EUROPE -OTHER","RUSSIA","HEATHROW","MOSCOW (VNUKOVO)",14,14,0
2016,"EASTERN EUROPE -OTHER","RUSSIA","HEATHROW","ST PETERSBURG",86566,86566,0
2016,"EASTERN EUROPE -OTHER","RUSSIA","LUTON","ADLER / SOCHI",172,0,172
2016,"EASTERN EUROPE -OTHER","RUSSIA","LUTON","MOSCOW (SHEREMETYEVO)",158,0,158
2016,"EASTERN EUROPE -OTHER","RUSSIA","LUTON","MOSCOW (VNUKOVO)",84,0,84
2016,"EASTERN EUROPE -OTHER","RUSSIA","LUTON","NOVOSIBIRSK (TOLMACHEVO)",1,0,1
2016,"EASTERN EUROPE -OTHER","RUSSIA","LUTON","ST PETERSBURG",11,0,11
2016,"EASTERN EUROPE -OTHER","RUSSIA","STANSTED","ST PETERSBURG",145,145,0
2016,"EASTERN EUROPE -OTHER","TURKMENISTAN","HEATHROW","ASHKHABAD",12093,12093,0
2016,"EASTERN EUROPE -OTHER","UKRAINE","GATWICK","KIEV (BORISPOL)",157426,157426,0
2016,"EASTERN EUROPE -OTHER","UKRAINE","GATWICK","KIEV (ZHULYANY)",147,147,0
2016,"EASTERN EUROPE -OTHER","UKRAINE","HEATHROW","KIEV (BORISPOL)",78349,78349,0
2016,"EASTERN EUROPE -OTHER","UKRAINE","LUTON","KIEV (BORISPOL)",246,244,2
2016,"EASTERN EUROPE -OTHER","UKRAINE","LUTON","KIEV (ZHULYANY)",31227,31208,19
2016,"EASTERN EUROPE -OTHER","UKRAINE","LUTON","LVOV",3,0,3
2016,"EASTERN EUROPE -OTHER","UKRAINE","LUTON","ODESSA",4,0,4
2016,"EASTERN EUROPE -OTHER","UZBEKISTAN","GATWICK","TASHKENT",0,0,0
2016,"EASTERN EUROPE -OTHER","UZBEKISTAN","HEATHROW","TASHKENT",23545,23545,0
2016,"NEAR EAST","ISRAEL","GATWICK","TEL AVIV",44782,44782,0
2016,"NEAR EAST","ISRAEL","HEATHROW","TEL AVIV",568922,568664,258
2016,"NEAR EAST","ISRAEL","LUTON","OVDA",4592,4293,299
2016,"NEAR EAST","ISRAEL","LUTON","TEL AVIV",370135,366993,3142
2016,"NEAR EAST","ISRAEL","STANSTED","TEL AVIV",0,0,0
2016,"NEAR EAST","JORDAN","GATWICK","AQABA",340,120,220
2016,"NEAR EAST","JORDAN","HEATHROW","AMMAN",209751,209751,0
2016,"NEAR EAST","JORDAN","LUTON","AMMAN (KING HUSSEIN)",4,0,4
2016,"NEAR EAST","JORDAN","STANSTED","AMMAN",248,0,248
2016,"NEAR EAST","LEBANON","HEATHROW","BEIRUT",271359,271359,0
2016,"NORTH AFRICA","ALGERIA","GATWICK","ALGIERS",51063,51063,0
2016,"NORTH AFRICA","ALGERIA","GATWICK","HASSI MESSAOUD",0,0,0
2016,"NORTH AFRICA","ALGERIA","HEATHROW","ALGIERS",76807,76807,0
2016,"NORTH AFRICA","ALGERIA","LUTON","ALGIERS",6,0,6
2016,"NORTH AFRICA","ALGERIA","STANSTED","HASSI MESSAOUD",5585,0,5585
2016,"NORTH AFRICA","EGYPT","GATWICK","HURGHADA",133686,48278,85408
2016,"NORTH AFRICA","EGYPT","GATWICK","LUXOR",3794,0,3794
2016,"NORTH AFRICA","EGYPT","GATWICK","MARSA ALAM",16800,0,16800
2016,"NORTH AFRICA","EGYPT","GATWICK","MERSA MATROUH",0,0,0
2016,"NORTH AFRICA","EGYPT","GATWICK","SHARM EL SHEIKH (OPHIRA)",2,0,2
2016,"NORTH AFRICA","EGYPT","HEATHROW","CAIRO",351703,351703,0
2016,"NORTH AFRICA","EGYPT","HEATHROW","LUXOR",5105,5105,0
2016,"NORTH AFRICA","EGYPT","LUTON","CAIRO",1,0,1
2016,"NORTH AFRICA","EGYPT","LUTON","HURGHADA",18,0,18
2016,"NORTH AFRICA","EGYPT","LUTON","MERSA MATROUH",0,0,0
2016,"NORTH AFRICA","EGYPT","LUTON","SHARM EL SHEIKH (OPHIRA)",0,0,0
2016,"NORTH AFRICA","EGYPT","STANSTED","SHARM EL SHEIKH (OPHIRA)",0,0,0
2016,"NORTH AFRICA","MOROCCO","GATWICK","AGADIR (AL MASSIRA)",85625,84144,1481
2016,"NORTH AFRICA","MOROCCO","GATWICK","CASABLANCA MOHAMED V",46604,46604,0
2016,"NORTH AFRICA","MOROCCO","GATWICK","MARRAKESH",303777,303666,111
2016,"NORTH AFRICA","MOROCCO","GATWICK","OUARZAZATE",787,0,787
2016,"NORTH AFRICA","MOROCCO","GATWICK","RABAT",21085,20850,235
2016,"NORTH AFRICA","MOROCCO","GATWICK","TANGIERS (IBN BATUTA)",23589,23589,0
2016,"NORTH AFRICA","MOROCCO","HEATHROW","CASABLANCA MOHAMED V",89851,89851,0
2016,"NORTH AFRICA","MOROCCO","HEATHROW","MARRAKESH",516,516,0
2016,"NORTH AFRICA","MOROCCO","LUTON","ESSAOUIRA",28147,28147,0
2016,"NORTH AFRICA","MOROCCO","LUTON","MARRAKESH",69887,69738,149
2016,"NORTH AFRICA","MOROCCO","LUTON","RABAT",9,0,9
2016,"NORTH AFRICA","MOROCCO","LUTON","TANGIERS (IBN BATUTA)",0,0,0
2016,"NORTH AFRICA","MOROCCO","STANSTED","AGADIR (AL MASSIRA)",5392,5392,0
2016,"NORTH AFRICA","MOROCCO","STANSTED","FEZ",34475,34475,0
2016,"NORTH AFRICA","MOROCCO","STANSTED","MARRAKESH",127361,126506,855
2016,"NORTH AFRICA","MOROCCO","STANSTED","RABAT",52542,52542,0
2016,"NORTH AFRICA","TUNISIA","GATWICK","ENFIDHA - HAMMAMET INTL",0,0,0
2016,"NORTH AFRICA","TUNISIA","GATWICK","JERBA",0,0,0
2016,"NORTH AFRICA","TUNISIA","GATWICK","MONASTIR",0,0,0
2016,"NORTH AFRICA","TUNISIA","GATWICK","TUNIS",23703,23703,0
2016,"NORTH AFRICA","TUNISIA","HEATHROW","MONASTIR",0,0,0
2016,"NORTH AFRICA","TUNISIA","HEATHROW","TUNIS",43423,43423,0
2016,"NORTH AFRICA","TUNISIA","LUTON","ENFIDHA - HAMMAMET INTL",0,0,0
2016,"NORTH AFRICA","TUNISIA","STANSTED","ENFIDHA - HAMMAMET INTL",0,0,0
2016,"NORTH AFRICA","TUNISIA","STANSTED","MONASTIR",0,0,0
2016,"EAST AFRICA","ETHIOPIA","HEATHROW","ADDIS ABABA",176975,176975,0
2016,"EAST AFRICA","KENYA","HEATHROW","MOMBASA",0,0,0
2016,"EAST AFRICA","KENYA","HEATHROW","NAIROBI",310425,310425,0
2016,"EAST AFRICA","UGANDA","HEATHROW","ENTEBBE",0,0,0
2016,"WEST AFRICA","GAMBIA","GATWICK","BANJUL",49078,29033,20045
2016,"WEST AFRICA","GHANA","GATWICK","ACCRA",534,0,534
2016,"WEST AFRICA","GHANA","HEATHROW","ACCRA",213543,213543,0
2016,"WEST AFRICA","NIGERIA","GATWICK","LAGOS",53618,53618,0
2016,"WEST AFRICA","NIGERIA","HEATHROW","ABUJA",106766,106766,0
2016,"WEST AFRICA","NIGERIA","HEATHROW","LAGOS",393612,393612,0
2016,"WEST AFRICA","SENEGAL","LUTON","DAKAR",0,0,0
2016,"CENTRAL AFRICA","ANGOLA","HEATHROW","LUANDA",17449,17449,0
2016,"SOUTHERN AFRICA","REPUBLIC OF SOUTH AFRICA","GATWICK","CAPE TOWN",10164,10164,0
2016,"SOUTHERN AFRICA","REPUBLIC OF SOUTH AFRICA","HEATHROW","CAPE TOWN",324307,324307,0
2016,"SOUTHERN AFRICA","REPUBLIC OF SOUTH AFRICA","HEATHROW","JOHANNESBURG",966897,966897,0
2016,"MIDDLE EAST","BAHRAIN","HEATHROW","BAHRAIN",284005,284005,0
2016,"MIDDLE EAST","BAHRAIN","LUTON","BAHRAIN",0,0,0
2016,"MIDDLE EAST","IRAN","HEATHROW","TEHRAN IMAM KHOMEINI",78027,78027,0
2016,"MIDDLE EAST","IRAN","LUTON","TEHRAN",4,0,4
2016,"MIDDLE EAST","IRAQ","GATWICK","BAGHDAD (GECA)",6451,6392,59
2016,"MIDDLE EAST","IRAQ","GATWICK","ERBIL INTERNATIONAL",0,0,0
2016,"MIDDLE EAST","IRAQ","GATWICK","SULAYMANIYAH INT",8274,8274,0
2016,"MIDDLE EAST","KUWAIT","HEATHROW","KUWAIT",279983,279983,0
2016,"MIDDLE EAST","KUWAIT","LUTON","KUWAIT",18,0,18
2016,"MIDDLE EAST","OMAN","GATWICK","MUSCAT",0,0,0
2016,"MIDDLE EAST","OMAN","HEATHROW","MUSCAT",252613,252613,0
2016,"MIDDLE EAST","QATAR","HEATHROW","DOHA HAMAD",1206752,1206571,181
2016,"MIDDLE EAST","SAUDI ARABIA","GATWICK","RIYADH",0,0,0
2016,"MIDDLE EAST","SAUDI ARABIA","HEATHROW","JEDDAH",248046,248046,0
2016,"MIDDLE EAST","SAUDI ARABIA","HEATHROW","MEDINA",3929,3929,0
2016,"MIDDLE EAST","SAUDI ARABIA","HEATHROW","RIYADH",253021,253021,0
2016,"MIDDLE EAST","SAUDI ARABIA","LUTON","DHAHRAN",4,0,4
2016,"MIDDLE EAST","SAUDI ARABIA","LUTON","JEDDAH",3,0,3
2016,"MIDDLE EAST","SAUDI ARABIA","LUTON","RIYADH",9,0,9
2016,"MIDDLE EAST","SAUDI ARABIA","LUTON","TABUK",0,0,0
2016,"MIDDLE EAST","UNITED ARAB EMIRATES","GATWICK","DUBAI",920462,920462,0
2016,"MIDDLE EAST","UNITED ARAB EMIRATES","GATWICK","DUBAI (WORLD CENTRAL)",1105,0,1105
2016,"MIDDLE EAST","UNITED ARAB EMIRATES","HEATHROW","ABU DHABI INTERNATIONAL",929020,929020,0
2016,"MIDDLE EAST","UNITED ARAB EMIRATES","HEATHROW","DUBAI",2651776,2651776,0
2016,"MIDDLE EAST","UNITED ARAB EMIRATES","LUTON","ABU DHABI - BATEEN",33,0,33
2016,"MIDDLE EAST","UNITED ARAB EMIRATES","LUTON","DUBAI",2,0,2
2016,"MIDDLE EAST","UNITED ARAB EMIRATES","SOUTHEND","SHARJAH",0,0,0
2016,"INDIAN SUB-CONTINENT","BANGLADESH","HEATHROW","DHAKHA",71419,71419,0
2016,"INDIAN SUB-CONTINENT","BANGLADESH","HEATHROW","SYLHET",52875,52875,0
2016,"INDIAN SUB-CONTINENT","INDIA","GATWICK","GOA",39460,19102,20358
2016,"INDIAN SUB-CONTINENT","INDIA","HEATHROW","AHMEDABAD",31524,31524,0
2016,"INDIAN SUB-CONTINENT","INDIA","HEATHROW","AMRITSAR",6927,6927,0
2016,"INDIAN SUB-CONTINENT","INDIA","HEATHROW","BANGALORE (BENGALURU)",167169,167169,0
2016,"INDIAN SUB-CONTINENT","INDIA","HEATHROW","CHENNAI",131092,131092,0
2016,"INDIAN SUB-CONTINENT","INDIA","HEATHROW","DELHI",1042532,1042532,0
2016,"INDIAN SUB-CONTINENT","INDIA","HEATHROW","HYDERABAD ( RAJIV GHANDI )",135936,135936,0
2016,"INDIAN SUB-CONTINENT","INDIA","HEATHROW","MUMBAI",916714,916714,0
2016,"INDIAN SUB-CONTINENT","INDIA","LUTON","JAIPUR",56,0,56
2016,"INDIAN SUB-CONTINENT","PAKISTAN","GATWICK","ISLAMABAD",650,80,570
2016,"INDIAN SUB-CONTINENT","PAKISTAN","HEATHROW","ISLAMABAD",98916,98916,0
2016,"INDIAN SUB-CONTINENT","PAKISTAN","HEATHROW","KARACHI",43763,43763,0
2016,"INDIAN SUB-CONTINENT","PAKISTAN","HEATHROW","LAHORE",75075,75075,0
2016,"INDIAN SUB-CONTINENT","SRI LANKA","GATWICK","COLOMBO",3477,0,3477
2016,"INDIAN SUB-CONTINENT","SRI LANKA","HEATHROW","COLOMBO",208816,208816,0
2016,"FAR EAST","BRUNEI","HEATHROW","BANDAR SERI BEGAWAN",77577,77577,0
2016,"FAR EAST","CHINA","GATWICK","CHONGQING JIANGBEI INTERNATIONAL",6719,6719,0
2016,"FAR EAST","CHINA","GATWICK","TIANJIN",11587,11587,0
2016,"FAR EAST","CHINA","GATWICK","XIAMEN",5,0,5
2016,"FAR EAST","CHINA","HEATHROW","BEIJING",494984,494984,0
2016,"FAR EAST","CHINA","HEATHROW","CHENGDU",57107,57107,0
2016,"FAR EAST","CHINA","HEATHROW","GUANGZHOU BAIYUN INTERNATIONAL",134854,134854,0
2016,"FAR EAST","CHINA","HEATHROW","SHANGHAI (PU DONG)",464022,464022,0
2016,"FAR EAST","HONG KONG","GATWICK","HONG KONG (CHEK LAP KOK)",33325,33325,0
2016,"FAR EAST","HONG KONG","HEATHROW","HONG KONG (CHEK LAP KOK)",1574741,1574741,0
2016,"FAR EAST","INDONESIA","GATWICK","JAKARTA (SOEKARNO-HATTA INTNL)",8323,8323,0
2016,"FAR EAST","INDONESIA","HEATHROW","JAKARTA (SOEKARNO-HATTA INTNL)",28052,28052,0
2016,"FAR EAST","JAPAN","HEATHROW","TOKYO (HANEDA)",458382,458382,0
2016,"FAR EAST","JAPAN","HEATHROW","TOKYO (NARITA)",149651,149651,0
2016,"FAR EAST","MALAYSIA","HEATHROW","KUALA LUMPUR (SEPANG)",622852,622852,0
2016,"FAR EAST","PHILIPPINES","HEATHROW","MANILA",108664,108664,0
2016,"FAR EAST","REPUBLIC OF KOREA","HEATHROW","SEOUL (INCHEON)",473602,473569,33
2016,"FAR EAST","SINGAPORE","HEATHROW","SINGAPORE",1198727,1198727,0
2016,"FAR EAST","TAIWAN","HEATHROW","TAIPEI",44681,44681,0
2016,"FAR EAST","THAILAND","GATWICK","PHUKET",14543,0,14543
2016,"FAR EAST","THAILAND","HEATHROW","BANGKOK SUVARNABHUMI ",773105,773105,0
2016,"FAR EAST","VIETNAM","GATWICK","HANOI",0,0,0
2016,"FAR EAST","VIETNAM","GATWICK","HO CHI MINH CITY",0,0,0
2016,"FAR EAST","VIETNAM","HEATHROW","HANOI",72965,72965,0
2016,"FAR EAST","VIETNAM","HEATHROW","HO CHI MINH CITY",59873,59873,0
2016,"AUSTRALASIA","AUSTRALIA","HEATHROW","BRISBANE",332,0,332
2016,"AUSTRALASIA","AUSTRALIA","HEATHROW","MELBOURNE",134547,134211,336
2016,"AUSTRALASIA","AUSTRALIA","HEATHROW","SYDNEY",290552,289883,669
2016,"AUSTRALASIA","AUSTRALIA","STANSTED","SYDNEY",1042,0,1042
2016,"AUSTRALASIA","NEW ZEALAND","HEATHROW","AUCKLAND INTERNATIONAL",36071,36071,0
2016,"CANADA","CANADA","GATWICK","CALGARY",99035,99035,0
2016,"CANADA","CANADA","GATWICK","EDMONTON",22870,22870,0
2016,"CANADA","CANADA","GATWICK","HALIFAX INT",0,0,0
2016,"CANADA","CANADA","GATWICK","MONTREAL (DORVAL)",24304,24304,0
2016,"CANADA","CANADA","GATWICK","OTTAWA INTERNATIONAL",36146,36146,0
2016,"CANADA","CANADA","GATWICK","ST JOHNS",242,242,0
2016,"CANADA","CANADA","GATWICK","TORONTO",387774,387774,0
2016,"CANADA","CANADA","GATWICK","VANCOUVER",171121,171121,0
2016,"CANADA","CANADA","GATWICK","WINNIPEG",10480,10480,0
2016,"CANADA","CANADA","HEATHROW","CALGARY",287730,287730,0
2016,"CANADA","CANADA","HEATHROW","EDMONTON",0,0,0
2016,"CANADA","CANADA","HEATHROW","HALIFAX INT",77811,77811,0
2016,"CANADA","CANADA","HEATHROW","MONTREAL (DORVAL)",311076,311076,0
2016,"CANADA","CANADA","HEATHROW","OTTAWA INTERNATIONAL",115498,115498,0
2016,"CANADA","CANADA","HEATHROW","ST JOHNS",35434,35434,0
2016,"CANADA","CANADA","HEATHROW","TORONTO",1053524,1053208,316
2016,"CANADA","CANADA","HEATHROW","VANCOUVER",567804,567804,0
2016,"CANADA","CANADA","LUTON","GANDER",6,0,6
2016,"UNITED STATES OF AMERICA","USA","GATWICK","BOSTON",94713,94713,0
2016,"UNITED STATES OF AMERICA","USA","GATWICK","BUFFALO",0,0,0
2016,"UNITED STATES OF AMERICA","USA","GATWICK","DETROIT",65,65,0
2016,"UNITED STATES OF AMERICA","USA","GATWICK","FORT LAUDERDALE",50383,50383,0
2016,"UNITED STATES OF AMERICA","USA","GATWICK","INDIANAPOLIS",451,0,451
2016,"UNITED STATES OF AMERICA","USA","GATWICK","LAS VEGAS",284941,284941,0
2016,"UNITED STATES OF AMERICA","USA","GATWICK","LOS ANGELES INTERNATIONAL",141341,141252,89
2016,"UNITED STATES OF AMERICA","USA","GATWICK","MINNEAPOLIS-ST PAUL",86,0,86
2016,"UNITED STATES OF AMERICA","USA","GATWICK","NEW ORLEANS",1142,0,1142
2016,"UNITED STATES OF AMERICA","USA","GATWICK","NEW YORK (JF KENNEDY)",330755,330755,0
2016,"UNITED STATES OF AMERICA","USA","GATWICK","OAKLAND",55917,55917,0
2016,"UNITED STATES OF AMERICA","USA","GATWICK","ORLANDO",791669,791668,1
2016,"UNITED STATES OF AMERICA","USA","GATWICK","SANFORD",41493,0,41493
2016,"UNITED STATES OF AMERICA","USA","GATWICK","TAMPA",156276,156276,0
2016,"UNITED STATES OF AMERICA","USA","GATWICK","WASHINGTON (DULLES)",0,0,0
2016,"UNITED STATES OF AMERICA","USA","HEATHROW","ATLANTA",638995,638995,0
2016,"UNITED STATES OF AMERICA","USA","HEATHROW","AUSTIN (BERGSTROM)",130614,130614,0
2016,"UNITED STATES OF AMERICA","USA","HEATHROW","BALTIMORE",120460,120460,0
2016,"UNITED STATES OF AMERICA","USA","HEATHROW","BOSTON",798119,798119,0
2016,"UNITED STATES OF AMERICA","USA","HEATHROW","BUFFALO",0,0,0
2016,"UNITED STATES OF AMERICA","USA","HEATHROW","CHARLOTTE",301682,301682,0
2016,"UNITED STATES OF AMERICA","USA","HEATHROW","CHICAGO (O'HARE)",1072875,1072875,0
2016,"UNITED STATES OF AMERICA","USA","HEATHROW","CINCINNATI",336,0,336
2016,"UNITED STATES OF AMERICA","USA","HEATHROW","COLUMBUS RICKENBACKER AFB",0,0,0
2016,"UNITED STATES OF AMERICA","USA","HEATHROW","DALLAS/FORT WORTH",655590,655590,0
2016,"UNITED STATES OF AMERICA","USA","HEATHROW","DENVER INTERNATIONAL",192441,192441,0
2016,"UNITED STATES OF AMERICA","USA","HEATHROW","DETROIT",215904,215742,162
2016,"UNITED STATES OF AMERICA","USA","HEATHROW","FORT LAUDERDALE",0,0,0
2016,"UNITED STATES OF AMERICA","USA","HEATHROW","HOUSTON",515278,515278,0
2016,"UNITED STATES OF AMERICA","USA","HEATHROW","INDIANAPOLIS",336,0,336
2016,"UNITED STATES OF AMERICA","USA","HEATHROW","JACKSONVILLE",404,0,404
2016,"UNITED STATES OF AMERICA","USA","HEATHROW","KANSAS CITY",0,0,0
2016,"UNITED STATES OF AMERICA","USA","HEATHROW","LAS VEGAS",312708,312708,0
2016,"UNITED STATES OF AMERICA","USA","HEATHROW","LOS ANGELES INTERNATIONAL",1529632,1529455,177
2016,"UNITED STATES OF AMERICA","USA","HEATHROW","MIAMI INTERNATIONAL",1030483,1030483,0
2016,"UNITED STATES OF AMERICA","USA","HEATHROW","MINNEAPOLIS-ST PAUL",134659,134235,424
2016,"UNITED STATES OF AMERICA","USA","HEATHROW","NEW YORK (JF KENNEDY)",2934554,2934554,0
2016,"UNITED STATES OF AMERICA","USA","HEATHROW","NEW YORK (NEWARK)",944639,944225,414
2016,"UNITED STATES OF AMERICA","USA","HEATHROW","ORLANDO",1004,0,1004
2016,"UNITED STATES OF AMERICA","USA","HEATHROW","PHILADELPHIA INTERNATIONAL",457612,457612,0
2016,"UNITED STATES OF AMERICA","USA","HEATHROW","PHOENIX",216995,216995,0
2016,"UNITED STATES OF AMERICA","USA","HEATHROW","RALEIGH",111152,111152,0
2016,"UNITED STATES OF AMERICA","USA","HEATHROW","SALT LAKE CITY",63606,63606,0
2016,"UNITED STATES OF AMERICA","USA","HEATHROW","SAN DIEGO",196067,196067,0
2016,"UNITED STATES OF AMERICA","USA","HEATHROW","SAN FRANCISCO",1016616,1016616,0
2016,"UNITED STATES OF AMERICA","USA","HEATHROW","SAN JOSE",76302,76302,0
2016,"UNITED STATES OF AMERICA","USA","HEATHROW","SEATTLE (TACOMA)",370113,370113,0
2016,"UNITED STATES OF AMERICA","USA","HEATHROW","WASHINGTON (DULLES)",849690,849381,309
2016,"UNITED STATES OF AMERICA","USA","LONDON CITY","NEW YORK (JF KENNEDY)",18850,18850,0
2016,"UNITED STATES OF AMERICA","USA","LUTON","BOSTON",7,0,7
2016,"UNITED STATES OF AMERICA","USA","LUTON","DALLAS",9,0,9
2016,"UNITED STATES OF AMERICA","USA","LUTON","INDIANAPOLIS",8,0,8
2016,"UNITED STATES OF AMERICA","USA","LUTON","LOS ANGELES INTERNATIONAL",6,0,6
2016,"UNITED STATES OF AMERICA","USA","LUTON","MILWAUKEE",0,0,0
2016,"UNITED STATES OF AMERICA","USA","LUTON","MINNEAPOLIS-ST PAUL",4,0,4
2016,"UNITED STATES OF AMERICA","USA","LUTON","NEW YORK (JF KENNEDY)",0,0,0
2016,"UNITED STATES OF AMERICA","USA","LUTON","NEW YORK (NEWARK)",16333,16323,10
2016,"UNITED STATES OF AMERICA","USA","LUTON","WASHINGTON (DULLES)",4,0,4
2016,"UNITED STATES OF AMERICA","USA","SOUTHEND","LOS ANGELES INTERNATIONAL",0,0,0
2016,"UNITED STATES OF AMERICA","USA","STANSTED","FORT LAUDERDALE",321,321,0
2016,"UNITED STATES OF AMERICA","USA","STANSTED","LAS VEGAS",3515,3515,0
2016,"UNITED STATES OF AMERICA","USA","STANSTED","ORLANDO",39819,39819,0
2016,"UNITED STATES OF AMERICA","USA","STANSTED","SANFORD",11365,0,11365
2016,"CENTRAL AMERICA","COSTA RICA","GATWICK","LIBERIA",29193,0,29193
2016,"CENTRAL AMERICA","COSTA RICA","GATWICK","SAN JOSE COST RICA",31391,31391,0
2016,"CENTRAL AMERICA","CUBA","GATWICK","CUNAGUA (CAYO COCO)",16624,16624,0
2016,"CENTRAL AMERICA","CUBA","GATWICK","HAVANA",92242,92242,0
2016,"CENTRAL AMERICA","CUBA","GATWICK","HOLGUIN (FRANK PAIS)",30091,30091,0
2016,"CENTRAL AMERICA","CUBA","GATWICK","VARADERO",20131,0,20131
2016,"CENTRAL AMERICA","DOMINICAN REPUBLIC","GATWICK","PUERTO PLATA",31292,0,31292
2016,"CENTRAL AMERICA","DOMINICAN REPUBLIC","GATWICK","PUNTA CANA",132532,52149,80383
2016,"CENTRAL AMERICA","MEXICO","GATWICK","ACAPULCO",993,0,993
2016,"CENTRAL AMERICA","MEXICO","GATWICK","CANCUN",410685,245481,165204
2016,"CENTRAL AMERICA","MEXICO","GATWICK","COZUMEL",964,0,964
2016,"CENTRAL AMERICA","MEXICO","GATWICK","PUERTO VALLARTA",30987,0,30987
2016,"CENTRAL AMERICA","MEXICO","HEATHROW","MEXICO CITY",252812,252812,0
2016,"CENTRAL AMERICA","MEXICO","STANSTED","CANCUN",20080,3697,16383
2016,"SOUTH AMERICA","ARGENTINA","HEATHROW","BUENOS AIRES",177238,177238,0
2016,"SOUTH AMERICA","BRAZIL","HEATHROW","RIO DE JANEIRO (GALEAO)",138704,138080,624
2016,"SOUTH AMERICA","BRAZIL","HEATHROW","SAO PAULO (GUARULHOS)",422422,422422,0
2016,"SOUTH AMERICA","COLOMBIA","GATWICK","CARTAGENA",1470,0,1470
2016,"SOUTH AMERICA","COLOMBIA","HEATHROW","BOGOTA",149723,149723,0
2016,"SOUTH AMERICA","ECUADOR","GATWICK","GUAYAQUIL",868,0,868
2016,"SOUTH AMERICA","PERU","GATWICK","LIMA",36744,36744,0
2016,"SOUTH AMERICA","VENEZUELA","HEATHROW","CARACAS",0,0,0
2016,"CARIBBEAN AREA","ANTIGUA AND BARBUDA","GATWICK","ANTIGUA",152851,152851,0
2016,"CARIBBEAN AREA","BAHAMAS","GATWICK","NASSAU",312,0,312
2016,"CARIBBEAN AREA","BAHAMAS","HEATHROW","NASSAU",51108,51108,0
2016,"CARIBBEAN AREA","BARBADOS","GATWICK","BRIDGETOWN",447003,383182,63821
2016,"CARIBBEAN AREA","BARBADOS","HEATHROW","BRIDGETOWN",454,454,0
2016,"CARIBBEAN AREA","BARBADOS","LUTON","BRIDGETOWN",0,0,0
2016,"CARIBBEAN AREA","BARBADOS","STANSTED","BRIDGETOWN",584,0,584
2016,"CARIBBEAN AREA","BERMUDA","GATWICK","BERMUDA",91856,91856,0
2016,"CARIBBEAN AREA","CAYMAN ISLANDS","HEATHROW","GRAND CAYMAN",33570,33570,0
2016,"CARIBBEAN AREA","GRENADA","GATWICK","GRENADA",64571,64571,0
2016,"CARIBBEAN AREA","ISLE OF CURACAO NETH.ANTILLES","GATWICK","ARUBA",17137,0,17137
2016,"CARIBBEAN AREA","JAMAICA","GATWICK","KINGSTON",84898,84898,0
2016,"CARIBBEAN AREA","JAMAICA","GATWICK","MONTEGO BAY",216862,116924,99938
2016,"CARIBBEAN AREA","JAMAICA","STANSTED","MONTEGO BAY",571,0,571
2016,"CARIBBEAN AREA","PUERTO RICO","GATWICK","SAN JUAN (PUERTO RICO)",24748,24748,0
2016,"CARIBBEAN AREA","SAINT KITTS AND NEVIS","GATWICK","ST KITTS",29936,29936,0
2016,"CARIBBEAN AREA","SAINT KITTS AND NEVIS","STANSTED","ST KITTS",0,0,0
2016,"CARIBBEAN AREA","ST LUCIA","GATWICK","ST LUCIA (HEWANORRA)",120632,118191,2441
2016,"CARIBBEAN AREA","TRINIDAD AND TOBAGO","GATWICK","PORT OF SPAIN",86121,86121,0
2016,"CARIBBEAN AREA","TRINIDAD AND TOBAGO","GATWICK","TOBAGO",55973,55973,0
2016,"CARIBBEAN AREA","TURKS AND CAICOS ISLANDS","GATWICK","PROVIDENCIALES",27283,27283,0
2016,"CARIBBEAN AREA","TURKS AND CAICOS ISLANDS","HEATHROW","PROVIDENCIALES",0,0,0
2016,"INDIAN OCEAN ISLANDS","MALDIVE ISLANDS","GATWICK","MALE INTERNATIONAL",29485,29485,0
2016,"INDIAN OCEAN ISLANDS","MAURITIUS","GATWICK","MAURITIUS",111819,111819,0
2016,"INDIAN OCEAN ISLANDS","MAURITIUS","HEATHROW","MAURITIUS",87081,87081,0
2016,"INDIAN OCEAN ISLANDS","MAURITIUS","STANSTED","MAURITIUS",0,0,0
2016,"ATLANTIC OCEAN ISLANDS","CAPE VERDE ISLANDS","GATWICK","BOA VISTA (RABIL)",62052,55734,6318
2016,"ATLANTIC OCEAN ISLANDS","CAPE VERDE ISLANDS","GATWICK","ILHA DO SAL C.VERDE",69502,66396,3106
2016,"ATLANTIC OCEAN ISLANDS","CAPE VERDE ISLANDS","GATWICK","SAN PEDRO (CAPE VERDE)",0,0,0
2016,"ATLANTIC OCEAN ISLANDS","CAPE VERDE ISLANDS","STANSTED","BOA VISTA (RABIL)",201,201,0
2016,"ATLANTIC OCEAN ISLANDS","FALKLAND ISLANDS","GATWICK","MOUNT PLEASANT",902,0,902
2017,"Unknown","Unknown","GATWICK","Unknown",32,0,32
2017,"Unknown","Unknown","STANSTED","Unknown",0,0,0
2017,"WESTERN EUROPE-EU","AUSTRIA","GATWICK","INNSBRUCK",209084,183664,25420
2017,"WESTERN EUROPE-EU","AUSTRIA","GATWICK","KLAGENFURT",838,838,0
2017,"WESTERN EUROPE-EU","AUSTRIA","GATWICK","SALZBURG",144593,125057,19536
2017,"WESTERN EUROPE-EU","AUSTRIA","GATWICK","VIENNA",223828,223828,0
2017,"WESTERN EUROPE-EU","AUSTRIA","HEATHROW","INNSBRUCK",34573,34573,0
2017,"WESTERN EUROPE-EU","AUSTRIA","HEATHROW","SALZBURG",13566,13231,335
2017,"WESTERN EUROPE-EU","AUSTRIA","HEATHROW","VIENNA",807858,807858,0
2017,"WESTERN EUROPE-EU","AUSTRIA","LONDON CITY","GRAZ",0,0,0
2017,"WESTERN EUROPE-EU","AUSTRIA","LUTON","GRAZ",819,0,819
2017,"WESTERN EUROPE-EU","AUSTRIA","LUTON","INNSBRUCK",8515,8515,0
2017,"WESTERN EUROPE-EU","AUSTRIA","LUTON","KLAGENFURT",0,0,0
2017,"WESTERN EUROPE-EU","AUSTRIA","LUTON","LINZ",190,0,190
2017,"WESTERN EUROPE-EU","AUSTRIA","LUTON","SALZBURG",11107,7648,3459
2017,"WESTERN EUROPE-EU","AUSTRIA","LUTON","VIENNA",64044,64008,36
2017,"WESTERN EUROPE-EU","AUSTRIA","SOUTHEND","VIENNA",13375,13375,0
2017,"WESTERN EUROPE-EU","AUSTRIA","STANSTED","GRAZ",502,0,502
2017,"WESTERN EUROPE-EU","AUSTRIA","STANSTED","INNSBRUCK",7775,0,7775
2017,"WESTERN EUROPE-EU","AUSTRIA","STANSTED","LINZ",34039,33929,110
2017,"WESTERN EUROPE-EU","AUSTRIA","STANSTED","SALZBURG",105552,101419,4133
2017,"WESTERN EUROPE-EU","AUSTRIA","STANSTED","VIENNA",86559,85566,993
2017,"WESTERN EUROPE-EU","BELGIUM","GATWICK","ANTWERP",45,45,0
2017,"WESTERN EUROPE-EU","BELGIUM","GATWICK","BRUSSELS",2240,2240,0
2017,"WESTERN EUROPE-EU","BELGIUM","HEATHROW","BRUSSELS",651009,651009,0
2017,"WESTERN EUROPE-EU","BELGIUM","HEATHROW","LIEGE",0,0,0
2017,"WESTERN EUROPE-EU","BELGIUM","LONDON CITY","ANTWERP",50564,50564,0
2017,"WESTERN EUROPE-EU","BELGIUM","LONDON CITY","OSTEND",39,0,39
2017,"WESTERN EUROPE-EU","BELGIUM","LUTON","BRUSSELS",0,0,0
2017,"WESTERN EUROPE-EU","BELGIUM","LUTON","LIEGE",0,0,0
2017,"WESTERN EUROPE-EU","BELGIUM","LUTON","OSTEND",108,0,108
2017,"WESTERN EUROPE-EU","BELGIUM","SOUTHEND","ANTWERP",43,43,0
2017,"WESTERN EUROPE-EU","BELGIUM","STANSTED","BRUSSELS",366,366,0
2017,"WESTERN EUROPE-EU","CROATIA","GATWICK","DUBROVNIK",239366,238974,392
2017,"WESTERN EUROPE-EU","CROATIA","GATWICK","PULA",35321,19221,16100
2017,"WESTERN EUROPE-EU","CROATIA","GATWICK","SPLIT",153495,144972,8523
2017,"WESTERN EUROPE-EU","CROATIA","GATWICK","ZAGREB",22260,22260,0
2017,"WESTERN EUROPE-EU","CROATIA","HEATHROW","DUBROVNIK",0,0,0
2017,"WESTERN EUROPE-EU","CROATIA","HEATHROW","PULA",7107,7107,0
2017,"WESTERN EUROPE-EU","CROATIA","HEATHROW","RIJEKA",4043,4043,0
2017,"WESTERN EUROPE-EU","CROATIA","HEATHROW","SPLIT",32607,32607,0
2017,"WESTERN EUROPE-EU","CROATIA","HEATHROW","ZAGREB",166287,166287,0
2017,"WESTERN EUROPE-EU","CROATIA","LUTON","DUBROVNIK",24462,24462,0
2017,"WESTERN EUROPE-EU","CROATIA","LUTON","SPLIT",72525,72525,0
2017,"WESTERN EUROPE-EU","CROATIA","LUTON","ZADAR",10671,10671,0
2017,"WESTERN EUROPE-EU","CROATIA","SOUTHEND","DUBROVNIK",5985,5985,0
2017,"WESTERN EUROPE-EU","CROATIA","SOUTHEND","ZADAR",4905,4905,0
2017,"WESTERN EUROPE-EU","CROATIA","STANSTED","DUBROVNIK",70277,69456,821
2017,"WESTERN EUROPE-EU","CROATIA","STANSTED","OSIJEK",0,0,0
2017,"WESTERN EUROPE-EU","CROATIA","STANSTED","PULA",37701,37701,0
2017,"WESTERN EUROPE-EU","CROATIA","STANSTED","RIJEKA",11620,11620,0
2017,"WESTERN EUROPE-EU","CROATIA","STANSTED","SPLIT",37704,37704,0
2017,"WESTERN EUROPE-EU","CROATIA","STANSTED","ZADAR",41773,36346,5427
2017,"WESTERN EUROPE-EU","CYPRUS","GATWICK","LARNACA",299600,238537,61063
2017,"WESTERN EUROPE-EU","CYPRUS","GATWICK","PAPHOS",403465,294313,109152
2017,"WESTERN EUROPE-EU","CYPRUS","HEATHROW","LARNACA",299292,299292,0
2017,"WESTERN EUROPE-EU","CYPRUS","LUTON","LARNACA",85998,76491,9507
2017,"WESTERN EUROPE-EU","CYPRUS","LUTON","PAPHOS",113018,78876,34142
2017,"WESTERN EUROPE-EU","CYPRUS","STANSTED","LARNACA",67632,57478,10154
2017,"WESTERN EUROPE-EU","CYPRUS","STANSTED","PAPHOS",185723,154384,31339
2017,"WESTERN EUROPE-EU","DENMARK","GATWICK","AALBORG",40380,40380,0
2017,"WESTERN EUROPE-EU","DENMARK","GATWICK","BILLUND",55,54,1
2017,"WESTERN EUROPE-EU","DENMARK","GATWICK","COPENHAGEN",808511,808276,235
2017,"WESTERN EUROPE-EU","DENMARK","HEATHROW","BILLUND",124523,124523,0
2017,"WESTERN EUROPE-EU","DENMARK","HEATHROW","COPENHAGEN",982928,982928,0
2017,"WESTERN EUROPE-EU","DENMARK","LONDON CITY","BILLUND",18979,18979,0
2017,"WESTERN EUROPE-EU","DENMARK","LUTON","AARHUS (TIRSTRUP)",0,0,0
2017,"WESTERN EUROPE-EU","DENMARK","LUTON","COPENHAGEN",266867,266855,12
2017,"WESTERN EUROPE-EU","DENMARK","SOUTHEND","BILLUND",99,99,0
2017,"WESTERN EUROPE-EU","DENMARK","STANSTED","AALBORG",15968,15968,0
2017,"WESTERN EUROPE-EU","DENMARK","STANSTED","AARHUS (TIRSTRUP)",95819,95819,0
2017,"WESTERN EUROPE-EU","DENMARK","STANSTED","BILLUND",213239,213239,0
2017,"WESTERN EUROPE-EU","DENMARK","STANSTED","COPENHAGEN",263371,263109,262
2017,"WESTERN EUROPE-EU","FINLAND","GATWICK","ENONTEKIO",4791,0,4791
2017,"WESTERN EUROPE-EU","FINLAND","GATWICK","HELSINKI",232720,232720,0
2017,"WESTERN EUROPE-EU","FINLAND","GATWICK","IVALO",11891,1773,10118
2017,"WESTERN EUROPE-EU","FINLAND","GATWICK","KITTILA",28832,6571,22261
2017,"WESTERN EUROPE-EU","FINLAND","GATWICK","KUUSAMO",3991,0,3991
2017,"WESTERN EUROPE-EU","FINLAND","GATWICK","ROVANIEMI",29443,19007,10436
2017,"WESTERN EUROPE-EU","FINLAND","HEATHROW","HELSINKI",714261,714261,0
2017,"WESTERN EUROPE-EU","FINLAND","LUTON","ENONTEKIO",0,0,0
2017,"WESTERN EUROPE-EU","FINLAND","LUTON","IVALO",719,0,719
2017,"WESTERN EUROPE-EU","FINLAND","LUTON","SEINAJOKI",42,0,42
2017,"WESTERN EUROPE-EU","FINLAND","LUTON","VAASA",0,0,0
2017,"WESTERN EUROPE-EU","FINLAND","STANSTED","ENONTEKIO",2447,0,2447
2017,"WESTERN EUROPE-EU","FINLAND","STANSTED","HELSINKI",0,0,0
2017,"WESTERN EUROPE-EU","FINLAND","STANSTED","IVALO",1805,0,1805
2017,"WESTERN EUROPE-EU","FINLAND","STANSTED","KITTILA",734,0,734
2017,"WESTERN EUROPE-EU","FINLAND","STANSTED","ROVANIEMI",1196,436,760
2017,"WESTERN EUROPE-EU","FINLAND","STANSTED","TAMPERE",98,0,98
2017,"WESTERN EUROPE-EU","FRANCE","GATWICK","AJACCIO",6935,6935,0
2017,"WESTERN EUROPE-EU","FRANCE","GATWICK","BASTIA",11196,11196,0
2017,"WESTERN EUROPE-EU","FRANCE","GATWICK","BIARRITZ",28785,28785,0
2017,"WESTERN EUROPE-EU","FRANCE","GATWICK","BORDEAUX",294040,294040,0
2017,"WESTERN EUROPE-EU","FRANCE","GATWICK","CANNES",3,0,3
2017,"WESTERN EUROPE-EU","FRANCE","GATWICK","CHAMBERY",44340,0,44340
2017,"WESTERN EUROPE-EU","FRANCE","GATWICK","CHATEAUROUX DEOLS",8,0,8
2017,"WESTERN EUROPE-EU","FRANCE","GATWICK","FIGARI",7239,7239,0
2017,"WESTERN EUROPE-EU","FRANCE","GATWICK","GRENOBLE",129318,54645,74673
2017,"WESTERN EUROPE-EU","FRANCE","GATWICK","LA ROCHELLE",28680,28680,0
2017,"WESTERN EUROPE-EU","FRANCE","GATWICK","LE HAVRE",0,0,0
2017,"WESTERN EUROPE-EU","FRANCE","GATWICK","LIMOGES",13856,13856,0
2017,"WESTERN EUROPE-EU","FRANCE","GATWICK","LYON",213213,204023,9190
2017,"WESTERN EUROPE-EU","FRANCE","GATWICK","MARSEILLE",154380,154380,0
2017,"WESTERN EUROPE-EU","FRANCE","GATWICK","MONTPELLIER",146562,146562,0
2017,"WESTERN EUROPE-EU","FRANCE","GATWICK","NANTES",162127,162127,0
2017,"WESTERN EUROPE-EU","FRANCE","GATWICK","NICE",622783,621878,905
2017,"WESTERN EUROPE-EU","FRANCE","GATWICK","NIMES",18,0,18
2017,"WESTERN EUROPE-EU","FRANCE","GATWICK","PARIS (CHARLES DE GAULLE)",455425,455117,308
2017,"WESTERN EUROPE-EU","FRANCE","GATWICK","PARIS (LE BOURGET)",0,0,0
2017,"WESTERN EUROPE-EU","FRANCE","GATWICK","PARIS (ORLY)",638,638,0
2017,"WESTERN EUROPE-EU","FRANCE","GATWICK","RENNES",17186,17186,0
2017,"WESTERN EUROPE-EU","FRANCE","GATWICK","STRASBOURG",0,0,0
2017,"WESTERN EUROPE-EU","FRANCE","GATWICK","TARBES-LOURDES INTERNATIONAL",1026,0,1026
2017,"WESTERN EUROPE-EU","FRANCE","GATWICK","TOULOUSE (BLAGNAC)",282042,275931,6111
2017,"WESTERN EUROPE-EU","FRANCE","HEATHROW","BASTIA",4889,0,4889
2017,"WESTERN EUROPE-EU","FRANCE","HEATHROW","BIARRITZ",4497,4497,0
2017,"WESTERN EUROPE-EU","FRANCE","HEATHROW","FIGARI",5438,0,5438
2017,"WESTERN EUROPE-EU","FRANCE","HEATHROW","GRENOBLE",11038,763,10275
2017,"WESTERN EUROPE-EU","FRANCE","HEATHROW","LYON",249677,249677,0
2017,"WESTERN EUROPE-EU","FRANCE","HEATHROW","MARSEILLE",248439,248439,0
2017,"WESTERN EUROPE-EU","FRANCE","HEATHROW","MONTPELLIER",8769,8769,0
2017,"WESTERN EUROPE-EU","FRANCE","HEATHROW","NANTES",9946,9946,0
2017,"WESTERN EUROPE-EU","FRANCE","HEATHROW","NICE",549690,549690,0
2017,"WESTERN EUROPE-EU","FRANCE","HEATHROW","PARIS (CHARLES DE GAULLE)",1207929,1207929,0
2017,"WESTERN EUROPE-EU","FRANCE","HEATHROW","PARIS (ORLY)",226685,226685,0
2017,"WESTERN EUROPE-EU","FRANCE","HEATHROW","TOULOUSE (BLAGNAC)",250002,250002,0
2017,"WESTERN EUROPE-EU","FRANCE","LONDON CITY","ANGERS- MARCE",0,0,0
2017,"WESTERN EUROPE-EU","FRANCE","LONDON CITY","AVIGNON",3740,3740,0
2017,"WESTERN EUROPE-EU","FRANCE","LONDON CITY","BERGERAC",9565,9565,0
2017,"WESTERN EUROPE-EU","FRANCE","LONDON CITY","CHAMBERY",6492,6492,0
2017,"WESTERN EUROPE-EU","FRANCE","LONDON CITY","DINARD",126,0,126
2017,"WESTERN EUROPE-EU","FRANCE","LONDON CITY","GRENOBLE",0,0,0
2017,"WESTERN EUROPE-EU","FRANCE","LONDON CITY","LILLE",75,0,75
2017,"WESTERN EUROPE-EU","FRANCE","LONDON CITY","NANTES",3984,3984,0
2017,"WESTERN EUROPE-EU","FRANCE","LONDON CITY","NICE",38546,38546,0
2017,"WESTERN EUROPE-EU","FRANCE","LONDON CITY","PARIS (CHARLES DE GAULLE)",4092,3900,192
2017,"WESTERN EUROPE-EU","FRANCE","LONDON CITY","PARIS (ORLY)",37309,37309,0
2017,"WESTERN EUROPE-EU","FRANCE","LONDON CITY","QUIMPER",6812,6812,0
2017,"WESTERN EUROPE-EU","FRANCE","LONDON CITY","RENNES",5709,5709,0
2017,"WESTERN EUROPE-EU","FRANCE","LONDON CITY","TOULON / HYERES",7533,7533,0
2017,"WESTERN EUROPE-EU","FRANCE","LUTON","BEZIERS",40818,40818,0
2017,"WESTERN EUROPE-EU","FRANCE","LUTON","BIARRITZ",5587,5587,0
2017,"WESTERN EUROPE-EU","FRANCE","LUTON","BORDEAUX",84847,84836,11
2017,"WESTERN EUROPE-EU","FRANCE","LUTON","BREST",974,974,0
2017,"WESTERN EUROPE-EU","FRANCE","LUTON","CANNES",0,0,0
2017,"WESTERN EUROPE-EU","FRANCE","LUTON","CARCASSONNE",80,80,0
2017,"WESTERN EUROPE-EU","FRANCE","LUTON","CHAMBERY",539,0,539
2017,"WESTERN EUROPE-EU","FRANCE","LUTON","CLERMONT FERRAND",1770,1267,503
2017,"WESTERN EUROPE-EU","FRANCE","LUTON","DEAUVILLE",0,0,0
2017,"WESTERN EUROPE-EU","FRANCE","LUTON","GRENOBLE",8065,7482,583
2017,"WESTERN EUROPE-EU","FRANCE","LUTON","LA ROCHELLE",79,0,79
2017,"WESTERN EUROPE-EU","FRANCE","LUTON","LILLE",39,0,39
2017,"WESTERN EUROPE-EU","FRANCE","LUTON","LYON",96229,95901,328
2017,"WESTERN EUROPE-EU","FRANCE","LUTON","MARSEILLE",40940,40940,0
2017,"WESTERN EUROPE-EU","FRANCE","LUTON","MONTPELLIER",16101,16101,0
2017,"WESTERN EUROPE-EU","FRANCE","LUTON","NANTES",43038,42936,102
2017,"WESTERN EUROPE-EU","FRANCE","LUTON","NICE",161975,161589,386
2017,"WESTERN EUROPE-EU","FRANCE","LUTON","NIMES",41508,41508,0
2017,"WESTERN EUROPE-EU","FRANCE","LUTON","PARIS (CHARLES DE GAULLE)",289242,289242,0
2017,"WESTERN EUROPE-EU","FRANCE","LUTON","PARIS (LE BOURGET)",25,0,25
2017,"WESTERN EUROPE-EU","FRANCE","LUTON","PARIS (ORLY)",29475,29475,0
2017,"WESTERN EUROPE-EU","FRANCE","LUTON","PERPIGNAN",183,183,0
2017,"WESTERN EUROPE-EU","FRANCE","LUTON","RODEZ",0,0,0
2017,"WESTERN EUROPE-EU","FRANCE","LUTON","ST ETIENNE",0,0,0
2017,"WESTERN EUROPE-EU","FRANCE","LUTON","STRASBOURG",251,251,0
2017,"WESTERN EUROPE-EU","FRANCE","LUTON","TOULON / HYERES",0,0,0
2017,"WESTERN EUROPE-EU","FRANCE","LUTON","TOULOUSE (BLAGNAC)",54728,54728,0
2017,"WESTERN EUROPE-EU","FRANCE","SOUTHEND","BASTIA",207,207,0
2017,"WESTERN EUROPE-EU","FRANCE","SOUTHEND","BORDEAUX",153,153,0
2017,"WESTERN EUROPE-EU","FRANCE","SOUTHEND","CAEN",12937,12937,0
2017,"WESTERN EUROPE-EU","FRANCE","SOUTHEND","LYON",15958,15958,0
2017,"WESTERN EUROPE-EU","FRANCE","SOUTHEND","NANTES",68,68,0
2017,"WESTERN EUROPE-EU","FRANCE","SOUTHEND","NICE",41,41,0
2017,"WESTERN EUROPE-EU","FRANCE","SOUTHEND","PARIS (CHARLES DE GAULLE)",49144,49144,0
2017,"WESTERN EUROPE-EU","FRANCE","SOUTHEND","PARIS (ORLY)",95,95,0
2017,"WESTERN EUROPE-EU","FRANCE","SOUTHEND","PERPIGNAN",3560,3560,0
2017,"WESTERN EUROPE-EU","FRANCE","SOUTHEND","RENNES",44921,44921,0
2017,"WESTERN EUROPE-EU","FRANCE","SOUTHEND","TOULON / HYERES",92,92,0
2017,"WESTERN EUROPE-EU","FRANCE","STANSTED","BASTIA",406,0,406
2017,"WESTERN EUROPE-EU","FRANCE","STANSTED","BERGERAC",108541,108541,0
2017,"WESTERN EUROPE-EU","FRANCE","STANSTED","BEZIERS",14956,14956,0
2017,"WESTERN EUROPE-EU","FRANCE","STANSTED","BIARRITZ",106439,106439,0
2017,"WESTERN EUROPE-EU","FRANCE","STANSTED","BORDEAUX",84604,84604,0
2017,"WESTERN EUROPE-EU","FRANCE","STANSTED","BREST",131,131,0
2017,"WESTERN EUROPE-EU","FRANCE","STANSTED","BRIVE-LA-GAILLARDE",17992,17992,0
2017,"WESTERN EUROPE-EU","FRANCE","STANSTED","CALVI",3954,0,3954
2017,"WESTERN EUROPE-EU","FRANCE","STANSTED","CARCASSONNE",104475,104475,0
2017,"WESTERN EUROPE-EU","FRANCE","STANSTED","CHAMBERY",18762,4744,14018
2017,"WESTERN EUROPE-EU","FRANCE","STANSTED","CLERMONT FERRAND",10784,10784,0
2017,"WESTERN EUROPE-EU","FRANCE","STANSTED","DEAUVILLE",17848,17848,0
2017,"WESTERN EUROPE-EU","FRANCE","STANSTED","DINARD",83017,83017,0
2017,"WESTERN EUROPE-EU","FRANCE","STANSTED","GRENOBLE",36054,35578,476
2017,"WESTERN EUROPE-EU","FRANCE","STANSTED","LA ROCHELLE",60391,60391,0
2017,"WESTERN EUROPE-EU","FRANCE","STANSTED","LIMOGES",99706,99706,0
2017,"WESTERN EUROPE-EU","FRANCE","STANSTED","LORIENT",13876,13876,0
2017,"WESTERN EUROPE-EU","FRANCE","STANSTED","LYON",1984,449,1535
2017,"WESTERN EUROPE-EU","FRANCE","STANSTED","MARSEILLE",152091,152091,0
2017,"WESTERN EUROPE-EU","FRANCE","STANSTED","NANTES",337,337,0
2017,"WESTERN EUROPE-EU","FRANCE","STANSTED","NICE",132154,131632,522
2017,"WESTERN EUROPE-EU","FRANCE","STANSTED","NIMES",36617,36617,0
2017,"WESTERN EUROPE-EU","FRANCE","STANSTED","PARIS (CHARLES DE GAULLE)",287,287,0
2017,"WESTERN EUROPE-EU","FRANCE","STANSTED","PARIS (ORLY)",0,0,0
2017,"WESTERN EUROPE-EU","FRANCE","STANSTED","PAU",326,326,0
2017,"WESTERN EUROPE-EU","FRANCE","STANSTED","PERPIGNAN",50527,50527,0
2017,"WESTERN EUROPE-EU","FRANCE","STANSTED","POITIERS",58355,58355,0
2017,"WESTERN EUROPE-EU","FRANCE","STANSTED","QUIMPER",105,0,105
2017,"WESTERN EUROPE-EU","FRANCE","STANSTED","RENNES",640,640,0
2017,"WESTERN EUROPE-EU","FRANCE","STANSTED","ST ETIENNE",0,0,0
2017,"WESTERN EUROPE-EU","FRANCE","STANSTED","STRASBOURG",18031,18031,0
2017,"WESTERN EUROPE-EU","FRANCE","STANSTED","TARBES-LOURDES INTERNATIONAL",59096,52690,6406
2017,"WESTERN EUROPE-EU","FRANCE","STANSTED","TOULON / HYERES",221,0,221
2017,"WESTERN EUROPE-EU","FRANCE","STANSTED","TOULOUSE (BLAGNAC)",170152,170152,0
2017,"WESTERN EUROPE-EU","FRANCE","STANSTED","TOURS",53018,53018,0
2017,"WESTERN EUROPE-EU","GERMANY","GATWICK","BERLIN (SCHONEFELD)",488945,488497,448
2017,"WESTERN EUROPE-EU","GERMANY","GATWICK","BREMEN",0,0,0
2017,"WESTERN EUROPE-EU","GERMANY","GATWICK","COLOGNE BONN",0,0,0
2017,"WESTERN EUROPE-EU","GERMANY","GATWICK","DRESDEN",1430,1430,0
2017,"WESTERN EUROPE-EU","GERMANY","GATWICK","DUSSELDORF",8,0,8
2017,"WESTERN EUROPE-EU","GERMANY","GATWICK","ERFURT",1,0,1
2017,"WESTERN EUROPE-EU","GERMANY","GATWICK","FRANKFURT MAIN",89,50,39
2017,"WESTERN EUROPE-EU","GERMANY","GATWICK","FRIEDRICHSHAFEN",22405,15412,6993
2017,"WESTERN EUROPE-EU","GERMANY","GATWICK","HAMBURG",154660,154660,0
2017,"WESTERN EUROPE-EU","GERMANY","GATWICK","LEIPZIG",427,0,427
2017,"WESTERN EUROPE-EU","GERMANY","GATWICK","MUNICH",254956,254209,747
2017,"WESTERN EUROPE-EU","GERMANY","GATWICK","MUNSTER-OSNABRUCK",139,0,139
2017,"WESTERN EUROPE-EU","GERMANY","GATWICK","NUREMBERG",4691,4691,0
2017,"WESTERN EUROPE-EU","GERMANY","GATWICK","ROSTOCK-LAAGE",1,0,1
2017,"WESTERN EUROPE-EU","GERMANY","GATWICK","STUTTGART",128760,128580,180
2017,"WESTERN EUROPE-EU","GERMANY","HEATHROW","BERLIN (TEGEL)",779203,778561,642
2017,"WESTERN EUROPE-EU","GERMANY","HEATHROW","COLOGNE BONN",179102,179030,72
2017,"WESTERN EUROPE-EU","GERMANY","HEATHROW","DORTMUND",0,0,0
2017,"WESTERN EUROPE-EU","GERMANY","HEATHROW","DUSSELDORF",741486,741486,0
2017,"WESTERN EUROPE-EU","GERMANY","HEATHROW","FRANKFURT MAIN",1501134,1501134,0
2017,"WESTERN EUROPE-EU","GERMANY","HEATHROW","FRIEDRICHSHAFEN",814,0,814
2017,"WESTERN EUROPE-EU","GERMANY","HEATHROW","HAMBURG",584508,584508,0
2017,"WESTERN EUROPE-EU","GERMANY","HEATHROW","HANOVER",212274,212274,0
2017,"WESTERN EUROPE-EU","GERMANY","HEATHROW","MUNICH",1190441,1190441,0
2017,"WESTERN EUROPE-EU","GERMANY","HEATHROW","STUTTGART",317014,317014,0
2017,"WESTERN EUROPE-EU","GERMANY","LONDON CITY","BERLIN (TEGEL)",109586,109492,94
2017,"WESTERN EUROPE-EU","GERMANY","LONDON CITY","BREMEN",985,985,0
2017,"WESTERN EUROPE-EU","GERMANY","LONDON CITY","DUSSELDORF",155803,155803,0
2017,"WESTERN EUROPE-EU","GERMANY","LONDON CITY","FRANKFURT MAIN",247322,247250,72
2017,"WESTERN EUROPE-EU","GERMANY","LONDON CITY","HAMBURG",13291,13291,0
2017,"WESTERN EUROPE-EU","GERMANY","LONDON CITY","HANOVER",0,0,0
2017,"WESTERN EUROPE-EU","GERMANY","LONDON CITY","MUNSTER-OSNABRUCK",44,0,44
2017,"WESTERN EUROPE-EU","GERMANY","LONDON CITY","STUTTGART",0,0,0
2017,"WESTERN EUROPE-EU","GERMANY","LUTON","BERLIN (SCHONEFELD)",187393,187393,0
2017,"WESTERN EUROPE-EU","GERMANY","LUTON","BERLIN (TEGEL)",99,0,99
2017,"WESTERN EUROPE-EU","GERMANY","LUTON","COLOGNE BONN",226,83,143
2017,"WESTERN EUROPE-EU","GERMANY","LUTON","DORTMUND",95283,95283,0
2017,"WESTERN EUROPE-EU","GERMANY","LUTON","DRESDEN",709,709,0
2017,"WESTERN EUROPE-EU","GERMANY","LUTON","DUSSELDORF",0,0,0
2017,"WESTERN EUROPE-EU","GERMANY","LUTON","ERFURT",0,0,0
2017,"WESTERN EUROPE-EU","GERMANY","LUTON","FRANKFURT MAIN",15,0,15
2017,"WESTERN EUROPE-EU","GERMANY","LUTON","FRIEDRICHSHAFEN",0,0,0
2017,"WESTERN EUROPE-EU","GERMANY","LUTON","HAHN",0,0,0
2017,"WESTERN EUROPE-EU","GERMANY","LUTON","HAMBURG",84567,84567,0
2017,"WESTERN EUROPE-EU","GERMANY","LUTON","HANOVER",152,152,0
2017,"WESTERN EUROPE-EU","GERMANY","LUTON","KASSEL",0,0,0
2017,"WESTERN EUROPE-EU","GERMANY","LUTON","MEMMINGEN ALLGAU",2,0,2
2017,"WESTERN EUROPE-EU","GERMANY","LUTON","MUNICH",94553,94023,530
2017,"WESTERN EUROPE-EU","GERMANY","LUTON","NIEDERRHEIN",19956,19956,0
2017,"WESTERN EUROPE-EU","GERMANY","LUTON","NUREMBERG",0,0,0
2017,"WESTERN EUROPE-EU","GERMANY","LUTON","STUTTGART",208,0,208
2017,"WESTERN EUROPE-EU","GERMANY","SOUTHEND","BERLIN (SCHONEFELD)",0,0,0
2017,"WESTERN EUROPE-EU","GERMANY","SOUTHEND","BERLIN (TEGEL)",0,0,0
2017,"WESTERN EUROPE-EU","GERMANY","SOUTHEND","BREMEN",41,41,0
2017,"WESTERN EUROPE-EU","GERMANY","SOUTHEND","COLOGNE BONN",17540,17540,0
2017,"WESTERN EUROPE-EU","GERMANY","SOUTHEND","DUSSELDORF",168,168,0
2017,"WESTERN EUROPE-EU","GERMANY","SOUTHEND","FRANKFURT MAIN",31,31,0
2017,"WESTERN EUROPE-EU","GERMANY","SOUTHEND","HAMBURG",37,37,0
2017,"WESTERN EUROPE-EU","GERMANY","SOUTHEND","MUNSTER-OSNABRUCK",0,0,0
2017,"WESTERN EUROPE-EU","GERMANY","STANSTED","BERLIN (SCHONEFELD)",437820,437820,0
2017,"WESTERN EUROPE-EU","GERMANY","STANSTED","BERLIN (TEGEL)",7121,7020,101
2017,"WESTERN EUROPE-EU","GERMANY","STANSTED","BRAUNSCHWEIG",255,0,255
2017,"WESTERN EUROPE-EU","GERMANY","STANSTED","BREMEN",156937,156937,0
2017,"WESTERN EUROPE-EU","GERMANY","STANSTED","COLOGNE BONN",414955,414672,283
2017,"WESTERN EUROPE-EU","GERMANY","STANSTED","DORTMUND",119523,119523,0
2017,"WESTERN EUROPE-EU","GERMANY","STANSTED","DUSSELDORF",85,85,0
2017,"WESTERN EUROPE-EU","GERMANY","STANSTED","FRANKFURT MAIN",54861,54861,0
2017,"WESTERN EUROPE-EU","GERMANY","STANSTED","FRIEDRICHSHAFEN",146,146,0
2017,"WESTERN EUROPE-EU","GERMANY","STANSTED","HAHN",118544,118544,0
2017,"WESTERN EUROPE-EU","GERMANY","STANSTED","HAMBURG",216774,216774,0
2017,"WESTERN EUROPE-EU","GERMANY","STANSTED","HANOVER",55915,55915,0
2017,"WESTERN EUROPE-EU","GERMANY","STANSTED","KARLSRUHE/BADEN BADEN",122582,122582,0
2017,"WESTERN EUROPE-EU","GERMANY","STANSTED","LEIPZIG",49561,49561,0
2017,"WESTERN EUROPE-EU","GERMANY","STANSTED","MEMMINGEN ALLGAU",94015,94015,0
2017,"WESTERN EUROPE-EU","GERMANY","STANSTED","MUNICH",159315,158380,935
2017,"WESTERN EUROPE-EU","GERMANY","STANSTED","MUNSTER-OSNABRUCK",146,0,146
2017,"WESTERN EUROPE-EU","GERMANY","STANSTED","NIEDERRHEIN",31960,31960,0
2017,"WESTERN EUROPE-EU","GERMANY","STANSTED","NUREMBERG",192636,192636,0
2017,"WESTERN EUROPE-EU","GERMANY","STANSTED","STUTTGART",80110,80110,0
2017,"WESTERN EUROPE-EU","GIBRALTAR","GATWICK","GIBRALTAR",202881,202881,0
2017,"WESTERN EUROPE-EU","GIBRALTAR","HEATHROW","GIBRALTAR",135879,135879,0
2017,"WESTERN EUROPE-EU","GIBRALTAR","LUTON","GIBRALTAR",50846,50468,378
2017,"WESTERN EUROPE-EU","GREECE","GATWICK","ATHENS",199298,199298,0
2017,"WESTERN EUROPE-EU","GREECE","GATWICK","CHANIA",120250,97376,22874
2017,"WESTERN EUROPE-EU","GREECE","GATWICK","CORFU",242496,172070,70426
2017,"WESTERN EUROPE-EU","GREECE","GATWICK","HERAKLION",299361,232340,67021
2017,"WESTERN EUROPE-EU","GREECE","GATWICK","KALAMATA",35032,34991,41
2017,"WESTERN EUROPE-EU","GREECE","GATWICK","KAVALA",25360,12018,13342
2017,"WESTERN EUROPE-EU","GREECE","GATWICK","KEFALLINIA",128515,89900,38615
2017,"WESTERN EUROPE-EU","GREECE","GATWICK","KOS",123186,57033,66153
2017,"WESTERN EUROPE-EU","GREECE","GATWICK","LEMNOS",1086,0,1086
2017,"WESTERN EUROPE-EU","GREECE","GATWICK","MIKONOS",87644,87644,0
2017,"WESTERN EUROPE-EU","GREECE","GATWICK","MYTILINI",8914,8914,0
2017,"WESTERN EUROPE-EU","GREECE","GATWICK","PREVEZA",100530,62119,38411
2017,"WESTERN EUROPE-EU","GREECE","GATWICK","RHODES",191890,123637,68253
2017,"WESTERN EUROPE-EU","GREECE","GATWICK","SALONIKA",164269,144937,19332
2017,"WESTERN EUROPE-EU","GREECE","GATWICK","SAMOS",9801,0,9801
2017,"WESTERN EUROPE-EU","GREECE","GATWICK","SKIATHOS",46452,17490,28962
2017,"WESTERN EUROPE-EU","GREECE","GATWICK","THIRA (SANTORINI)",122805,107698,15107
2017,"WESTERN EUROPE-EU","GREECE","GATWICK","VOLOS NEA ANCHILOS",2813,0,2813
2017,"WESTERN EUROPE-EU","GREECE","GATWICK","ZAKINTHOS",164773,107665,57108
2017,"WESTERN EUROPE-EU","GREECE","HEATHROW","ATHENS",761330,758261,3069
2017,"WESTERN EUROPE-EU","GREECE","HEATHROW","CHANIA",12006,12006,0
2017,"WESTERN EUROPE-EU","GREECE","HEATHROW","CORFU",45610,40661,4949
2017,"WESTERN EUROPE-EU","GREECE","HEATHROW","HERAKLION",0,0,0
2017,"WESTERN EUROPE-EU","GREECE","HEATHROW","KALAMATA",23087,13005,10082
2017,"WESTERN EUROPE-EU","GREECE","HEATHROW","KOS",8237,5971,2266
2017,"WESTERN EUROPE-EU","GREECE","HEATHROW","LEMNOS",15286,200,15086
2017,"WESTERN EUROPE-EU","GREECE","HEATHROW","MIKONOS",20657,20657,0
2017,"WESTERN EUROPE-EU","GREECE","HEATHROW","PREVEZA",17108,0,17108
2017,"WESTERN EUROPE-EU","GREECE","HEATHROW","RHODES",11356,0,11356
2017,"WESTERN EUROPE-EU","GREECE","HEATHROW","THIRA (SANTORINI)",24528,24528,0
2017,"WESTERN EUROPE-EU","GREECE","HEATHROW","ZAKINTHOS",10172,10172,0
2017,"WESTERN EUROPE-EU","GREECE","LONDON CITY","MIKONOS",8465,8465,0
2017,"WESTERN EUROPE-EU","GREECE","LONDON CITY","SKIATHOS",4269,4269,0
2017,"WESTERN EUROPE-EU","GREECE","LONDON CITY","THIRA (SANTORINI)",3362,3362,0
2017,"WESTERN EUROPE-EU","GREECE","LUTON","ATHENS",207,185,22
2017,"WESTERN EUROPE-EU","GREECE","LUTON","CORFU",68749,56054,12695
2017,"WESTERN EUROPE-EU","GREECE","LUTON","HERAKLION",38384,29278,9106
2017,"WESTERN EUROPE-EU","GREECE","LUTON","KALAMATA",11,0,11
2017,"WESTERN EUROPE-EU","GREECE","LUTON","KAVALA",133,0,133
2017,"WESTERN EUROPE-EU","GREECE","LUTON","KEFALLINIA",7518,0,7518
2017,"WESTERN EUROPE-EU","GREECE","LUTON","MIKONOS",16620,16612,8
2017,"WESTERN EUROPE-EU","GREECE","LUTON","RHODES",30163,11633,18530
2017,"WESTERN EUROPE-EU","GREECE","LUTON","SKIATHOS",6665,0,6665
2017,"WESTERN EUROPE-EU","GREECE","LUTON","THIRA (SANTORINI)",0,0,0
2017,"WESTERN EUROPE-EU","GREECE","LUTON","ZAKINTHOS",8722,0,8722
2017,"WESTERN EUROPE-EU","GREECE","SOUTHEND","RHODES",180,180,0
2017,"WESTERN EUROPE-EU","GREECE","STANSTED","ATHENS",203528,203528,0
2017,"WESTERN EUROPE-EU","GREECE","STANSTED","CHANIA",24929,24929,0
2017,"WESTERN EUROPE-EU","GREECE","STANSTED","CORFU",68427,53516,14911
2017,"WESTERN EUROPE-EU","GREECE","STANSTED","HERAKLION",46911,31314,15597
2017,"WESTERN EUROPE-EU","GREECE","STANSTED","KAVALA",162,162,0
2017,"WESTERN EUROPE-EU","GREECE","STANSTED","KEFALLINIA",28406,20331,8075
2017,"WESTERN EUROPE-EU","GREECE","STANSTED","KOS",36112,26682,9430
2017,"WESTERN EUROPE-EU","GREECE","STANSTED","MIKONOS",76,0,76
2017,"WESTERN EUROPE-EU","GREECE","STANSTED","RHODES",80806,63535,17271
2017,"WESTERN EUROPE-EU","GREECE","STANSTED","SALONIKA",117695,117695,0
2017,"WESTERN EUROPE-EU","GREECE","STANSTED","SKIATHOS",8836,8836,0
2017,"WESTERN EUROPE-EU","GREECE","STANSTED","ZAKINTHOS",65207,57740,7467
2017,"WESTERN EUROPE-EU","IRISH REPUBLIC","GATWICK","CORK",124950,124950,0
2017,"WESTERN EUROPE-EU","IRISH REPUBLIC","GATWICK","DUBLIN",1367300,1366599,701
2017,"WESTERN EUROPE-EU","IRISH REPUBLIC","GATWICK","IRELAND WEST(KNOCK)",79837,79837,0
2017,"WESTERN EUROPE-EU","IRISH REPUBLIC","GATWICK","SHANNON",114852,114837,15
2017,"WESTERN EUROPE-EU","IRISH REPUBLIC","HEATHROW","CORK",401601,401601,0
2017,"WESTERN EUROPE-EU","IRISH REPUBLIC","HEATHROW","DUBLIN",1803497,1803497,0
2017,"WESTERN EUROPE-EU","IRISH REPUBLIC","HEATHROW","SHANNON",270079,270079,0
2017,"WESTERN EUROPE-EU","IRISH REPUBLIC","LONDON CITY","CORK",22,0,22
2017,"WESTERN EUROPE-EU","IRISH REPUBLIC","LONDON CITY","DUBLIN",470563,470563,0
2017,"WESTERN EUROPE-EU","IRISH REPUBLIC","LUTON","CORK",0,0,0
2017,"WESTERN EUROPE-EU","IRISH REPUBLIC","LUTON","DUBLIN",358631,358295,336
2017,"WESTERN EUROPE-EU","IRISH REPUBLIC","LUTON","IRELAND WEST(KNOCK)",134889,134889,0
2017,"WESTERN EUROPE-EU","IRISH REPUBLIC","LUTON","KERRY COUNTY",113539,113539,0
2017,"WESTERN EUROPE-EU","IRISH REPUBLIC","LUTON","SHANNON",0,0,0
2017,"WESTERN EUROPE-EU","IRISH REPUBLIC","LUTON","WATERFORD",0,0,0
2017,"WESTERN EUROPE-EU","IRISH REPUBLIC","SOUTHEND","CORK",0,0,0
2017,"WESTERN EUROPE-EU","IRISH REPUBLIC","SOUTHEND","DUBLIN",19249,19249,0
2017,"WESTERN EUROPE-EU","IRISH REPUBLIC","STANSTED","CORK",351914,351914,0
2017,"WESTERN EUROPE-EU","IRISH REPUBLIC","STANSTED","DUBLIN",890741,890502,239
2017,"WESTERN EUROPE-EU","IRISH REPUBLIC","STANSTED","IRELAND WEST(KNOCK)",160276,160276,0
2017,"WESTERN EUROPE-EU","IRISH REPUBLIC","STANSTED","KERRY COUNTY",78661,78661,0
2017,"WESTERN EUROPE-EU","IRISH REPUBLIC","STANSTED","SHANNON",198935,198935,0
2017,"WESTERN EUROPE-EU","ITALY","GATWICK","ALGHERO (FERTILIA)",8355,0,8355
2017,"WESTERN EUROPE-EU","ITALY","GATWICK","BARI (PALESE)",83618,83618,0
2017,"WESTERN EUROPE-EU","ITALY","GATWICK","BERGAMO",241,0,241
2017,"WESTERN EUROPE-EU","ITALY","GATWICK","BOLOGNA",98657,98657,0
2017,"WESTERN EUROPE-EU","ITALY","GATWICK","BRINDISI",17109,17109,0
2017,"WESTERN EUROPE-EU","ITALY","GATWICK","CAGLIARI (ELMAS)",33886,33886,0
2017,"WESTERN EUROPE-EU","ITALY","GATWICK","CATANIA (FONTANAROSSA)",205997,193757,12240
2017,"WESTERN EUROPE-EU","ITALY","GATWICK","FLORENCE",86676,86676,0
2017,"WESTERN EUROPE-EU","ITALY","GATWICK","GENOA",73772,73772,0
2017,"WESTERN EUROPE-EU","ITALY","GATWICK","MILAN (LINATE)",305599,305599,0
2017,"WESTERN EUROPE-EU","ITALY","GATWICK","MILAN (MALPENSA)",568120,568120,0
2017,"WESTERN EUROPE-EU","ITALY","GATWICK","NAPLES",432334,403042,29292
2017,"WESTERN EUROPE-EU","ITALY","GATWICK","OLBIA",104704,103964,740
2017,"WESTERN EUROPE-EU","ITALY","GATWICK","PALERMO",65865,65865,0
2017,"WESTERN EUROPE-EU","ITALY","GATWICK","PISA",253863,253863,0
2017,"WESTERN EUROPE-EU","ITALY","GATWICK","ROME (FIUMICINO)",705708,705155,553
2017,"WESTERN EUROPE-EU","ITALY","GATWICK","TREVISO",160,160,0
2017,"WESTERN EUROPE-EU","ITALY","GATWICK","TURIN",170415,150710,19705
2017,"WESTERN EUROPE-EU","ITALY","GATWICK","VENICE",751512,744190,7322
2017,"WESTERN EUROPE-EU","ITALY","GATWICK","VERONA VILLAFRANCA",273664,254841,18823
2017,"WESTERN EUROPE-EU","ITALY","HEATHROW","BOLOGNA",273415,273415,0
2017,"WESTERN EUROPE-EU","ITALY","HEATHROW","BRINDISI",10786,10786,0
2017,"WESTERN EUROPE-EU","ITALY","HEATHROW","CAGLIARI (ELMAS)",8325,165,8160
2017,"WESTERN EUROPE-EU","ITALY","HEATHROW","FLORENCE",0,0,0
2017,"WESTERN EUROPE-EU","ITALY","HEATHROW","MILAN (LINATE)",657343,657343,0
2017,"WESTERN EUROPE-EU","ITALY","HEATHROW","MILAN (MALPENSA)",245175,245175,0
2017,"WESTERN EUROPE-EU","ITALY","HEATHROW","OLBIA",30325,18523,11802
2017,"WESTERN EUROPE-EU","ITALY","HEATHROW","PALERMO",28992,28992,0
2017,"WESTERN EUROPE-EU","ITALY","HEATHROW","PISA",118593,118593,0
2017,"WESTERN EUROPE-EU","ITALY","HEATHROW","ROME (FIUMICINO)",976106,972783,3323
2017,"WESTERN EUROPE-EU","ITALY","HEATHROW","TRIESTE (RONCHI DEI LEGIONARI)",507,0,507
2017,"WESTERN EUROPE-EU","ITALY","HEATHROW","TURIN",2025,2025,0
2017,"WESTERN EUROPE-EU","ITALY","HEATHROW","VENICE",196126,193621,2505
2017,"WESTERN EUROPE-EU","ITALY","LONDON CITY","BOLOGNA",272,272,0
2017,"WESTERN EUROPE-EU","ITALY","LONDON CITY","FLORENCE",96945,96945,0
2017,"WESTERN EUROPE-EU","ITALY","LONDON CITY","MILAN (LINATE)",248071,248071,0
2017,"WESTERN EUROPE-EU","ITALY","LONDON CITY","MILAN (MALPENSA)",147,0,147
2017,"WESTERN EUROPE-EU","ITALY","LONDON CITY","PISA",727,727,0
2017,"WESTERN EUROPE-EU","ITALY","LONDON CITY","ROME (FIUMICINO)",46534,46534,0
2017,"WESTERN EUROPE-EU","ITALY","LONDON CITY","VENICE",20465,20465,0
2017,"WESTERN EUROPE-EU","ITALY","LUTON","ALGHERO (FERTILIA)",2575,2575,0
2017,"WESTERN EUROPE-EU","ITALY","LUTON","BARI (PALESE)",13,0,13
2017,"WESTERN EUROPE-EU","ITALY","LUTON","BERGAMO",167,0,167
2017,"WESTERN EUROPE-EU","ITALY","LUTON","BOLOGNA",6,0,6
2017,"WESTERN EUROPE-EU","ITALY","LUTON","BRESCIA/MONTICHIARI",0,0,0
2017,"WESTERN EUROPE-EU","ITALY","LUTON","BRINDISI",0,0,0
2017,"WESTERN EUROPE-EU","ITALY","LUTON","CAGLIARI (ELMAS)",7694,7694,0
2017,"WESTERN EUROPE-EU","ITALY","LUTON","CATANIA (FONTANAROSSA)",51441,51251,190
2017,"WESTERN EUROPE-EU","ITALY","LUTON","FLORENCE",18968,18958,10
2017,"WESTERN EUROPE-EU","ITALY","LUTON","LAMETIA-TERME",181,181,0
2017,"WESTERN EUROPE-EU","ITALY","LUTON","MILAN (LINATE)",0,0,0
2017,"WESTERN EUROPE-EU","ITALY","LUTON","MILAN (MALPENSA)",166292,165772,520
2017,"WESTERN EUROPE-EU","ITALY","LUTON","NAPLES",124863,115160,9703
2017,"WESTERN EUROPE-EU","ITALY","LUTON","OLBIA",20713,20699,14
2017,"WESTERN EUROPE-EU","ITALY","LUTON","PALERMO",237,182,55
2017,"WESTERN EUROPE-EU","ITALY","LUTON","PISA",83328,83328,0
2017,"WESTERN EUROPE-EU","ITALY","LUTON","RIMINI",0,0,0
2017,"WESTERN EUROPE-EU","ITALY","LUTON","ROME (CIAMPINO)",186,186,0
2017,"WESTERN EUROPE-EU","ITALY","LUTON","ROME (FIUMICINO)",129159,128942,217
2017,"WESTERN EUROPE-EU","ITALY","LUTON","SALERNO COSTA AMALFI",12,0,12
2017,"WESTERN EUROPE-EU","ITALY","LUTON","TREVISO",184,184,0
2017,"WESTERN EUROPE-EU","ITALY","LUTON","TURIN",49654,48880,774
2017,"WESTERN EUROPE-EU","ITALY","LUTON","VENICE",93303,93303,0
2017,"WESTERN EUROPE-EU","ITALY","LUTON","VERONA VILLAFRANCA",315,0,315
2017,"WESTERN EUROPE-EU","ITALY","SOUTHEND","FLORENCE",374,374,0
2017,"WESTERN EUROPE-EU","ITALY","SOUTHEND","MILAN (MALPENSA)",16422,16422,0
2017,"WESTERN EUROPE-EU","ITALY","SOUTHEND","PISA",254,254,0
2017,"WESTERN EUROPE-EU","ITALY","SOUTHEND","VENICE",5346,5346,0
2017,"WESTERN EUROPE-EU","ITALY","STANSTED","ALGHERO (FERTILIA)",36832,36832,0
2017,"WESTERN EUROPE-EU","ITALY","STANSTED","ANCONA",109200,109200,0
2017,"WESTERN EUROPE-EU","ITALY","STANSTED","BARI (PALESE)",128535,128535,0
2017,"WESTERN EUROPE-EU","ITALY","STANSTED","BERGAMO",472393,472393,0
2017,"WESTERN EUROPE-EU","ITALY","STANSTED","BOLOGNA",223568,223568,0
2017,"WESTERN EUROPE-EU","ITALY","STANSTED","BRINDISI",79581,79581,0
2017,"WESTERN EUROPE-EU","ITALY","STANSTED","CAGLIARI (ELMAS)",123799,123799,0
2017,"WESTERN EUROPE-EU","ITALY","STANSTED","CATANIA (FONTANAROSSA)",245,245,0
2017,"WESTERN EUROPE-EU","ITALY","STANSTED","COMISO",20800,20800,0
2017,"WESTERN EUROPE-EU","ITALY","STANSTED","FLORENCE",7664,7664,0
2017,"WESTERN EUROPE-EU","ITALY","STANSTED","GENOA",83690,83690,0
2017,"WESTERN EUROPE-EU","ITALY","STANSTED","LAMETIA-TERME",60431,60431,0
2017,"WESTERN EUROPE-EU","ITALY","STANSTED","MILAN (LINATE)",8638,8638,0
2017,"WESTERN EUROPE-EU","ITALY","STANSTED","MILAN (MALPENSA)",222586,222586,0
2017,"WESTERN EUROPE-EU","ITALY","STANSTED","NAPLES",224989,224546,443
2017,"WESTERN EUROPE-EU","ITALY","STANSTED","PALERMO",111690,111690,0
2017,"WESTERN EUROPE-EU","ITALY","STANSTED","PARMA",0,0,0
2017,"WESTERN EUROPE-EU","ITALY","STANSTED","PERUGIA",92992,92992,0
2017,"WESTERN EUROPE-EU","ITALY","STANSTED","PESCARA",89859,89859,0
2017,"WESTERN EUROPE-EU","ITALY","STANSTED","PISA",328318,328318,0
2017,"WESTERN EUROPE-EU","ITALY","STANSTED","ROME (CIAMPINO)",616558,616558,0
2017,"WESTERN EUROPE-EU","ITALY","STANSTED","ROME (FIUMICINO)",1341,38,1303
2017,"WESTERN EUROPE-EU","ITALY","STANSTED","TREVISO",323953,323953,0
2017,"WESTERN EUROPE-EU","ITALY","STANSTED","TRIESTE (RONCHI DEI LEGIONARI)",64651,64651,0
2017,"WESTERN EUROPE-EU","ITALY","STANSTED","TURIN",128491,122784,5707
2017,"WESTERN EUROPE-EU","ITALY","STANSTED","VENICE",13789,13573,216
2017,"WESTERN EUROPE-EU","ITALY","STANSTED","VERONA VILLAFRANCA",73675,73556,119
2017,"WESTERN EUROPE-EU","LUXEMBOURG","GATWICK","LUXEMBOURG",65067,65066,1
2017,"WESTERN EUROPE-EU","LUXEMBOURG","HEATHROW","LUXEMBOURG",154673,154673,0
2017,"WESTERN EUROPE-EU","LUXEMBOURG","LONDON CITY","LUXEMBOURG",174026,174026,0
2017,"WESTERN EUROPE-EU","LUXEMBOURG","LUTON","LUXEMBOURG",165,122,43
2017,"WESTERN EUROPE-EU","LUXEMBOURG","SOUTHEND","LUXEMBOURG",396,396,0
2017,"WESTERN EUROPE-EU","LUXEMBOURG","STANSTED","LUXEMBOURG",108681,108563,118
2017,"WESTERN EUROPE-EU","MALTA","GATWICK","MALTA",381154,352448,28706
2017,"WESTERN EUROPE-EU","MALTA","HEATHROW","MALTA",194604,194604,0
2017,"WESTERN EUROPE-EU","MALTA","LUTON","MALTA",122169,122165,4
2017,"WESTERN EUROPE-EU","MALTA","SOUTHEND","MALTA",5632,5632,0
2017,"WESTERN EUROPE-EU","MALTA","STANSTED","MALTA",87106,87106,0
2017,"WESTERN EUROPE-EU","NETHERLANDS","GATWICK","AMSTERDAM",1074208,1074132,76
2017,"WESTERN EUROPE-EU","NETHERLANDS","GATWICK","GRONINGEN",0,0,0
2017,"WESTERN EUROPE-EU","NETHERLANDS","GATWICK","ROTTERDAM",87,87,0
2017,"WESTERN EUROPE-EU","NETHERLANDS","HEATHROW","AMSTERDAM",1689924,1689924,0
2017,"WESTERN EUROPE-EU","NETHERLANDS","LONDON CITY","AMSTERDAM",598424,598424,0
2017,"WESTERN EUROPE-EU","NETHERLANDS","LONDON CITY","ROTTERDAM",178253,178253,0
2017,"WESTERN EUROPE-EU","NETHERLANDS","LUTON","AMSTERDAM",785646,785539,107
2017,"WESTERN EUROPE-EU","NETHERLANDS","LUTON","MAASTRICHT",135,0,135
2017,"WESTERN EUROPE-EU","NETHERLANDS","LUTON","ROTTERDAM",26,0,26
2017,"WESTERN EUROPE-EU","NETHERLANDS","SOUTHEND","AMSTERDAM",190836,190836,0
2017,"WESTERN EUROPE-EU","NETHERLANDS","SOUTHEND","GRONINGEN",27215,27215,0
2017,"WESTERN EUROPE-EU","NETHERLANDS","SOUTHEND","ROTTERDAM",235,235,0
2017,"WESTERN EUROPE-EU","NETHERLANDS","STANSTED","AMSTERDAM",338839,338244,595
2017,"WESTERN EUROPE-EU","NETHERLANDS","STANSTED","EINDHOVEN",264387,264387,0
2017,"WESTERN EUROPE-EU","NETHERLANDS","STANSTED","MAASTRICHT",98,0,98
2017,"WESTERN EUROPE-EU","NETHERLANDS","STANSTED","ROTTERDAM",317,57,260
2017,"WESTERN EUROPE-EU","PORTUGAL(EXCLUDING MADEIRA)","GATWICK","AZORES LAJES TERCEIRA ISLAND",205,205,0
2017,"WESTERN EUROPE-EU","PORTUGAL(EXCLUDING MADEIRA)","GATWICK","AZORES PONTA DELGADA",5383,5382,1
2017,"WESTERN EUROPE-EU","PORTUGAL(EXCLUDING MADEIRA)","GATWICK","FARO",809771,773292,36479
2017,"WESTERN EUROPE-EU","PORTUGAL(EXCLUDING MADEIRA)","GATWICK","LISBON",417182,416293,889
2017,"WESTERN EUROPE-EU","PORTUGAL(EXCLUDING MADEIRA)","GATWICK","OPORTO (PORTUGAL)",339649,339322,327
2017,"WESTERN EUROPE-EU","PORTUGAL(EXCLUDING MADEIRA)","HEATHROW","FARO",20414,20414,0
2017,"WESTERN EUROPE-EU","PORTUGAL(EXCLUDING MADEIRA)","HEATHROW","LISBON",865043,865043,0
2017,"WESTERN EUROPE-EU","PORTUGAL(EXCLUDING MADEIRA)","LONDON CITY","FARO",11017,10967,50
2017,"WESTERN EUROPE-EU","PORTUGAL(EXCLUDING MADEIRA)","LONDON CITY","LISBON",12731,12731,0
2017,"WESTERN EUROPE-EU","PORTUGAL(EXCLUDING MADEIRA)","LUTON","AZORES PONTA DELGADA",0,0,0
2017,"WESTERN EUROPE-EU","PORTUGAL(EXCLUDING MADEIRA)","LUTON","FARO",323394,303201,20193
2017,"WESTERN EUROPE-EU","PORTUGAL(EXCLUDING MADEIRA)","LUTON","LISBON",253450,253450,0
2017,"WESTERN EUROPE-EU","PORTUGAL(EXCLUDING MADEIRA)","LUTON","OPORTO (PORTUGAL)",80744,80233,511
2017,"WESTERN EUROPE-EU","PORTUGAL(EXCLUDING MADEIRA)","SOUTHEND","FARO",107905,107905,0
2017,"WESTERN EUROPE-EU","PORTUGAL(EXCLUDING MADEIRA)","STANSTED","AZORES PONTA DELGADA",13397,13397,0
2017,"WESTERN EUROPE-EU","PORTUGAL(EXCLUDING MADEIRA)","STANSTED","FARO",326420,306350,20070
2017,"WESTERN EUROPE-EU","PORTUGAL(EXCLUDING MADEIRA)","STANSTED","LISBON",353212,353212,0
2017,"WESTERN EUROPE-EU","PORTUGAL(EXCLUDING MADEIRA)","STANSTED","OPORTO (PORTUGAL)",304720,304720,0
2017,"WESTERN EUROPE-EU","PORTUGAL(MADEIRA)","GATWICK","FUNCHAL",301453,263867,37586
2017,"WESTERN EUROPE-EU","PORTUGAL(MADEIRA)","GATWICK","PORTO SANTO",9366,346,9020
2017,"WESTERN EUROPE-EU","PORTUGAL(MADEIRA)","LUTON","FUNCHAL",8983,0,8983
2017,"WESTERN EUROPE-EU","PORTUGAL(MADEIRA)","STANSTED","FUNCHAL",24949,24949,0
2017,"WESTERN EUROPE-EU","PORTUGAL(MADEIRA)","STANSTED","PORTO SANTO",0,0,0
2017,"WESTERN EUROPE-EU","SLOVENIA","GATWICK","LJUBLJANA",62589,62521,68
2017,"WESTERN EUROPE-EU","SLOVENIA","LUTON","LJUBLJANA",64321,64056,265
2017,"WESTERN EUROPE-EU","SLOVENIA","STANSTED","LJUBLJANA",112911,112911,0
2017,"WESTERN EUROPE-EU","SPAIN","GATWICK","A CORUNA",0,0,0
2017,"WESTERN EUROPE-EU","SPAIN","GATWICK","ALICANTE",884249,839813,44436
2017,"WESTERN EUROPE-EU","SPAIN","GATWICK","ALMERIA",158486,149162,9324
2017,"WESTERN EUROPE-EU","SPAIN","GATWICK","ASTURIAS",38769,38769,0
2017,"WESTERN EUROPE-EU","SPAIN","GATWICK","BARCELONA",1458522,1458005,517
2017,"WESTERN EUROPE-EU","SPAIN","GATWICK","BILBAO",107913,107196,717
2017,"WESTERN EUROPE-EU","SPAIN","GATWICK","GIRONA",15870,204,15666
2017,"WESTERN EUROPE-EU","SPAIN","GATWICK","GRANADA",43297,43297,0
2017,"WESTERN EUROPE-EU","SPAIN","GATWICK","IBIZA",331515,259516,71999
2017,"WESTERN EUROPE-EU","SPAIN","GATWICK","JEREZ",9161,0,9161
2017,"WESTERN EUROPE-EU","SPAIN","GATWICK","LEON",0,0,0
2017,"WESTERN EUROPE-EU","SPAIN","GATWICK","LIEIDA",9271,607,8664
2017,"WESTERN EUROPE-EU","SPAIN","GATWICK","MADRID",1021320,1020121,1199
2017,"WESTERN EUROPE-EU","SPAIN","GATWICK","MAHON",278700,196874,81826
2017,"WESTERN EUROPE-EU","SPAIN","GATWICK","MALAGA",1155520,1084436,71084
2017,"WESTERN EUROPE-EU","SPAIN","GATWICK","MURCIA SAN JAVIER",170365,170365,0
2017,"WESTERN EUROPE-EU","SPAIN","GATWICK","PALMA DE MALLORCA",856367,711847,144520
2017,"WESTERN EUROPE-EU","SPAIN","GATWICK","REUS",42743,14237,28506
2017,"WESTERN EUROPE-EU","SPAIN","GATWICK","SANTIAGO DE COMPOSTELA (SPAIN)",67395,67395,0
2017,"WESTERN EUROPE-EU","SPAIN","GATWICK","SEVILLE",190855,190499,356
2017,"WESTERN EUROPE-EU","SPAIN","GATWICK","VALENCIA",345733,345733,0
2017,"WESTERN EUROPE-EU","SPAIN","GATWICK","VALLADOLID",286,0,286
2017,"WESTERN EUROPE-EU","SPAIN","GATWICK","VITORIA",507,139,368
2017,"WESTERN EUROPE-EU","SPAIN","HEATHROW","A CORUNA",101171,101171,0
2017,"WESTERN EUROPE-EU","SPAIN","HEATHROW","ASTURIAS",35827,35827,0
2017,"WESTERN EUROPE-EU","SPAIN","HEATHROW","BARCELONA",683777,682969,808
2017,"WESTERN EUROPE-EU","SPAIN","HEATHROW","BILBAO",171670,171670,0
2017,"WESTERN EUROPE-EU","SPAIN","HEATHROW","IBIZA",30688,30688,0
2017,"WESTERN EUROPE-EU","SPAIN","HEATHROW","MADRID",1382478,1382478,0
2017,"WESTERN EUROPE-EU","SPAIN","HEATHROW","MAHON",22342,22342,0
2017,"WESTERN EUROPE-EU","SPAIN","HEATHROW","MALAGA",32875,32875,0
2017,"WESTERN EUROPE-EU","SPAIN","HEATHROW","MURCIA SAN JAVIER",16810,16810,0
2017,"WESTERN EUROPE-EU","SPAIN","HEATHROW","PALMA DE MALLORCA",82504,82504,0
2017,"WESTERN EUROPE-EU","SPAIN","HEATHROW","SANTIAGO DE COMPOSTELA (SPAIN)",0,0,0
2017,"WESTERN EUROPE-EU","SPAIN","LONDON CITY","ALICANTE",0,0,0
2017,"WESTERN EUROPE-EU","SPAIN","LONDON CITY","GRANADA",16696,16696,0
2017,"WESTERN EUROPE-EU","SPAIN","LONDON CITY","IBIZA",91146,91146,0
2017,"WESTERN EUROPE-EU","SPAIN","LONDON CITY","MADRID",4675,4675,0
2017,"WESTERN EUROPE-EU","SPAIN","LONDON CITY","MAHON",2602,2602,0
2017,"WESTERN EUROPE-EU","SPAIN","LONDON CITY","MALAGA",67857,67857,0
2017,"WESTERN EUROPE-EU","SPAIN","LONDON CITY","PALMA DE MALLORCA",46528,46528,0
2017,"WESTERN EUROPE-EU","SPAIN","LUTON","ALICANTE",264625,263825,800
2017,"WESTERN EUROPE-EU","SPAIN","LUTON","ALMERIA",62,0,62
2017,"WESTERN EUROPE-EU","SPAIN","LUTON","ASTURIAS",0,0,0
2017,"WESTERN EUROPE-EU","SPAIN","LUTON","BARCELONA",506522,506518,4
2017,"WESTERN EUROPE-EU","SPAIN","LUTON","BILBAO",51,51,0
2017,"WESTERN EUROPE-EU","SPAIN","LUTON","CASTELLON COSTA AZAHAR",0,0,0
2017,"WESTERN EUROPE-EU","SPAIN","LUTON","GIRONA",34086,33932,154
2017,"WESTERN EUROPE-EU","SPAIN","LUTON","GRANADA",0,0,0
2017,"WESTERN EUROPE-EU","SPAIN","LUTON","IBIZA",81045,56133,24912
2017,"WESTERN EUROPE-EU","SPAIN","LUTON","MADRID",144644,144345,299
2017,"WESTERN EUROPE-EU","SPAIN","LUTON","MAHON",92241,73146,19095
2017,"WESTERN EUROPE-EU","SPAIN","LUTON","MALAGA",332077,308610,23467
2017,"WESTERN EUROPE-EU","SPAIN","LUTON","MURCIA SAN JAVIER",96715,96715,0
2017,"WESTERN EUROPE-EU","SPAIN","LUTON","PALMA DE MALLORCA",291890,234196,57694
2017,"WESTERN EUROPE-EU","SPAIN","LUTON","REUS",9576,0,9576
2017,"WESTERN EUROPE-EU","SPAIN","LUTON","SAN SEBASTIAN",1063,1063,0
2017,"WESTERN EUROPE-EU","SPAIN","LUTON","SEVILLE",7217,7106,111
2017,"WESTERN EUROPE-EU","SPAIN","LUTON","VALENCIA",39549,39549,0
2017,"WESTERN EUROPE-EU","SPAIN","LUTON","VIGO",3210,3210,0
2017,"WESTERN EUROPE-EU","SPAIN","SOUTHEND","ALICANTE",116142,116142,0
2017,"WESTERN EUROPE-EU","SPAIN","SOUTHEND","BARCELONA",42448,42448,0
2017,"WESTERN EUROPE-EU","SPAIN","SOUTHEND","IBIZA",20415,20415,0
2017,"WESTERN EUROPE-EU","SPAIN","SOUTHEND","MADRID",0,0,0
2017,"WESTERN EUROPE-EU","SPAIN","SOUTHEND","MAHON",13578,13578,0
2017,"WESTERN EUROPE-EU","SPAIN","SOUTHEND","MALAGA",86149,86149,0
2017,"WESTERN EUROPE-EU","SPAIN","SOUTHEND","MURCIA SAN JAVIER",15031,15031,0
2017,"WESTERN EUROPE-EU","SPAIN","SOUTHEND","PALMA DE MALLORCA",89692,89692,0
2017,"WESTERN EUROPE-EU","SPAIN","SOUTHEND","REUS",8477,8477,0
2017,"WESTERN EUROPE-EU","SPAIN","STANSTED","ALICANTE",320486,320486,0
2017,"WESTERN EUROPE-EU","SPAIN","STANSTED","ALMERIA",25867,25867,0
2017,"WESTERN EUROPE-EU","SPAIN","STANSTED","ASTURIAS",76035,76035,0
2017,"WESTERN EUROPE-EU","SPAIN","STANSTED","BARCELONA",464280,464111,169
2017,"WESTERN EUROPE-EU","SPAIN","STANSTED","BILBAO",127186,127060,126
2017,"WESTERN EUROPE-EU","SPAIN","STANSTED","CASTELLON COSTA AZAHAR",34037,34037,0
2017,"WESTERN EUROPE-EU","SPAIN","STANSTED","CASTELLON DE LA PLANA AIRPORT",14723,14723,0
2017,"WESTERN EUROPE-EU","SPAIN","STANSTED","GIRONA",71010,70843,167
2017,"WESTERN EUROPE-EU","SPAIN","STANSTED","GRANADA",97,97,0
2017,"WESTERN EUROPE-EU","SPAIN","STANSTED","IBIZA",301243,275401,25842
2017,"WESTERN EUROPE-EU","SPAIN","STANSTED","JEREZ",59019,59019,0
2017,"WESTERN EUROPE-EU","SPAIN","STANSTED","LEON",0,0,0
2017,"WESTERN EUROPE-EU","SPAIN","STANSTED","LIEIDA",367,0,367
2017,"WESTERN EUROPE-EU","SPAIN","STANSTED","MADRID",475209,474277,932
2017,"WESTERN EUROPE-EU","SPAIN","STANSTED","MAHON",68811,51785,17026
2017,"WESTERN EUROPE-EU","SPAIN","STANSTED","MALAGA",466283,466283,0
2017,"WESTERN EUROPE-EU","SPAIN","STANSTED","MURCIA SAN JAVIER",131327,131327,0
2017,"WESTERN EUROPE-EU","SPAIN","STANSTED","PALMA DE MALLORCA",448781,419939,28842
2017,"WESTERN EUROPE-EU","SPAIN","STANSTED","REUS",83509,82669,840
2017,"WESTERN EUROPE-EU","SPAIN","STANSTED","SALAMANCA",0,0,0
2017,"WESTERN EUROPE-EU","SPAIN","STANSTED","SANTANDER",80607,80607,0
2017,"WESTERN EUROPE-EU","SPAIN","STANSTED","SANTIAGO DE COMPOSTELA (SPAIN)",77121,77121,0
2017,"WESTERN EUROPE-EU","SPAIN","STANSTED","SEVILLE",144825,144672,153
2017,"WESTERN EUROPE-EU","SPAIN","STANSTED","VALENCIA",130358,130186,172
2017,"WESTERN EUROPE-EU","SPAIN","STANSTED","VALLADOLID",0,0,0
2017,"WESTERN EUROPE-EU","SPAIN","STANSTED","ZARAGOZA",87056,87056,0
2017,"WESTERN EUROPE-EU","SPAIN(CANARY ISLANDS)","GATWICK","ARRECIFE",476254,393718,82536
2017,"WESTERN EUROPE-EU","SPAIN(CANARY ISLANDS)","GATWICK","FUERTEVENTURA",254548,199215,55333
2017,"WESTERN EUROPE-EU","SPAIN(CANARY ISLANDS)","GATWICK","LAS PALMAS",339899,245250,94649
2017,"WESTERN EUROPE-EU","SPAIN(CANARY ISLANDS)","GATWICK","SANTA CRUZ DE LA PALMA",45521,21351,24170
2017,"WESTERN EUROPE-EU","SPAIN(CANARY ISLANDS)","GATWICK","TENERIFE (NORTE LOS RODEOS)",0,0,0
2017,"WESTERN EUROPE-EU","SPAIN(CANARY ISLANDS)","GATWICK","TENERIFE (SURREINA SOFIA)",817588,646705,170883
2017,"WESTERN EUROPE-EU","SPAIN(CANARY ISLANDS)","HEATHROW","LAS PALMAS",46764,46764,0
2017,"WESTERN EUROPE-EU","SPAIN(CANARY ISLANDS)","HEATHROW","TENERIFE (NORTE LOS RODEOS)",211,211,0
2017,"WESTERN EUROPE-EU","SPAIN(CANARY ISLANDS)","HEATHROW","TENERIFE (SURREINA SOFIA)",2916,2916,0
2017,"WESTERN EUROPE-EU","SPAIN(CANARY ISLANDS)","LUTON","ARRECIFE",126018,95209,30809
2017,"WESTERN EUROPE-EU","SPAIN(CANARY ISLANDS)","LUTON","FUERTEVENTURA",54433,35250,19183
2017,"WESTERN EUROPE-EU","SPAIN(CANARY ISLANDS)","LUTON","LAS PALMAS",50353,32540,17813
2017,"WESTERN EUROPE-EU","SPAIN(CANARY ISLANDS)","LUTON","TENERIFE (SURREINA SOFIA)",188093,149457,38636
2017,"WESTERN EUROPE-EU","SPAIN(CANARY ISLANDS)","SOUTHEND","ARRECIFE",16510,16510,0
2017,"WESTERN EUROPE-EU","SPAIN(CANARY ISLANDS)","SOUTHEND","LAS PALMAS",6481,6481,0
2017,"WESTERN EUROPE-EU","SPAIN(CANARY ISLANDS)","SOUTHEND","TENERIFE (SURREINA SOFIA)",16700,16700,0
2017,"WESTERN EUROPE-EU","SPAIN(CANARY ISLANDS)","STANSTED","ARRECIFE",200295,190118,10177
2017,"WESTERN EUROPE-EU","SPAIN(CANARY ISLANDS)","STANSTED","FUERTEVENTURA",148815,131566,17249
2017,"WESTERN EUROPE-EU","SPAIN(CANARY ISLANDS)","STANSTED","LAS PALMAS",159189,140727,18462
2017,"WESTERN EUROPE-EU","SPAIN(CANARY ISLANDS)","STANSTED","SANTA CRUZ DE LA PALMA",0,0,0
2017,"WESTERN EUROPE-EU","SPAIN(CANARY ISLANDS)","STANSTED","TENERIFE (SURREINA SOFIA)",312121,282693,29428
2017,"WESTERN EUROPE-EU","SWEDEN","GATWICK","GOTEBORG (LANDVETTER)",194976,194976,0
2017,"WESTERN EUROPE-EU","SWEDEN","GATWICK","JONKOPING",220,0,220
2017,"WESTERN EUROPE-EU","SWEDEN","GATWICK","KIRUNA",1230,0,1230
2017,"WESTERN EUROPE-EU","SWEDEN","GATWICK","OSTERSUND / FROSON",5390,5390,0
2017,"WESTERN EUROPE-EU","SWEDEN","GATWICK","PAJALA YLLAS",378,0,378
2017,"WESTERN EUROPE-EU","SWEDEN","GATWICK","STOCKHOLM (ARLANDA)",497417,497403,14
2017,"WESTERN EUROPE-EU","SWEDEN","GATWICK","STOCKHOLM (BROMMA)",9,0,9
2017,"WESTERN EUROPE-EU","SWEDEN","GATWICK","VISBY",171,0,171
2017,"WESTERN EUROPE-EU","SWEDEN","HEATHROW","GOTEBORG (LANDVETTER)",247135,247135,0
2017,"WESTERN EUROPE-EU","SWEDEN","HEATHROW","KIRUNA",2538,0,2538
2017,"WESTERN EUROPE-EU","SWEDEN","HEATHROW","STOCKHOLM (ARLANDA)",1013192,1013192,0
2017,"WESTERN EUROPE-EU","SWEDEN","LUTON","GOTEBORG (LANDVETTER)",4,0,4
2017,"WESTERN EUROPE-EU","SWEDEN","LUTON","NORRKOPING",25,0,25
2017,"WESTERN EUROPE-EU","SWEDEN","LUTON","STOCKHOLM (ARLANDA)",58946,58853,93
2017,"WESTERN EUROPE-EU","SWEDEN","STANSTED","GOTEBORG (LANDVETTER)",157867,157573,294
2017,"WESTERN EUROPE-EU","SWEDEN","STANSTED","MALMO",92,0,92
2017,"WESTERN EUROPE-EU","SWEDEN","STANSTED","STOCKHOLM (ARLANDA)",649,0,649
2017,"WESTERN EUROPE-EU","SWEDEN","STANSTED","STOCKHOLM (SKAVSTA)",215172,214918,254
2017,"WESTERN EUROPE-EU","SWEDEN","STANSTED","VASTERAS",71237,71237,0
2017,"WESTERN EUROPE-OTHER","BOSNIA-HERZEGOVINA","LUTON","TUZLA",20159,20159,0
2017,"WESTERN EUROPE-OTHER","FAROE ISLANDS","GATWICK","VAGAR",0,0,0
2017,"WESTERN EUROPE-OTHER","FAROE ISLANDS","SOUTHEND","VAGAR",0,0,0
2017,"WESTERN EUROPE-OTHER","ICELAND","GATWICK","EGILSSTADIR",202,0,202
2017,"WESTERN EUROPE-OTHER","ICELAND","GATWICK","KEFLAVIK",500157,484654,15503
2017,"WESTERN EUROPE-OTHER","ICELAND","HEATHROW","KEFLAVIK",351751,351751,0
2017,"WESTERN EUROPE-OTHER","ICELAND","LONDON CITY","KEFLAVIK",2127,2127,0
2017,"WESTERN EUROPE-OTHER","ICELAND","LUTON","KEFLAVIK",147225,147225,0
2017,"WESTERN EUROPE-OTHER","ICELAND","LUTON","REYKJAVIK",0,0,0
2017,"WESTERN EUROPE-OTHER","ICELAND","STANSTED","KEFLAVIK",25104,25104,0
2017,"WESTERN EUROPE-OTHER","KOSOVO","GATWICK","PRISTINA",20946,20946,0
2017,"WESTERN EUROPE-OTHER","KOSOVO","LUTON","PRISTINA",18208,18208,0
2017,"WESTERN EUROPE-OTHER","MACEDONIA","LUTON","OHRID",19709,19709,0
2017,"WESTERN EUROPE-OTHER","MACEDONIA","LUTON","SKOPJE",69252,69252,0
2017,"WESTERN EUROPE-OTHER","NORWAY","GATWICK","ALESUND",0,0,0
2017,"WESTERN EUROPE-OTHER","NORWAY","GATWICK","BERGEN",199362,198047,1315
2017,"WESTERN EUROPE-OTHER","NORWAY","GATWICK","BODO",0,0,0
2017,"WESTERN EUROPE-OTHER","NORWAY","GATWICK","EVENES",584,0,584
2017,"WESTERN EUROPE-OTHER","NORWAY","GATWICK","FAGERNES/LEIRIN",3196,0,3196
2017,"WESTERN EUROPE-OTHER","NORWAY","GATWICK","HAUGESUND",2125,0,2125
2017,"WESTERN EUROPE-OTHER","NORWAY","GATWICK","OSLO (GARDERMOEN)",413419,413167,252
2017,"WESTERN EUROPE-OTHER","NORWAY","GATWICK","STAVANGER",97138,97138,0
2017,"WESTERN EUROPE-OTHER","NORWAY","GATWICK","TROMSOE",20602,19238,1364
2017,"WESTERN EUROPE-OTHER","NORWAY","GATWICK","TRONDHEIM (VAERNES)",66893,66893,0
2017,"WESTERN EUROPE-OTHER","NORWAY","HEATHROW","BERGEN",71736,71736,0
2017,"WESTERN EUROPE-OTHER","NORWAY","HEATHROW","OSLO (GARDERMOEN)",679409,679409,0
2017,"WESTERN EUROPE-OTHER","NORWAY","HEATHROW","STAVANGER",148714,148714,0
2017,"WESTERN EUROPE-OTHER","NORWAY","HEATHROW","TROMSOE",0,0,0
2017,"WESTERN EUROPE-OTHER","NORWAY","LUTON","EVENES",0,0,0
2017,"WESTERN EUROPE-OTHER","NORWAY","LUTON","OSLO (GARDERMOEN)",0,0,0
2017,"WESTERN EUROPE-OTHER","NORWAY","LUTON","STAVANGER",0,0,0
2017,"WESTERN EUROPE-OTHER","NORWAY","LUTON","TRONDHEIM (VAERNES)",0,0,0
2017,"WESTERN EUROPE-OTHER","NORWAY","STANSTED","BERGEN",110,0,110
2017,"WESTERN EUROPE-OTHER","NORWAY","STANSTED","HAUGESUND",0,0,0
2017,"WESTERN EUROPE-OTHER","NORWAY","STANSTED","OSLO (GARDERMOEN)",293578,293578,0
2017,"WESTERN EUROPE-OTHER","NORWAY","STANSTED","RYGGE",0,0,0
2017,"WESTERN EUROPE-OTHER","NORWAY","STANSTED","SANDEFJORD(TORP)",48918,48918,0
2017,"WESTERN EUROPE-OTHER","NORWAY","STANSTED","TRONDHEIM (VAERNES)",0,0,0
2017,"WESTERN EUROPE-OTHER","REPUBLIC OF MONTENEGRO","GATWICK","TIVAT",33051,33051,0
2017,"WESTERN EUROPE-OTHER","REPUBLIC OF MONTENEGRO","LUTON","TIVAT",264,0,264
2017,"WESTERN EUROPE-OTHER","REPUBLIC OF MONTENEGRO","STANSTED","PODGORICA",36738,36738,0
2017,"WESTERN EUROPE-OTHER","REPUBLIC OF MONTENEGRO","STANSTED","TIVAT",0,0,0
2017,"WESTERN EUROPE-OTHER","REPUBLIC OF SERBIA","GATWICK","BELGRADE",0,0,0
2017,"WESTERN EUROPE-OTHER","REPUBLIC OF SERBIA","HEATHROW","BELGRADE",92447,92447,0
2017,"WESTERN EUROPE-OTHER","REPUBLIC OF SERBIA","LUTON","BELGRADE",47208,47103,105
2017,"WESTERN EUROPE-OTHER","REPUBLIC OF SERBIA","STANSTED","BELGRADE",100,0,100
2017,"WESTERN EUROPE-OTHER","SWITZERLAND","GATWICK","BALE MULHOUSE",278401,278400,1
2017,"WESTERN EUROPE-OTHER","SWITZERLAND","GATWICK","GENEVA",854140,826127,28013
2017,"WESTERN EUROPE-OTHER","SWITZERLAND","GATWICK","ZURICH",164837,164828,9
2017,"WESTERN EUROPE-OTHER","SWITZERLAND","HEATHROW","BALE MULHOUSE",257324,257324,0
2017,"WESTERN EUROPE-OTHER","SWITZERLAND","HEATHROW","GENEVA",1056478,1052445,4033
2017,"WESTERN EUROPE-OTHER","SWITZERLAND","HEATHROW","SION",475,475,0
2017,"WESTERN EUROPE-OTHER","SWITZERLAND","HEATHROW","ZURICH",1139638,1139271,367
2017,"WESTERN EUROPE-OTHER","SWITZERLAND","LONDON CITY","BALE MULHOUSE",15977,15977,0
2017,"WESTERN EUROPE-OTHER","SWITZERLAND","LONDON CITY","BERNE",10761,10761,0
2017,"WESTERN EUROPE-OTHER","SWITZERLAND","LONDON CITY","GENEVA",195443,195443,0
2017,"WESTERN EUROPE-OTHER","SWITZERLAND","LONDON CITY","ZURICH",402817,402817,0
2017,"WESTERN EUROPE-OTHER","SWITZERLAND","LUTON","ALTENRHEIN",0,0,0
2017,"WESTERN EUROPE-OTHER","SWITZERLAND","LUTON","BALE MULHOUSE",81815,81815,0
2017,"WESTERN EUROPE-OTHER","SWITZERLAND","LUTON","BERNE",0,0,0
2017,"WESTERN EUROPE-OTHER","SWITZERLAND","LUTON","GENEVA",293862,293860,2
2017,"WESTERN EUROPE-OTHER","SWITZERLAND","LUTON","ZURICH",174574,174514,60
2017,"WESTERN EUROPE-OTHER","SWITZERLAND","SOUTHEND","BALE MULHOUSE",41,41,0
2017,"WESTERN EUROPE-OTHER","SWITZERLAND","SOUTHEND","GENEVA",32306,32306,0
2017,"WESTERN EUROPE-OTHER","SWITZERLAND","SOUTHEND","ZURICH",0,0,0
2017,"WESTERN EUROPE-OTHER","SWITZERLAND","STANSTED","BALE MULHOUSE",103155,103019,136
2017,"WESTERN EUROPE-OTHER","SWITZERLAND","STANSTED","BERNE",156,0,156
2017,"WESTERN EUROPE-OTHER","SWITZERLAND","STANSTED","GENEVA",69614,66465,3149
2017,"WESTERN EUROPE-OTHER","SWITZERLAND","STANSTED","ZURICH",257,257,0
2017,"WESTERN EUROPE-OTHER","TURKEY","GATWICK","ANKARA (ESENBOGA)",9,0,9
2017,"WESTERN EUROPE-OTHER","TURKEY","GATWICK","ANTALYA",225771,182272,43499
2017,"WESTERN EUROPE-OTHER","TURKEY","GATWICK","BODRUM (MILAS)",97261,80827,16434
2017,"WESTERN EUROPE-OTHER","TURKEY","GATWICK","BURSA YENISEHIR",0,0,0
2017,"WESTERN EUROPE-OTHER","TURKEY","GATWICK","DALAMAN",293926,261725,32201
2017,"WESTERN EUROPE-OTHER","TURKEY","GATWICK","ISTANBUL",213718,213718,0
2017,"WESTERN EUROPE-OTHER","TURKEY","GATWICK","ISTANBUL (SABIHA GOKCEN)",87640,87640,0
2017,"WESTERN EUROPE-OTHER","TURKEY","GATWICK","IZMIR (ADNAN MENDERES)",54436,45104,9332
2017,"WESTERN EUROPE-OTHER","TURKEY","HEATHROW","ISTANBUL",1021532,1021532,0
2017,"WESTERN EUROPE-OTHER","TURKEY","HEATHROW","IZMIR (ADNAN MENDERES)",0,0,0
2017,"WESTERN EUROPE-OTHER","TURKEY","LUTON","ANKARA (ESENBOGA)",0,0,0
2017,"WESTERN EUROPE-OTHER","TURKEY","LUTON","ANTALYA",24044,20476,3568
2017,"WESTERN EUROPE-OTHER","TURKEY","LUTON","BODRUM (MILAS)",18414,18414,0
2017,"WESTERN EUROPE-OTHER","TURKEY","LUTON","DALAMAN",23813,23059,754
2017,"WESTERN EUROPE-OTHER","TURKEY","LUTON","ISTANBUL",0,0,0
2017,"WESTERN EUROPE-OTHER","TURKEY","LUTON","ISTANBUL (SABIHA GOKCEN)",0,0,0
2017,"WESTERN EUROPE-OTHER","TURKEY","LUTON","IZMIR (ADNAN MENDERES)",10640,10640,0
2017,"WESTERN EUROPE-OTHER","TURKEY","LUTON","TRABZON",46,0,46
2017,"WESTERN EUROPE-OTHER","TURKEY","SOUTHEND","BODRUM (MILAS)",352,352,0
2017,"WESTERN EUROPE-OTHER","TURKEY","STANSTED","ADANA",0,0,0
2017,"WESTERN EUROPE-OTHER","TURKEY","STANSTED","ANTALYA",81591,65238,16353
2017,"WESTERN EUROPE-OTHER","TURKEY","STANSTED","BODRUM (MILAS)",21427,21427,0
2017,"WESTERN EUROPE-OTHER","TURKEY","STANSTED","DALAMAN",116750,100878,15872
2017,"WESTERN EUROPE-OTHER","TURKEY","STANSTED","GAZIANTEP",0,0,0
2017,"WESTERN EUROPE-OTHER","TURKEY","STANSTED","ISTANBUL",94958,94893,65
2017,"WESTERN EUROPE-OTHER","TURKEY","STANSTED","ISTANBUL (SABIHA GOKCEN)",305510,305510,0
2017,"WESTERN EUROPE-OTHER","TURKEY","STANSTED","IZMIR (ADNAN MENDERES)",51065,49215,1850
2017,"EASTERN EUROPE-EU","BULGARIA","GATWICK","BURGAS",61937,24684,37253
2017,"EASTERN EUROPE-EU","BULGARIA","GATWICK","ROUSE",0,0,0
2017,"EASTERN EUROPE-EU","BULGARIA","GATWICK","SOFIA",140255,131641,8614
2017,"EASTERN EUROPE-EU","BULGARIA","GATWICK","VARNA",16765,14462,2303
2017,"EASTERN EUROPE-EU","BULGARIA","HEATHROW","SOFIA",157087,157087,0
2017,"EASTERN EUROPE-EU","BULGARIA","LUTON","BURGAS",87341,80153,7188
2017,"EASTERN EUROPE-EU","BULGARIA","LUTON","SOFIA",288858,288858,0
2017,"EASTERN EUROPE-EU","BULGARIA","LUTON","VARNA",115104,115104,0
2017,"EASTERN EUROPE-EU","BULGARIA","STANSTED","BURGAS",1959,0,1959
2017,"EASTERN EUROPE-EU","BULGARIA","STANSTED","PLOVDIV",53711,53711,0
2017,"EASTERN EUROPE-EU","BULGARIA","STANSTED","SOFIA",253261,253261,0
2017,"EASTERN EUROPE-EU","CZECH REPUBLIC","GATWICK","PRAGUE",326578,326555,23
2017,"EASTERN EUROPE-EU","CZECH REPUBLIC","HEATHROW","PRAGUE",440166,440166,0
2017,"EASTERN EUROPE-EU","CZECH REPUBLIC","LONDON CITY","PRAGUE",6532,6532,0
2017,"EASTERN EUROPE-EU","CZECH REPUBLIC","LUTON","BRNO (TURANY)",47835,47835,0
2017,"EASTERN EUROPE-EU","CZECH REPUBLIC","LUTON","PRAGUE",115157,115157,0
2017,"EASTERN EUROPE-EU","CZECH REPUBLIC","SOUTHEND","PRAGUE",27622,27622,0
2017,"EASTERN EUROPE-EU","CZECH REPUBLIC","STANSTED","BRNO (TURANY)",108793,108793,0
2017,"EASTERN EUROPE-EU","CZECH REPUBLIC","STANSTED","OSTRAVA",60350,60350,0
2017,"EASTERN EUROPE-EU","CZECH REPUBLIC","STANSTED","PARDUBICE",15458,15458,0
2017,"EASTERN EUROPE-EU","CZECH REPUBLIC","STANSTED","PRAGUE",329285,329285,0
2017,"EASTERN EUROPE-EU","ESTONIA","GATWICK","TALLIN",34579,34579,0
2017,"EASTERN EUROPE-EU","ESTONIA","HEATHROW","TALLIN",23662,23662,0
2017,"EASTERN EUROPE-EU","ESTONIA","STANSTED","TALLIN",74634,74634,0
2017,"EASTERN EUROPE-EU","HUNGARY","GATWICK","BUDAPEST",213527,213527,0
2017,"EASTERN EUROPE-EU","HUNGARY","HEATHROW","BUDAPEST",333843,333843,0
2017,"EASTERN EUROPE-EU","HUNGARY","LUTON","BUDAPEST",574051,573843,208
2017,"EASTERN EUROPE-EU","HUNGARY","LUTON","DEBRECEN",140778,140778,0
2017,"EASTERN EUROPE-EU","HUNGARY","SOUTHEND","BUDAPEST",13299,13299,0
2017,"EASTERN EUROPE-EU","HUNGARY","STANSTED","BUDAPEST",390343,390343,0
2017,"EASTERN EUROPE-EU","LATVIA","GATWICK","RIGA",122332,122332,0
2017,"EASTERN EUROPE-EU","LATVIA","LUTON","RIGA",196894,196894,0
2017,"EASTERN EUROPE-EU","LATVIA","STANSTED","RIGA",257854,257854,0
2017,"EASTERN EUROPE-EU","LITHUANIA","GATWICK","KAUNAS",0,0,0
2017,"EASTERN EUROPE-EU","LITHUANIA","GATWICK","VILNIUS",1,0,1
2017,"EASTERN EUROPE-EU","LITHUANIA","LUTON","KAUNAS",251071,251046,25
2017,"EASTERN EUROPE-EU","LITHUANIA","LUTON","PALANGA",56109,56109,0
2017,"EASTERN EUROPE-EU","LITHUANIA","LUTON","VILNIUS",247669,247669,0
2017,"EASTERN EUROPE-EU","LITHUANIA","STANSTED","KAUNAS",82435,82435,0
2017,"EASTERN EUROPE-EU","LITHUANIA","STANSTED","PALANGA",38045,38045,0
2017,"EASTERN EUROPE-EU","LITHUANIA","STANSTED","VILNIUS",107636,107636,0
2017,"EASTERN EUROPE-EU","POLAND","GATWICK","GDANSK",1,0,1
2017,"EASTERN EUROPE-EU","POLAND","GATWICK","KATOWICE",70,0,70
2017,"EASTERN EUROPE-EU","POLAND","GATWICK","KRAKOW",143924,143052,872
2017,"EASTERN EUROPE-EU","POLAND","GATWICK","POZNAN",42,0,42
2017,"EASTERN EUROPE-EU","POLAND","GATWICK","RZESZOW",0,0,0
2017,"EASTERN EUROPE-EU","POLAND","GATWICK","WARSAW (CHOPIN)",15480,15479,1
2017,"EASTERN EUROPE-EU","POLAND","GATWICK","WROCLAW",0,0,0
2017,"EASTERN EUROPE-EU","POLAND","HEATHROW","KRAKOW",96581,96581,0
2017,"EASTERN EUROPE-EU","POLAND","HEATHROW","WARSAW (CHOPIN)",444088,444088,0
2017,"EASTERN EUROPE-EU","POLAND","LUTON","BYDGOSZCZ",8764,8764,0
2017,"EASTERN EUROPE-EU","POLAND","LUTON","GDANSK",304454,304454,0
2017,"EASTERN EUROPE-EU","POLAND","LUTON","KATOWICE",318964,318964,0
2017,"EASTERN EUROPE-EU","POLAND","LUTON","KRAKOW",459,0,459
2017,"EASTERN EUROPE-EU","POLAND","LUTON","LUBLIN (PORT LOTNICZY)",113802,113802,0
2017,"EASTERN EUROPE-EU","POLAND","LUTON","POZNAN",173603,173603,0
2017,"EASTERN EUROPE-EU","POLAND","LUTON","RZESZOW",57699,57699,0
2017,"EASTERN EUROPE-EU","POLAND","LUTON","SZCZECIN (GOLENOW)",45526,45526,0
2017,"EASTERN EUROPE-EU","POLAND","LUTON","SZYMANY (MAZURY)",41004,41004,0
2017,"EASTERN EUROPE-EU","POLAND","LUTON","WARSAW (CHOPIN)",447928,447900,28
2017,"EASTERN EUROPE-EU","POLAND","LUTON","WROCLAW",118620,118620,0
2017,"EASTERN EUROPE-EU","POLAND","STANSTED","BYDGOSZCZ",120524,120524,0
2017,"EASTERN EUROPE-EU","POLAND","STANSTED","GDANSK",208935,208935,0
2017,"EASTERN EUROPE-EU","POLAND","STANSTED","KATOWICE",129993,129993,0
2017,"EASTERN EUROPE-EU","POLAND","STANSTED","KRAKOW",347441,346281,1160
2017,"EASTERN EUROPE-EU","POLAND","STANSTED","LODZ LUBLINEK",110052,110052,0
2017,"EASTERN EUROPE-EU","POLAND","STANSTED","LUBLIN (PORT LOTNICZY)",70119,70119,0
2017,"EASTERN EUROPE-EU","POLAND","STANSTED","POZNAN",136055,136055,0
2017,"EASTERN EUROPE-EU","POLAND","STANSTED","RZESZOW",141221,140959,262
2017,"EASTERN EUROPE-EU","POLAND","STANSTED","SZCZECIN (GOLENOW)",108181,108181,0
2017,"EASTERN EUROPE-EU","POLAND","STANSTED","SZYMANY (MAZURY)",51129,51129,0
2017,"EASTERN EUROPE-EU","POLAND","STANSTED","WARSAW (CHOPIN)",0,0,0
2017,"EASTERN EUROPE-EU","POLAND","STANSTED","WARSAW (MODLIN MASOVIA)",412432,412432,0
2017,"EASTERN EUROPE-EU","POLAND","STANSTED","WROCLAW",223185,223185,0
2017,"EASTERN EUROPE-EU","ROMANIA","GATWICK","BUCHAREST (OTOPENI)",122456,122456,0
2017,"EASTERN EUROPE-EU","ROMANIA","HEATHROW","BUCHAREST (OTOPENI)",260726,260726,0
2017,"EASTERN EUROPE-EU","ROMANIA","LUTON","BACAU",87117,87117,0
2017,"EASTERN EUROPE-EU","ROMANIA","LUTON","BUCHAREST (OTOPENI)",565616,565616,0
2017,"EASTERN EUROPE-EU","ROMANIA","LUTON","CLUJ NAPOCA",327118,327091,27
2017,"EASTERN EUROPE-EU","ROMANIA","LUTON","CONSTANTA",44127,44127,0
2017,"EASTERN EUROPE-EU","ROMANIA","LUTON","CRAIOVA",109332,109332,0
2017,"EASTERN EUROPE-EU","ROMANIA","LUTON","IASI",187463,187463,0
2017,"EASTERN EUROPE-EU","ROMANIA","LUTON","SATU MARE",33967,33967,0
2017,"EASTERN EUROPE-EU","ROMANIA","LUTON","SIBIU",76306,76306,0
2017,"EASTERN EUROPE-EU","ROMANIA","LUTON","SUCEAVA",77703,77703,0
2017,"EASTERN EUROPE-EU","ROMANIA","LUTON","TIMISOARA",114113,114113,0
2017,"EASTERN EUROPE-EU","ROMANIA","LUTON","TIRGU MURES",0,0,0
2017,"EASTERN EUROPE-EU","ROMANIA","STANSTED","BUCHAREST (BANEASA)",0,0,0
2017,"EASTERN EUROPE-EU","ROMANIA","STANSTED","BUCHAREST (OTOPENI)",240103,240103,0
2017,"EASTERN EUROPE-EU","ROMANIA","STANSTED","ORADEA",16029,16029,0
2017,"EASTERN EUROPE-EU","ROMANIA","STANSTED","TIMISOARA",123389,123389,0
2017,"EASTERN EUROPE-EU","SLOVAK REPUBLIC","GATWICK","BRATISLAVA",6,0,6
2017,"EASTERN EUROPE-EU","SLOVAK REPUBLIC","LUTON","BRATISLAVA",0,0,0
2017,"EASTERN EUROPE-EU","SLOVAK REPUBLIC","LUTON","KOSICE",126078,126078,0
2017,"EASTERN EUROPE-EU","SLOVAK REPUBLIC","LUTON","TATRY-POPRAD",53970,53970,0
2017,"EASTERN EUROPE-EU","SLOVAK REPUBLIC","STANSTED","BRATISLAVA",195107,194703,404
2017,"EASTERN EUROPE -OTHER","ALBANIA","GATWICK","TIRANA",96156,84677,11479
2017,"EASTERN EUROPE -OTHER","ALBANIA","STANSTED","TIRANA",2031,0,2031
2017,"EASTERN EUROPE -OTHER","AZERBAIJAN","GATWICK","BAKU (HEYDER ALIYEV INT'L)",689,0,689
2017,"EASTERN EUROPE -OTHER","AZERBAIJAN","HEATHROW","BAKU (HEYDER ALIYEV INT'L)",47985,47985,0
2017,"EASTERN EUROPE -OTHER","AZERBAIJAN","LUTON","BAKU (HEYDER ALIYEV INT'L)",1011,0,1011
2017,"EASTERN EUROPE -OTHER","BELARUS","GATWICK","MINSK INT'L ",28954,28835,119
2017,"EASTERN EUROPE -OTHER","BELARUS","LUTON","MINSK INT'L ",141,0,141
2017,"EASTERN EUROPE -OTHER","GEORGIA","GATWICK","TBILISI",7144,7144,0
2017,"EASTERN EUROPE -OTHER","GEORGIA","LUTON","KUTAISI",13992,13992,0
2017,"EASTERN EUROPE -OTHER","GEORGIA","LUTON","TBILISI",0,0,0
2017,"EASTERN EUROPE -OTHER","KAZAKHSTAN","HEATHROW","ALMATY",0,0,0
2017,"EASTERN EUROPE -OTHER","KAZAKHSTAN","HEATHROW","ASTANA",41678,41678,0
2017,"EASTERN EUROPE -OTHER","KAZAKHSTAN","LUTON","ALMATY",2,0,2
2017,"EASTERN EUROPE -OTHER","REPUBLIC OF MOLDOVA","LUTON","CHISINAU (KISHINEV)",83154,83154,0
2017,"EASTERN EUROPE -OTHER","REPUBLIC OF MOLDOVA","STANSTED","CHISINAU (KISHINEV)",60058,60058,0
2017,"EASTERN EUROPE -OTHER","RUSSIA","GATWICK","ADLER / SOCHI",0,0,0
2017,"EASTERN EUROPE -OTHER","RUSSIA","GATWICK","MOSCOW (DOMODEDOVO)",0,0,0
2017,"EASTERN EUROPE -OTHER","RUSSIA","GATWICK","MOSCOW (SHEREMETYEVO)",81042,81042,0
2017,"EASTERN EUROPE -OTHER","RUSSIA","HEATHROW","ADLER / SOCHI",119,0,119
2017,"EASTERN EUROPE -OTHER","RUSSIA","HEATHROW","KHANTY-MANSIYSK",0,0,0
2017,"EASTERN EUROPE -OTHER","RUSSIA","HEATHROW","MOSCOW (DOMODEDOVO)",261437,261311,126
2017,"EASTERN EUROPE -OTHER","RUSSIA","HEATHROW","MOSCOW (SHEREMETYEVO)",422025,422025,0
2017,"EASTERN EUROPE -OTHER","RUSSIA","HEATHROW","MOSCOW (VNUKOVO)",0,0,0
2017,"EASTERN EUROPE -OTHER","RUSSIA","HEATHROW","ST PETERSBURG",93026,93026,0
2017,"EASTERN EUROPE -OTHER","RUSSIA","LUTON","ADLER / SOCHI",918,0,918
2017,"EASTERN EUROPE -OTHER","RUSSIA","LUTON","MOSCOW (SHEREMETYEVO)",0,0,0
2017,"EASTERN EUROPE -OTHER","RUSSIA","LUTON","MOSCOW (VNUKOVO)",167,0,167
2017,"EASTERN EUROPE -OTHER","RUSSIA","LUTON","NOVOSIBIRSK (TOLMACHEVO)",0,0,0
2017,"EASTERN EUROPE -OTHER","RUSSIA","LUTON","ST PETERSBURG",0,0,0
2017,"EASTERN EUROPE -OTHER","RUSSIA","STANSTED","ST PETERSBURG",0,0,0
2017,"EASTERN EUROPE -OTHER","TURKMENISTAN","HEATHROW","ASHKHABAD",9987,9987,0
2017,"EASTERN EUROPE -OTHER","UKRAINE","GATWICK","KIEV (BORISPOL)",170437,170437,0
2017,"EASTERN EUROPE -OTHER","UKRAINE","GATWICK","KIEV (ZHULYANY)",0,0,0
2017,"EASTERN EUROPE -OTHER","UKRAINE","HEATHROW","KIEV (BORISPOL)",80344,80344,0
2017,"EASTERN EUROPE -OTHER","UKRAINE","LUTON","KIEV (BORISPOL)",926,926,0
2017,"EASTERN EUROPE -OTHER","UKRAINE","LUTON","KIEV (ZHULYANY)",41528,41528,0
2017,"EASTERN EUROPE -OTHER","UKRAINE","LUTON","LVOV",0,0,0
2017,"EASTERN EUROPE -OTHER","UKRAINE","LUTON","ODESSA",0,0,0
2017,"EASTERN EUROPE -OTHER","UZBEKISTAN","HEATHROW","TASHKENT",26138,26138,0
2017,"NEAR EAST","ISRAEL","GATWICK","TEL AVIV",34115,33744,371
2017,"NEAR EAST","ISRAEL","HEATHROW","TEL AVIV",607277,607277,0
2017,"NEAR EAST","ISRAEL","LUTON","OVDA",3644,3255,389
2017,"NEAR EAST","ISRAEL","LUTON","TEL AVIV",417773,414376,3397
2017,"NEAR EAST","ISRAEL","STANSTED","TEL AVIV",19751,19657,94
2017,"NEAR EAST","JORDAN","GATWICK","AQABA",568,0,568
2017,"NEAR EAST","JORDAN","HEATHROW","AMMAN",219105,219105,0
2017,"NEAR EAST","JORDAN","LUTON","AMMAN (KING HUSSEIN)",0,0,0
2017,"NEAR EAST","JORDAN","STANSTED","AMMAN",0,0,0
2017,"NEAR EAST","LEBANON","HEATHROW","BEIRUT",292894,292894,0
2017,"NORTH AFRICA","ALGERIA","GATWICK","ALGIERS",52299,52299,0
2017,"NORTH AFRICA","ALGERIA","HEATHROW","ALGIERS",76544,76544,0
2017,"NORTH AFRICA","ALGERIA","LUTON","ALGIERS",0,0,0
2017,"NORTH AFRICA","ALGERIA","STANSTED","HASSI MESSAOUD",0,0,0
2017,"NORTH AFRICA","EGYPT","GATWICK","HURGHADA",182655,139494,43161
2017,"NORTH AFRICA","EGYPT","GATWICK","LUXOR",0,0,0
2017,"NORTH AFRICA","EGYPT","GATWICK","MARSA ALAM",21076,21076,0
2017,"NORTH AFRICA","EGYPT","GATWICK","SHARM EL SHEIKH (OPHIRA)",0,0,0
2017,"NORTH AFRICA","EGYPT","HEATHROW","CAIRO",378097,378097,0
2017,"NORTH AFRICA","EGYPT","HEATHROW","LUXOR",7167,7167,0
2017,"NORTH AFRICA","EGYPT","LUTON","CAIRO",0,0,0
2017,"NORTH AFRICA","EGYPT","LUTON","HURGHADA",0,0,0
2017,"NORTH AFRICA","EGYPT","STANSTED","HURGHADA",135,0,135
2017,"NORTH AFRICA","MOROCCO","GATWICK","AGADIR (AL MASSIRA)",92309,92229,80
2017,"NORTH AFRICA","MOROCCO","GATWICK","CASABLANCA MOHAMED V",55889,55889,0
2017,"NORTH AFRICA","MOROCCO","GATWICK","FEZ",5298,5298,0
2017,"NORTH AFRICA","MOROCCO","GATWICK","MARRAKESH",327835,327833,2
2017,"NORTH AFRICA","MOROCCO","GATWICK","OUARZAZATE",819,0,819
2017,"NORTH AFRICA","MOROCCO","GATWICK","RABAT",6940,6647,293
2017,"NORTH AFRICA","MOROCCO","GATWICK","TANGIERS (IBN BATUTA)",25428,25428,0
2017,"NORTH AFRICA","MOROCCO","HEATHROW","CASABLANCA MOHAMED V",86369,86369,0
2017,"NORTH AFRICA","MOROCCO","HEATHROW","MARRAKESH",0,0,0
2017,"NORTH AFRICA","MOROCCO","HEATHROW","RABAT",10292,10292,0
2017,"NORTH AFRICA","MOROCCO","LUTON","ESSAOUIRA",31249,31249,0
2017,"NORTH AFRICA","MOROCCO","LUTON","MARRAKESH",59749,59749,0
2017,"NORTH AFRICA","MOROCCO","LUTON","RABAT",44,0,44
2017,"NORTH AFRICA","MOROCCO","STANSTED","AGADIR (AL MASSIRA)",37553,37553,0
2017,"NORTH AFRICA","MOROCCO","STANSTED","FEZ",36425,36425,0
2017,"NORTH AFRICA","MOROCCO","STANSTED","MARRAKESH",132231,128455,3776
2017,"NORTH AFRICA","MOROCCO","STANSTED","RABAT",53775,53775,0
2017,"NORTH AFRICA","TUNISIA","GATWICK","TUNIS",28758,28758,0
2017,"NORTH AFRICA","TUNISIA","HEATHROW","TUNIS",45179,45179,0
2017,"NORTH AFRICA","TUNISIA","STANSTED","TUNIS",29,0,29
2017,"EAST AFRICA","ETHIOPIA","HEATHROW","ADDIS ABABA",190483,190483,0
2017,"EAST AFRICA","KENYA","HEATHROW","NAIROBI",337920,337920,0
2017,"EAST AFRICA","RWANDA","GATWICK","KIGALI",14132,14132,0
2017,"WEST AFRICA","GAMBIA","GATWICK","BANJUL",42775,21980,20795
2017,"WEST AFRICA","GHANA","GATWICK","ACCRA",460,0,460
2017,"WEST AFRICA","GHANA","HEATHROW","ACCRA",208615,208615,0
2017,"WEST AFRICA","NIGERIA","GATWICK","LAGOS",63944,63596,348
2017,"WEST AFRICA","NIGERIA","HEATHROW","ABUJA",98457,98457,0
2017,"WEST AFRICA","NIGERIA","HEATHROW","LAGOS",340449,340449,0
2017,"WEST AFRICA","NIGERIA","LUTON","ABUJA",3,0,3
2017,"WEST AFRICA","NIGERIA","SOUTHEND","IBADAN",144,144,0
2017,"CENTRAL AFRICA","ANGOLA","HEATHROW","LUANDA",11122,11122,0
2017,"SOUTHERN AFRICA","REPUBLIC OF SOUTH AFRICA","GATWICK","CAPE TOWN",45188,45188,0
2017,"SOUTHERN AFRICA","REPUBLIC OF SOUTH AFRICA","HEATHROW","CAPE TOWN",330897,330897,0
2017,"SOUTHERN AFRICA","REPUBLIC OF SOUTH AFRICA","HEATHROW","JOHANNESBURG",954716,954716,0
2017,"MIDDLE EAST","BAHRAIN","HEATHROW","BAHRAIN",328920,328920,0
2017,"MIDDLE EAST","IRAN","HEATHROW","TEHRAN IMAM KHOMEINI",153207,153207,0
2017,"MIDDLE EAST","IRAN","LUTON","TEHRAN",0,0,0
2017,"MIDDLE EAST","IRAQ","GATWICK","BAGHDAD (GECA)",7814,7784,30
2017,"MIDDLE EAST","IRAQ","GATWICK","SULAYMANIYAH INT",7164,7164,0
2017,"MIDDLE EAST","KUWAIT","HEATHROW","KUWAIT",384392,384392,0
2017,"MIDDLE EAST","KUWAIT","LUTON","KUWAIT",0,0,0
2017,"MIDDLE EAST","OMAN","HEATHROW","MUSCAT",331675,331675,0
2017,"MIDDLE EAST","QATAR","HEATHROW","DOHA HAMAD",1287225,1287197,28
2017,"MIDDLE EAST","QATAR","STANSTED","DOHA HAMAD",185,185,0
2017,"MIDDLE EAST","SAUDI ARABIA","HEATHROW","JEDDAH",230160,230160,0
2017,"MIDDLE EAST","SAUDI ARABIA","HEATHROW","MEDINA",2302,2302,0
2017,"MIDDLE EAST","SAUDI ARABIA","HEATHROW","RIYADH",250805,250805,0
2017,"MIDDLE EAST","SAUDI ARABIA","LUTON","DHAHRAN",0,0,0
2017,"MIDDLE EAST","SAUDI ARABIA","LUTON","JEDDAH",0,0,0
2017,"MIDDLE EAST","SAUDI ARABIA","LUTON","RIYADH",0,0,0
2017,"MIDDLE EAST","UNITED ARAB EMIRATES","GATWICK","DUBAI",966466,966466,0
2017,"MIDDLE EAST","UNITED ARAB EMIRATES","GATWICK","DUBAI (WORLD CENTRAL)",7209,0,7209
2017,"MIDDLE EAST","UNITED ARAB EMIRATES","HEATHROW","ABU DHABI INTERNATIONAL",1004473,1004473,0
2017,"MIDDLE EAST","UNITED ARAB EMIRATES","HEATHROW","DUBAI",2873011,2873011,0
2017,"MIDDLE EAST","UNITED ARAB EMIRATES","LUTON","ABU DHABI - BATEEN",0,0,0
2017,"MIDDLE EAST","UNITED ARAB EMIRATES","LUTON","DUBAI",0,0,0
2017,"INDIAN SUB-CONTINENT","BANGLADESH","HEATHROW","DHAKHA",73116,73116,0
2017,"INDIAN SUB-CONTINENT","BANGLADESH","HEATHROW","SYLHET",48927,48927,0
2017,"INDIAN SUB-CONTINENT","INDIA","GATWICK","GOA",42331,25480,16851
2017,"INDIAN SUB-CONTINENT","INDIA","HEATHROW","AHMEDABAD",66719,66719,0
2017,"INDIAN SUB-CONTINENT","INDIA","HEATHROW","AMRITSAR",5003,5003,0
2017,"INDIAN SUB-CONTINENT","INDIA","HEATHROW","BANGALORE (BENGALURU)",171746,171746,0
2017,"INDIAN SUB-CONTINENT","INDIA","HEATHROW","CHENNAI",132218,132218,0
2017,"INDIAN SUB-CONTINENT","INDIA","HEATHROW","DELHI",1023509,1023509,0
2017,"INDIAN SUB-CONTINENT","INDIA","HEATHROW","HYDERABAD ( RAJIV GHANDI )",136468,136468,0
2017,"INDIAN SUB-CONTINENT","INDIA","HEATHROW","MUMBAI",963977,963977,0
2017,"INDIAN SUB-CONTINENT","INDIA","LUTON","JAIPUR",0,0,0
2017,"INDIAN SUB-CONTINENT","PAKISTAN","GATWICK","ISLAMABAD",1067,0,1067
2017,"INDIAN SUB-CONTINENT","PAKISTAN","HEATHROW","ISLAMABAD",124286,124286,0
2017,"INDIAN SUB-CONTINENT","PAKISTAN","HEATHROW","KARACHI",44720,44720,0
2017,"INDIAN SUB-CONTINENT","PAKISTAN","HEATHROW","LAHORE",86623,86623,0
2017,"INDIAN SUB-CONTINENT","SRI LANKA","GATWICK","COLOMBO",10620,0,10620
2017,"INDIAN SUB-CONTINENT","SRI LANKA","HEATHROW","COLOMBO",218075,218075,0
2017,"INDIAN SUB-CONTINENT","SRI LANKA","HEATHROW","MATTALA RAJAPAKSA",3,3,0
2017,"FAR EAST","BRUNEI","HEATHROW","BANDAR SERI BEGAWAN",78340,78340,0
2017,"FAR EAST","CHINA","GATWICK","CHONGQING JIANGBEI INTERNATIONAL",20795,20795,0
2017,"FAR EAST","CHINA","GATWICK","SHANGHAI (PU DONG)",198,198,0
2017,"FAR EAST","CHINA","GATWICK","TIANJIN",19441,19441,0
2017,"FAR EAST","CHINA","GATWICK","XIAMEN",12,0,12
2017,"FAR EAST","CHINA","HEATHROW","BEIJING",485503,485061,442
2017,"FAR EAST","CHINA","HEATHROW","CHENGDU",1562,1562,0
2017,"FAR EAST","CHINA","HEATHROW","GUANGZHOU BAIYUN INTERNATIONAL",208653,208653,0
2017,"FAR EAST","CHINA","HEATHROW","SHANGHAI (PU DONG)",486159,486159,0
2017,"FAR EAST","CHINA","STANSTED","BEIJING",258,0,258
2017,"FAR EAST","HONG KONG","GATWICK","HONG KONG (CHEK LAP KOK)",145058,145058,0
2017,"FAR EAST","HONG KONG","HEATHROW","HONG KONG (CHEK LAP KOK)",1588805,1588805,0
2017,"FAR EAST","INDONESIA","GATWICK","JAKARTA (SOEKARNO-HATTA INTNL)",0,0,0
2017,"FAR EAST","INDONESIA","HEATHROW","JAKARTA (SOEKARNO-HATTA INTNL)",34893,34893,0
2017,"FAR EAST","JAPAN","HEATHROW","TOKYO (HANEDA)",487627,487627,0
2017,"FAR EAST","JAPAN","HEATHROW","TOKYO (NARITA)",137817,137817,0
2017,"FAR EAST","MALAYSIA","HEATHROW","KUALA LUMPUR (SEPANG)",692039,692039,0
2017,"FAR EAST","PHILIPPINES","HEATHROW","MANILA",130309,130309,0
2017,"FAR EAST","REPUBLIC OF KOREA","HEATHROW","SEOUL (INCHEON)",506857,506857,0
2017,"FAR EAST","SINGAPORE","GATWICK","SINGAPORE",25548,25548,0
2017,"FAR EAST","SINGAPORE","HEATHROW","SINGAPORE",1234806,1234806,0
2017,"FAR EAST","TAIWAN","GATWICK","TAIPEI",9447,9447,0
2017,"FAR EAST","TAIWAN","HEATHROW","TAIPEI",35682,35682,0
2017,"FAR EAST","THAILAND","GATWICK","KRABI",1207,0,1207
2017,"FAR EAST","THAILAND","GATWICK","PHUKET",16469,0,16469
2017,"FAR EAST","THAILAND","HEATHROW","BANGKOK SUVARNABHUMI ",850446,850446,0
2017,"FAR EAST","VIETNAM","GATWICK","PHU QUOC INTERNATIONAL",3892,0,3892
2017,"FAR EAST","VIETNAM","HEATHROW","HANOI",84975,84975,0
2017,"FAR EAST","VIETNAM","HEATHROW","HO CHI MINH CITY",65357,65357,0
2017,"AUSTRALASIA","AUSTRALIA","HEATHROW","BRISBANE",335,0,335
2017,"AUSTRALASIA","AUSTRALIA","HEATHROW","MELBOURNE",142615,142615,0
2017,"AUSTRALASIA","AUSTRALIA","HEATHROW","SYDNEY",261176,260844,332
2017,"AUSTRALASIA","AUSTRALIA","STANSTED","SYDNEY",0,0,0
2017,"AUSTRALASIA","NEW ZEALAND","HEATHROW","AUCKLAND INTERNATIONAL",17566,17566,0
2017,"CANADA","CANADA","GATWICK","CALGARY",131049,131049,0
2017,"CANADA","CANADA","GATWICK","EDMONTON",10008,10008,0
2017,"CANADA","CANADA","GATWICK","MONTREAL (DORVAL)",25624,25624,0
2017,"CANADA","CANADA","GATWICK","OTTAWA INTERNATIONAL",38032,38032,0
2017,"CANADA","CANADA","GATWICK","ST JOHNS",0,0,0
2017,"CANADA","CANADA","GATWICK","TORONTO",429508,429508,0
2017,"CANADA","CANADA","GATWICK","VANCOUVER",197016,197016,0
2017,"CANADA","CANADA","GATWICK","WINNIPEG",4907,4907,0
2017,"CANADA","CANADA","HEATHROW","CALGARY",305003,305003,0
2017,"CANADA","CANADA","HEATHROW","HALIFAX INT",78785,78785,0
2017,"CANADA","CANADA","HEATHROW","MONTREAL (DORVAL)",320668,320668,0
2017,"CANADA","CANADA","HEATHROW","OTTAWA INTERNATIONAL",113286,113286,0
2017,"CANADA","CANADA","HEATHROW","ST JOHNS",33467,33467,0
2017,"CANADA","CANADA","HEATHROW","TORONTO",1047947,1047947,0
2017,"CANADA","CANADA","HEATHROW","VANCOUVER",504218,504218,0
2017,"CANADA","CANADA","LUTON","GANDER",0,0,0
2017,"UNITED STATES OF AMERICA","USA","GATWICK","BOSTON",136407,136407,0
2017,"UNITED STATES OF AMERICA","USA","GATWICK","CHARLOTTE",145,0,145
2017,"UNITED STATES OF AMERICA","USA","GATWICK","CHICAGO (O'HARE)",1,0,1
2017,"UNITED STATES OF AMERICA","USA","GATWICK","DALLAS/FORT WORTH",13,0,13
2017,"UNITED STATES OF AMERICA","USA","GATWICK","DENVER INTERNATIONAL",18848,18848,0
2017,"UNITED STATES OF AMERICA","USA","GATWICK","DETROIT",0,0,0
2017,"UNITED STATES OF AMERICA","USA","GATWICK","FORT LAUDERDALE",112394,112394,0
2017,"UNITED STATES OF AMERICA","USA","GATWICK","INDIANAPOLIS",0,0,0
2017,"UNITED STATES OF AMERICA","USA","GATWICK","LAS VEGAS",257297,257297,0
2017,"UNITED STATES OF AMERICA","USA","GATWICK","LOS ANGELES INTERNATIONAL",213673,213673,0
2017,"UNITED STATES OF AMERICA","USA","GATWICK","MINNEAPOLIS-ST PAUL",0,0,0
2017,"UNITED STATES OF AMERICA","USA","GATWICK","NEW ORLEANS",0,0,0
2017,"UNITED STATES OF AMERICA","USA","GATWICK","NEW YORK (JF KENNEDY)",450820,450820,0
2017,"UNITED STATES OF AMERICA","USA","GATWICK","OAKLAND",190032,190032,0
2017,"UNITED STATES OF AMERICA","USA","GATWICK","ORLANDO",826319,825642,677
2017,"UNITED STATES OF AMERICA","USA","GATWICK","PHOENIX",168,0,168
2017,"UNITED STATES OF AMERICA","USA","GATWICK","SAN BERNARDINO (NORTON AFB)",1,0,1
2017,"UNITED STATES OF AMERICA","USA","GATWICK","SANFORD",39862,0,39862
2017,"UNITED STATES OF AMERICA","USA","GATWICK","SEATTLE (TACOMA)",27745,27745,0
2017,"UNITED STATES OF AMERICA","USA","GATWICK","TAMPA",141000,141000,0
2017,"UNITED STATES OF AMERICA","USA","HEATHROW","ATLANTA",644081,644081,0
2017,"UNITED STATES OF AMERICA","USA","HEATHROW","AUSTIN (BERGSTROM)",128887,128887,0
2017,"UNITED STATES OF AMERICA","USA","HEATHROW","BALTIMORE",124756,124423,333
2017,"UNITED STATES OF AMERICA","USA","HEATHROW","BOSTON",814124,813880,244
2017,"UNITED STATES OF AMERICA","USA","HEATHROW","CHARLOTTE",303240,303240,0
2017,"UNITED STATES OF AMERICA","USA","HEATHROW","CHICAGO (O'HARE)",1062328,1062328,0
2017,"UNITED STATES OF AMERICA","USA","HEATHROW","CINCINNATI",0,0,0
2017,"UNITED STATES OF AMERICA","USA","HEATHROW","CLEVELAND",787,0,787
2017,"UNITED STATES OF AMERICA","USA","HEATHROW","DALLAS/FORT WORTH",677113,677113,0
2017,"UNITED STATES OF AMERICA","USA","HEATHROW","DENVER INTERNATIONAL",195398,195206,192
2017,"UNITED STATES OF AMERICA","USA","HEATHROW","DETROIT",188797,188797,0
2017,"UNITED STATES OF AMERICA","USA","HEATHROW","FORT LAUDERDALE",176,0,176
2017,"UNITED STATES OF AMERICA","USA","HEATHROW","HOUSTON",474976,474976,0
2017,"UNITED STATES OF AMERICA","USA","HEATHROW","INDIANAPOLIS",243,243,0
2017,"UNITED STATES OF AMERICA","USA","HEATHROW","JACKSONVILLE",553,0,553
2017,"UNITED STATES OF AMERICA","USA","HEATHROW","LAS VEGAS",320674,320674,0
2017,"UNITED STATES OF AMERICA","USA","HEATHROW","LOS ANGELES INTERNATIONAL",1600587,1600415,172
2017,"UNITED STATES OF AMERICA","USA","HEATHROW","MIAMI INTERNATIONAL",985148,984961,187
2017,"UNITED STATES OF AMERICA","USA","HEATHROW","MINNEAPOLIS-ST PAUL",129130,128430,700
2017,"UNITED STATES OF AMERICA","USA","HEATHROW","NEW ORLEANS",56519,55994,525
2017,"UNITED STATES OF AMERICA","USA","HEATHROW","NEW YORK (JF KENNEDY)",2945744,2945744,0
2017,"UNITED STATES OF AMERICA","USA","HEATHROW","NEW YORK (NEWARK)",1020678,1020678,0
2017,"UNITED STATES OF AMERICA","USA","HEATHROW","ORLANDO",661,0,661
2017,"UNITED STATES OF AMERICA","USA","HEATHROW","PHILADELPHIA INTERNATIONAL",485316,485316,0
2017,"UNITED STATES OF AMERICA","USA","HEATHROW","PHOENIX",220180,220027,153
2017,"UNITED STATES OF AMERICA","USA","HEATHROW","PORTLAND (OREGON)",24421,24421,0
2017,"UNITED STATES OF AMERICA","USA","HEATHROW","RALEIGH",125410,125410,0
2017,"UNITED STATES OF AMERICA","USA","HEATHROW","SALT LAKE CITY",83169,83169,0
2017,"UNITED STATES OF AMERICA","USA","HEATHROW","SAN DIEGO",174586,174586,0
2017,"UNITED STATES OF AMERICA","USA","HEATHROW","SAN FRANCISCO",1009584,1009584,0
2017,"UNITED STATES OF AMERICA","USA","HEATHROW","SAN JOSE",113463,113463,0
2017,"UNITED STATES OF AMERICA","USA","HEATHROW","SEATTLE (TACOMA)",384596,384596,0
2017,"UNITED STATES OF AMERICA","USA","HEATHROW","TAMPA",2,2,0
2017,"UNITED STATES OF AMERICA","USA","HEATHROW","WASHINGTON (DULLES)",845634,845634,0
2017,"UNITED STATES OF AMERICA","USA","LONDON CITY","NEW YORK (JF KENNEDY)",11966,11966,0
2017,"UNITED STATES OF AMERICA","USA","LUTON","BOSTON",0,0,0
2017,"UNITED STATES OF AMERICA","USA","LUTON","DALLAS",0,0,0
2017,"UNITED STATES OF AMERICA","USA","LUTON","INDIANAPOLIS",0,0,0
2017,"UNITED STATES OF AMERICA","USA","LUTON","LOS ANGELES INTERNATIONAL",0,0,0
2017,"UNITED STATES OF AMERICA","USA","LUTON","MIAMI INTERNATIONAL",11,0,11
2017,"UNITED STATES OF AMERICA","USA","LUTON","MINNEAPOLIS-ST PAUL",0,0,0
2017,"UNITED STATES OF AMERICA","USA","LUTON","NEW YORK (NEWARK)",0,0,0
2017,"UNITED STATES OF AMERICA","USA","LUTON","WASHINGTON (DULLES)",0,0,0
2017,"UNITED STATES OF AMERICA","USA","STANSTED","FORT LAUDERDALE",0,0,0
2017,"UNITED STATES OF AMERICA","USA","STANSTED","LAS VEGAS",6507,6507,0
2017,"UNITED STATES OF AMERICA","USA","STANSTED","LOS ANGELES INTERNATIONAL",347,347,0
2017,"UNITED STATES OF AMERICA","USA","STANSTED","NEW YORK (NEWARK)",1742,1742,0
2017,"UNITED STATES OF AMERICA","USA","STANSTED","ORLANDO",28314,28314,0
2017,"UNITED STATES OF AMERICA","USA","STANSTED","SANFORD",3462,0,3462
2017,"CENTRAL AMERICA","COSTA RICA","GATWICK","LIBERIA",30443,0,30443
2017,"CENTRAL AMERICA","COSTA RICA","GATWICK","SAN JOSE COST RICA",55360,55360,0
2017,"CENTRAL AMERICA","CUBA","GATWICK","CUNAGUA (CAYO COCO)",13056,13056,0
2017,"CENTRAL AMERICA","CUBA","GATWICK","HAVANA",78831,78831,0
2017,"CENTRAL AMERICA","CUBA","GATWICK","HOLGUIN (FRANK PAIS)",31699,31699,0
2017,"CENTRAL AMERICA","CUBA","GATWICK","VARADERO",44043,14317,29726
2017,"CENTRAL AMERICA","DOMINICAN REPUBLIC","GATWICK","LA ROMANA",3236,0,3236
2017,"CENTRAL AMERICA","DOMINICAN REPUBLIC","GATWICK","PUERTO PLATA",30566,0,30566
2017,"CENTRAL AMERICA","DOMINICAN REPUBLIC","GATWICK","PUNTA CANA",157638,71457,86181
2017,"CENTRAL AMERICA","MEXICO","GATWICK","ACAPULCO",0,0,0
2017,"CENTRAL AMERICA","MEXICO","GATWICK","CANCUN",403490,371732,31758
2017,"CENTRAL AMERICA","MEXICO","GATWICK","COZUMEL",0,0,0
2017,"CENTRAL AMERICA","MEXICO","GATWICK","PUERTO VALLARTA",31446,0,31446
2017,"CENTRAL AMERICA","MEXICO","HEATHROW","MEXICO CITY",278469,278469,0
2017,"CENTRAL AMERICA","MEXICO","STANSTED","CANCUN",32645,25106,7539
2017,"SOUTH AMERICA","ARGENTINA","HEATHROW","BUENOS AIRES",177065,177065,0
2017,"SOUTH AMERICA","BRAZIL","HEATHROW","RIO DE JANEIRO (GALEAO)",105685,105685,0
2017,"SOUTH AMERICA","BRAZIL","HEATHROW","SAO PAULO (GUARULHOS)",406101,406101,0
2017,"SOUTH AMERICA","CHILE","HEATHROW","SANTIAGO DE CHILE",71817,71817,0
2017,"SOUTH AMERICA","COLOMBIA","GATWICK","CARTAGENA",0,0,0
2017,"SOUTH AMERICA","COLOMBIA","HEATHROW","BOGOTA",158548,158548,0
2017,"SOUTH AMERICA","ECUADOR","GATWICK","GUAYAQUIL",0,0,0
2017,"SOUTH AMERICA","PERU","GATWICK","LIMA",47807,47807,0
2017,"SOUTH AMERICA","PERU","HEATHROW","LIMA",274,274,0
2017,"CARIBBEAN AREA","ANTIGUA AND BARBUDA","GATWICK","ANTIGUA",158955,158955,0
2017,"CARIBBEAN AREA","BAHAMAS","GATWICK","NASSAU",0,0,0
2017,"CARIBBEAN AREA","BAHAMAS","HEATHROW","NASSAU",55580,55580,0
2017,"CARIBBEAN AREA","BARBADOS","GATWICK","BRIDGETOWN",450836,383946,66890
2017,"CARIBBEAN AREA","BARBADOS","HEATHROW","BRIDGETOWN",4988,2438,2550
2017,"CARIBBEAN AREA","BARBADOS","STANSTED","BRIDGETOWN",0,0,0
2017,"CARIBBEAN AREA","BERMUDA","GATWICK","BERMUDA",98227,98227,0
2017,"CARIBBEAN AREA","CAYMAN ISLANDS","HEATHROW","GRAND CAYMAN",34935,34935,0
2017,"CARIBBEAN AREA","GRENADA","GATWICK","GRENADA",35848,35848,0
2017,"CARIBBEAN AREA","ISLE OF CURACAO NETH.ANTILLES","GATWICK","ARUBA",16627,0,16627
2017,"CARIBBEAN AREA","JAMAICA","GATWICK","KINGSTON",97512,97362,150
2017,"CARIBBEAN AREA","JAMAICA","GATWICK","MONTEGO BAY",220936,104708,116228
2017,"CARIBBEAN AREA","JAMAICA","STANSTED","MONTEGO BAY",10243,0,10243
2017,"CARIBBEAN AREA","PUERTO RICO","GATWICK","SAN JUAN (PUERTO RICO)",14756,14756,0
2017,"CARIBBEAN AREA","SAINT KITTS AND NEVIS","GATWICK","ST KITTS",17673,17673,0
2017,"CARIBBEAN AREA","ST LUCIA","GATWICK","ST LUCIA (HEWANORRA)",184235,160432,23803
2017,"CARIBBEAN AREA","TRINIDAD AND TOBAGO","GATWICK","PORT OF SPAIN",61697,61697,0
2017,"CARIBBEAN AREA","TRINIDAD AND TOBAGO","GATWICK","TOBAGO",35267,35267,0
2017,"CARIBBEAN AREA","TURKS AND CAICOS ISLANDS","GATWICK","PROVIDENCIALES",14369,14369,0
2017,"INDIAN OCEAN ISLANDS","MALDIVE ISLANDS","GATWICK","MALE INTERNATIONAL",27798,27798,0
2017,"INDIAN OCEAN ISLANDS","MALDIVE ISLANDS","HEATHROW","MALE INTERNATIONAL",2118,2118,0
2017,"INDIAN OCEAN ISLANDS","MAURITIUS","GATWICK","MAURITIUS",120673,118731,1942
2017,"INDIAN OCEAN ISLANDS","MAURITIUS","HEATHROW","MAURITIUS",94101,94101,0
2017,"ATLANTIC OCEAN ISLANDS","ASCENSION ISLAND","STANSTED","ASCENSION ISLAND",32,0,32
2017,"ATLANTIC OCEAN ISLANDS","CAPE VERDE ISLANDS","GATWICK","BOA VISTA (RABIL)",66384,59064,7320
2017,"ATLANTIC OCEAN ISLANDS","CAPE VERDE ISLANDS","GATWICK","ILHA DO SAL C.VERDE",86475,81215,5260
2017,"ATLANTIC OCEAN ISLANDS","CAPE VERDE ISLANDS","STANSTED","BOA VISTA (RABIL)",0,0,0
2017,"ATLANTIC OCEAN ISLANDS","FALKLAND ISLANDS","GATWICK","MOUNT PLEASANT",0,0,0
2018,"Unknown","Unknown","GATWICK","Unknown",0,0,0
2018,"WESTERN EUROPE-EU","AUSTRIA","GATWICK","INNSBRUCK",200652,176646,24006
2018,"WESTERN EUROPE-EU","AUSTRIA","GATWICK","KLAGENFURT",5758,5758,0
2018,"WESTERN EUROPE-EU","AUSTRIA","GATWICK","LINZ",172,172,0
2018,"WESTERN EUROPE-EU","AUSTRIA","GATWICK","SALZBURG",137514,118512,19002
2018,"WESTERN EUROPE-EU","AUSTRIA","GATWICK","VIENNA",265519,265519,0
2018,"WESTERN EUROPE-EU","AUSTRIA","HEATHROW","INNSBRUCK",54962,54962,0
2018,"WESTERN EUROPE-EU","AUSTRIA","HEATHROW","SALZBURG",33855,33855,0
2018,"WESTERN EUROPE-EU","AUSTRIA","HEATHROW","VIENNA",840882,840882,0
2018,"WESTERN EUROPE-EU","AUSTRIA","LUTON","GRAZ",401,0,401
2018,"WESTERN EUROPE-EU","AUSTRIA","LUTON","INNSBRUCK",13975,13975,0
2018,"WESTERN EUROPE-EU","AUSTRIA","LUTON","LINZ",218,218,0
2018,"WESTERN EUROPE-EU","AUSTRIA","LUTON","SALZBURG",11521,8215,3306
2018,"WESTERN EUROPE-EU","AUSTRIA","LUTON","VIENNA",63564,63564,0
2018,"WESTERN EUROPE-EU","AUSTRIA","SOUTHEND","VIENNA",16884,16884,0
2018,"WESTERN EUROPE-EU","AUSTRIA","STANSTED","GRAZ",0,0,0
2018,"WESTERN EUROPE-EU","AUSTRIA","STANSTED","INNSBRUCK",8794,946,7848
2018,"WESTERN EUROPE-EU","AUSTRIA","STANSTED","LINZ",26776,26776,0
2018,"WESTERN EUROPE-EU","AUSTRIA","STANSTED","SALZBURG",150737,146304,4433
2018,"WESTERN EUROPE-EU","AUSTRIA","STANSTED","VIENNA",104876,104876,0
2018,"WESTERN EUROPE-EU","BELGIUM","GATWICK","ANTWERP",0,0,0
2018,"WESTERN EUROPE-EU","BELGIUM","GATWICK","BRUSSELS",12304,12304,0
2018,"WESTERN EUROPE-EU","BELGIUM","HEATHROW","BRUSSELS",672319,672319,0
2018,"WESTERN EUROPE-EU","BELGIUM","LONDON CITY","ANTWERP",27525,27525,0
2018,"WESTERN EUROPE-EU","BELGIUM","LONDON CITY","BRUSSELS",67,67,0
2018,"WESTERN EUROPE-EU","BELGIUM","LONDON CITY","OSTEND",71,71,0
2018,"WESTERN EUROPE-EU","BELGIUM","LUTON","ANTWERP",42,0,42
2018,"WESTERN EUROPE-EU","BELGIUM","LUTON","OSTEND",13,0,13
2018,"WESTERN EUROPE-EU","BELGIUM","SOUTHEND","ANTWERP",13246,13246,0
2018,"WESTERN EUROPE-EU","BELGIUM","STANSTED","BRUSSELS",0,0,0
2018,"WESTERN EUROPE-EU","CROATIA","GATWICK","DUBROVNIK",219074,218779,295
2018,"WESTERN EUROPE-EU","CROATIA","GATWICK","PULA",43821,20112,23709
2018,"WESTERN EUROPE-EU","CROATIA","GATWICK","SPLIT",177874,161290,16584
2018,"WESTERN EUROPE-EU","CROATIA","GATWICK","ZAGREB",374,374,0
2018,"WESTERN EUROPE-EU","CROATIA","HEATHROW","PULA",7245,7245,0
2018,"WESTERN EUROPE-EU","CROATIA","HEATHROW","RIJEKA",0,0,0
2018,"WESTERN EUROPE-EU","CROATIA","HEATHROW","SPLIT",31201,31201,0
2018,"WESTERN EUROPE-EU","CROATIA","HEATHROW","ZAGREB",140534,140534,0
2018,"WESTERN EUROPE-EU","CROATIA","LUTON","DUBROVNIK",21951,21951,0
2018,"WESTERN EUROPE-EU","CROATIA","LUTON","SPLIT",87825,87825,0
2018,"WESTERN EUROPE-EU","CROATIA","LUTON","ZADAR",14770,14770,0
2018,"WESTERN EUROPE-EU","CROATIA","SOUTHEND","DUBROVNIK",15553,15553,0
2018,"WESTERN EUROPE-EU","CROATIA","SOUTHEND","PULA",7209,7209,0
2018,"WESTERN EUROPE-EU","CROATIA","SOUTHEND","ZADAR",3894,3894,0
2018,"WESTERN EUROPE-EU","CROATIA","STANSTED","DUBROVNIK",84188,84188,0
2018,"WESTERN EUROPE-EU","CROATIA","STANSTED","PULA",34895,34895,0
2018,"WESTERN EUROPE-EU","CROATIA","STANSTED","RIJEKA",6042,6042,0
2018,"WESTERN EUROPE-EU","CROATIA","STANSTED","SPLIT",44179,44179,0
2018,"WESTERN EUROPE-EU","CROATIA","STANSTED","ZADAR",37323,32364,4959
2018,"WESTERN EUROPE-EU","CYPRUS","GATWICK","LARNACA",320533,265973,54560
2018,"WESTERN EUROPE-EU","CYPRUS","GATWICK","PAPHOS",378912,283680,95232
2018,"WESTERN EUROPE-EU","CYPRUS","HEATHROW","LARNACA",273464,273464,0
2018,"WESTERN EUROPE-EU","CYPRUS","LUTON","LARNACA",160499,152254,8245
2018,"WESTERN EUROPE-EU","CYPRUS","LUTON","PAPHOS",107456,82473,24983
2018,"WESTERN EUROPE-EU","CYPRUS","STANSTED","LARNACA",91852,82363,9489
2018,"WESTERN EUROPE-EU","CYPRUS","STANSTED","PAPHOS",228079,197854,30225
2018,"WESTERN EUROPE-EU","DENMARK","GATWICK","AALBORG",31405,31405,0
2018,"WESTERN EUROPE-EU","DENMARK","GATWICK","AARHUS (TIRSTRUP)",3452,3452,0
2018,"WESTERN EUROPE-EU","DENMARK","GATWICK","BILLUND",0,0,0
2018,"WESTERN EUROPE-EU","DENMARK","GATWICK","COPENHAGEN",798591,798464,127
2018,"WESTERN EUROPE-EU","DENMARK","GATWICK","RONNE",7,0,7
2018,"WESTERN EUROPE-EU","DENMARK","HEATHROW","BILLUND",125046,125046,0
2018,"WESTERN EUROPE-EU","DENMARK","HEATHROW","COPENHAGEN",1012730,1012730,0
2018,"WESTERN EUROPE-EU","DENMARK","LONDON CITY","BILLUND",18730,18730,0
2018,"WESTERN EUROPE-EU","DENMARK","LUTON","BILLUND",168,168,0
2018,"WESTERN EUROPE-EU","DENMARK","LUTON","COPENHAGEN",123412,123412,0
2018,"WESTERN EUROPE-EU","DENMARK","LUTON","KARUP",84,0,84
2018,"WESTERN EUROPE-EU","DENMARK","SOUTHEND","BILLUND",24,24,0
2018,"WESTERN EUROPE-EU","DENMARK","STANSTED","AALBORG",54734,54734,0
2018,"WESTERN EUROPE-EU","DENMARK","STANSTED","AARHUS (TIRSTRUP)",103089,103089,0
2018,"WESTERN EUROPE-EU","DENMARK","STANSTED","BILLUND",212578,212375,203
2018,"WESTERN EUROPE-EU","DENMARK","STANSTED","COPENHAGEN",339888,339606,282
2018,"WESTERN EUROPE-EU","FINLAND","GATWICK","ENONTEKIO",3676,0,3676
2018,"WESTERN EUROPE-EU","FINLAND","GATWICK","HELSINKI",230541,230541,0
2018,"WESTERN EUROPE-EU","FINLAND","GATWICK","IVALO",15817,6035,9782
2018,"WESTERN EUROPE-EU","FINLAND","GATWICK","KITTILA",23486,4828,18658
2018,"WESTERN EUROPE-EU","FINLAND","GATWICK","KUUSAMO",5708,0,5708
2018,"WESTERN EUROPE-EU","FINLAND","GATWICK","ROVANIEMI",39418,27792,11626
2018,"WESTERN EUROPE-EU","FINLAND","HEATHROW","HELSINKI",774505,774505,0
2018,"WESTERN EUROPE-EU","FINLAND","LUTON","IVALO",1337,715,622
2018,"WESTERN EUROPE-EU","FINLAND","LUTON","SEINAJOKI",0,0,0
2018,"WESTERN EUROPE-EU","FINLAND","STANSTED","ENONTEKIO",1454,0,1454
2018,"WESTERN EUROPE-EU","FINLAND","STANSTED","IVALO",2016,0,2016
2018,"WESTERN EUROPE-EU","FINLAND","STANSTED","KITTILA",964,0,964
2018,"WESTERN EUROPE-EU","FINLAND","STANSTED","ROVANIEMI",362,0,362
2018,"WESTERN EUROPE-EU","FINLAND","STANSTED","TAMPERE",0,0,0
2018,"WESTERN EUROPE-EU","FRANCE","GATWICK","AJACCIO",6418,6418,0
2018,"WESTERN EUROPE-EU","FRANCE","GATWICK","BASTIA",10653,10653,0
2018,"WESTERN EUROPE-EU","FRANCE","GATWICK","BIARRITZ",29728,29728,0
2018,"WESTERN EUROPE-EU","FRANCE","GATWICK","BORDEAUX",311909,311858,51
2018,"WESTERN EUROPE-EU","FRANCE","GATWICK","CANNES",0,0,0
2018,"WESTERN EUROPE-EU","FRANCE","GATWICK","CHAMBERY",46837,186,46651
2018,"WESTERN EUROPE-EU","FRANCE","GATWICK","CHATEAUROUX DEOLS",0,0,0
2018,"WESTERN EUROPE-EU","FRANCE","GATWICK","FIGARI",7704,7704,0
2018,"WESTERN EUROPE-EU","FRANCE","GATWICK","GRENOBLE",129111,43165,85946
2018,"WESTERN EUROPE-EU","FRANCE","GATWICK","LA ROCHELLE",28868,28868,0
2018,"WESTERN EUROPE-EU","FRANCE","GATWICK","LIMOGES",11695,11695,0
2018,"WESTERN EUROPE-EU","FRANCE","GATWICK","LYON",227985,212654,15331
2018,"WESTERN EUROPE-EU","FRANCE","GATWICK","MARSEILLE",149228,148880,348
2018,"WESTERN EUROPE-EU","FRANCE","GATWICK","MONTPELLIER",145756,145756,0
2018,"WESTERN EUROPE-EU","FRANCE","GATWICK","NANTES",167694,167656,38
2018,"WESTERN EUROPE-EU","FRANCE","GATWICK","NICE",620834,619189,1645
2018,"WESTERN EUROPE-EU","FRANCE","GATWICK","NIMES",0,0,0
2018,"WESTERN EUROPE-EU","FRANCE","GATWICK","PARIS (CHARLES DE GAULLE)",486072,486072,0
2018,"WESTERN EUROPE-EU","FRANCE","GATWICK","PARIS (ORLY)",105,105,0
2018,"WESTERN EUROPE-EU","FRANCE","GATWICK","RENNES",782,782,0
2018,"WESTERN EUROPE-EU","FRANCE","GATWICK","TARBES-LOURDES INTERNATIONAL",0,0,0
2018,"WESTERN EUROPE-EU","FRANCE","GATWICK","TOULOUSE (BLAGNAC)",271680,265592,6088
2018,"WESTERN EUROPE-EU","FRANCE","HEATHROW","BASTIA",4385,0,4385
2018,"WESTERN EUROPE-EU","FRANCE","HEATHROW","BIARRITZ",0,0,0
2018,"WESTERN EUROPE-EU","FRANCE","HEATHROW","FIGARI",8858,4134,4724
2018,"WESTERN EUROPE-EU","FRANCE","HEATHROW","GRENOBLE",8156,4209,3947
2018,"WESTERN EUROPE-EU","FRANCE","HEATHROW","LYON",267813,267813,0
2018,"WESTERN EUROPE-EU","FRANCE","HEATHROW","MARSEILLE",263324,263324,0
2018,"WESTERN EUROPE-EU","FRANCE","HEATHROW","MONTPELLIER",0,0,0
2018,"WESTERN EUROPE-EU","FRANCE","HEATHROW","NANTES",9153,9153,0
2018,"WESTERN EUROPE-EU","FRANCE","HEATHROW","NICE",553540,553540,0
2018,"WESTERN EUROPE-EU","FRANCE","HEATHROW","PARIS (CHARLES DE GAULLE)",1250771,1250771,0
2018,"WESTERN EUROPE-EU","FRANCE","HEATHROW","PARIS (ORLY)",176,176,0
2018,"WESTERN EUROPE-EU","FRANCE","HEATHROW","TOULOUSE (BLAGNAC)",249444,249444,0
2018,"WESTERN EUROPE-EU","FRANCE","LONDON CITY","AVIGNON",0,0,0
2018,"WESTERN EUROPE-EU","FRANCE","LONDON CITY","BERGERAC",10015,10015,0
2018,"WESTERN EUROPE-EU","FRANCE","LONDON CITY","CHAMBERY",5382,5382,0
2018,"WESTERN EUROPE-EU","FRANCE","LONDON CITY","DINARD",159,0,159
2018,"WESTERN EUROPE-EU","FRANCE","LONDON CITY","LILLE",0,0,0
2018,"WESTERN EUROPE-EU","FRANCE","LONDON CITY","NANTES",0,0,0
2018,"WESTERN EUROPE-EU","FRANCE","LONDON CITY","NICE",39797,39797,0
2018,"WESTERN EUROPE-EU","FRANCE","LONDON CITY","PARIS (CHARLES DE GAULLE)",0,0,0
2018,"WESTERN EUROPE-EU","FRANCE","LONDON CITY","PARIS (ORLY)",95447,95447,0
2018,"WESTERN EUROPE-EU","FRANCE","LONDON CITY","QUIMPER",6846,6846,0
2018,"WESTERN EUROPE-EU","FRANCE","LONDON CITY","RENNES",2590,2590,0
2018,"WESTERN EUROPE-EU","FRANCE","LONDON CITY","TOULON / HYERES",0,0,0
2018,"WESTERN EUROPE-EU","FRANCE","LUTON","BEZIERS",40534,40534,0
2018,"WESTERN EUROPE-EU","FRANCE","LUTON","BIARRITZ",5101,5101,0
2018,"WESTERN EUROPE-EU","FRANCE","LUTON","BORDEAUX",89352,89352,0
2018,"WESTERN EUROPE-EU","FRANCE","LUTON","BREST",0,0,0
2018,"WESTERN EUROPE-EU","FRANCE","LUTON","CARCASSONNE",0,0,0
2018,"WESTERN EUROPE-EU","FRANCE","LUTON","CHAMBERY",4320,0,4320
2018,"WESTERN EUROPE-EU","FRANCE","LUTON","CLERMONT FERRAND",0,0,0
2018,"WESTERN EUROPE-EU","FRANCE","LUTON","GRENOBLE",10969,10685,284
2018,"WESTERN EUROPE-EU","FRANCE","LUTON","LA ROCHELLE",92,92,0
2018,"WESTERN EUROPE-EU","FRANCE","LUTON","LILLE",0,0,0
2018,"WESTERN EUROPE-EU","FRANCE","LUTON","LYON",96452,96159,293
2018,"WESTERN EUROPE-EU","FRANCE","LUTON","MARSEILLE",43327,43327,0
2018,"WESTERN EUROPE-EU","FRANCE","LUTON","MONTPELLIER",11595,11595,0
2018,"WESTERN EUROPE-EU","FRANCE","LUTON","NANTES",51757,51757,0
2018,"WESTERN EUROPE-EU","FRANCE","LUTON","NICE",168171,167440,731
2018,"WESTERN EUROPE-EU","FRANCE","LUTON","NIMES",35318,35318,0
2018,"WESTERN EUROPE-EU","FRANCE","LUTON","PARIS (CHARLES DE GAULLE)",291331,291331,0
2018,"WESTERN EUROPE-EU","FRANCE","LUTON","PARIS (LE BOURGET)",0,0,0
2018,"WESTERN EUROPE-EU","FRANCE","LUTON","PARIS (ORLY)",0,0,0
2018,"WESTERN EUROPE-EU","FRANCE","LUTON","PERPIGNAN",579,152,427
2018,"WESTERN EUROPE-EU","FRANCE","LUTON","STRASBOURG",0,0,0
2018,"WESTERN EUROPE-EU","FRANCE","LUTON","TARBES-LOURDES INTERNATIONAL",278,0,278
2018,"WESTERN EUROPE-EU","FRANCE","LUTON","TOULOUSE (BLAGNAC)",55351,55351,0
2018,"WESTERN EUROPE-EU","FRANCE","SOUTHEND","BASTIA",0,0,0
2018,"WESTERN EUROPE-EU","FRANCE","SOUTHEND","BORDEAUX",8256,8256,0
2018,"WESTERN EUROPE-EU","FRANCE","SOUTHEND","CAEN",13420,13420,0
2018,"WESTERN EUROPE-EU","FRANCE","SOUTHEND","CHATEAUROUX DEOLS",1022,1022,0
2018,"WESTERN EUROPE-EU","FRANCE","SOUTHEND","LYON",31409,31409,0
2018,"WESTERN EUROPE-EU","FRANCE","SOUTHEND","NANTES",0,0,0
2018,"WESTERN EUROPE-EU","FRANCE","SOUTHEND","NICE",0,0,0
2018,"WESTERN EUROPE-EU","FRANCE","SOUTHEND","PARIS (CHARLES DE GAULLE)",51862,51862,0
2018,"WESTERN EUROPE-EU","FRANCE","SOUTHEND","PARIS (ORLY)",44,44,0
2018,"WESTERN EUROPE-EU","FRANCE","SOUTHEND","PERPIGNAN",0,0,0
2018,"WESTERN EUROPE-EU","FRANCE","SOUTHEND","RENNES",46046,46046,0
2018,"WESTERN EUROPE-EU","FRANCE","SOUTHEND","TOULON / HYERES",0,0,0
2018,"WESTERN EUROPE-EU","FRANCE","STANSTED","AJACCIO",20232,20232,0
2018,"WESTERN EUROPE-EU","FRANCE","STANSTED","BASTIA",20860,20860,0
2018,"WESTERN EUROPE-EU","FRANCE","STANSTED","BERGERAC",92068,92068,0
2018,"WESTERN EUROPE-EU","FRANCE","STANSTED","BEZIERS",28922,28922,0
2018,"WESTERN EUROPE-EU","FRANCE","STANSTED","BIARRITZ",107321,107321,0
2018,"WESTERN EUROPE-EU","FRANCE","STANSTED","BORDEAUX",94623,94623,0
2018,"WESTERN EUROPE-EU","FRANCE","STANSTED","BREST",193,193,0
2018,"WESTERN EUROPE-EU","FRANCE","STANSTED","BRIVE-LA-GAILLARDE",17833,17833,0
2018,"WESTERN EUROPE-EU","FRANCE","STANSTED","CALVI",3471,0,3471
2018,"WESTERN EUROPE-EU","FRANCE","STANSTED","CARCASSONNE",89186,89186,0
2018,"WESTERN EUROPE-EU","FRANCE","STANSTED","CHAMBERY",20513,5309,15204
2018,"WESTERN EUROPE-EU","FRANCE","STANSTED","CLERMONT FERRAND",20208,20208,0
2018,"WESTERN EUROPE-EU","FRANCE","STANSTED","DEAUVILLE",0,0,0
2018,"WESTERN EUROPE-EU","FRANCE","STANSTED","DINARD",76245,76245,0
2018,"WESTERN EUROPE-EU","FRANCE","STANSTED","DOLE",703,703,0
2018,"WESTERN EUROPE-EU","FRANCE","STANSTED","FIGARI",5857,5857,0
2018,"WESTERN EUROPE-EU","FRANCE","STANSTED","GRENOBLE",53467,52071,1396
2018,"WESTERN EUROPE-EU","FRANCE","STANSTED","LA ROCHELLE",62254,62254,0
2018,"WESTERN EUROPE-EU","FRANCE","STANSTED","LIMOGES",99761,99761,0
2018,"WESTERN EUROPE-EU","FRANCE","STANSTED","LORIENT",0,0,0
2018,"WESTERN EUROPE-EU","FRANCE","STANSTED","LYON",8041,6159,1882
2018,"WESTERN EUROPE-EU","FRANCE","STANSTED","MARSEILLE",158505,158505,0
2018,"WESTERN EUROPE-EU","FRANCE","STANSTED","NANTES",14946,14946,0
2018,"WESTERN EUROPE-EU","FRANCE","STANSTED","NICE",223418,223418,0
2018,"WESTERN EUROPE-EU","FRANCE","STANSTED","NIMES",44731,44731,0
2018,"WESTERN EUROPE-EU","FRANCE","STANSTED","PARIS (CHARLES DE GAULLE)",0,0,0
2018,"WESTERN EUROPE-EU","FRANCE","STANSTED","PARIS (ORLY)",257,257,0
2018,"WESTERN EUROPE-EU","FRANCE","STANSTED","PAU",167,167,0
2018,"WESTERN EUROPE-EU","FRANCE","STANSTED","PERPIGNAN",48240,48240,0
2018,"WESTERN EUROPE-EU","FRANCE","STANSTED","POITIERS",56925,56925,0
2018,"WESTERN EUROPE-EU","FRANCE","STANSTED","QUIMPER",0,0,0
2018,"WESTERN EUROPE-EU","FRANCE","STANSTED","RENNES",180,180,0
2018,"WESTERN EUROPE-EU","FRANCE","STANSTED","STRASBOURG",18618,18618,0
2018,"WESTERN EUROPE-EU","FRANCE","STANSTED","TARBES-LOURDES INTERNATIONAL",63057,55625,7432
2018,"WESTERN EUROPE-EU","FRANCE","STANSTED","TOULON / HYERES",245,0,245
2018,"WESTERN EUROPE-EU","FRANCE","STANSTED","TOULOUSE (BLAGNAC)",201713,201713,0
2018,"WESTERN EUROPE-EU","FRANCE","STANSTED","TOURS",50037,50037,0
2018,"WESTERN EUROPE-EU","GERMANY","GATWICK","BERLIN (SCHONEFELD)",290056,290056,0
2018,"WESTERN EUROPE-EU","GERMANY","GATWICK","BERLIN (TEGEL)",173730,173730,0
2018,"WESTERN EUROPE-EU","GERMANY","GATWICK","BRAUNSCHWEIG",39,0,39
2018,"WESTERN EUROPE-EU","GERMANY","GATWICK","COLOGNE BONN",6821,6821,0
2018,"WESTERN EUROPE-EU","GERMANY","GATWICK","DRESDEN",0,0,0
2018,"WESTERN EUROPE-EU","GERMANY","GATWICK","DUSSELDORF",37,0,37
2018,"WESTERN EUROPE-EU","GERMANY","GATWICK","ERFURT",0,0,0
2018,"WESTERN EUROPE-EU","GERMANY","GATWICK","FRANKFURT MAIN",361,172,189
2018,"WESTERN EUROPE-EU","GERMANY","GATWICK","FRIEDRICHSHAFEN",23513,14642,8871
2018,"WESTERN EUROPE-EU","GERMANY","GATWICK","HAMBURG",167827,167827,0
2018,"WESTERN EUROPE-EU","GERMANY","GATWICK","LEIPZIG",0,0,0
2018,"WESTERN EUROPE-EU","GERMANY","GATWICK","MUNICH",250777,250777,0
2018,"WESTERN EUROPE-EU","GERMANY","GATWICK","MUNSTER-OSNABRUCK",0,0,0
2018,"WESTERN EUROPE-EU","GERMANY","GATWICK","NUREMBERG",7735,7735,0
2018,"WESTERN EUROPE-EU","GERMANY","GATWICK","ROSTOCK-LAAGE",0,0,0
2018,"WESTERN EUROPE-EU","GERMANY","GATWICK","STUTTGART",125629,125629,0
2018,"WESTERN EUROPE-EU","GERMANY","HEATHROW","BERLIN (TEGEL)",817252,817252,0
2018,"WESTERN EUROPE-EU","GERMANY","HEATHROW","COLOGNE BONN",193790,193790,0
2018,"WESTERN EUROPE-EU","GERMANY","HEATHROW","DUSSELDORF",737313,737313,0
2018,"WESTERN EUROPE-EU","GERMANY","HEATHROW","FRANKFURT MAIN",1559218,1559218,0
2018,"WESTERN EUROPE-EU","GERMANY","HEATHROW","FRIEDRICHSHAFEN",604,0,604
2018,"WESTERN EUROPE-EU","GERMANY","HEATHROW","HAMBURG",600913,600913,0
2018,"WESTERN EUROPE-EU","GERMANY","HEATHROW","HANOVER",213722,213722,0
2018,"WESTERN EUROPE-EU","GERMANY","HEATHROW","MUNICH",1242063,1242063,0
2018,"WESTERN EUROPE-EU","GERMANY","HEATHROW","STUTTGART",343928,343928,0
2018,"WESTERN EUROPE-EU","GERMANY","LONDON CITY","BERLIN (TEGEL)",122062,122062,0
2018,"WESTERN EUROPE-EU","GERMANY","LONDON CITY","BREMEN",0,0,0
2018,"WESTERN EUROPE-EU","GERMANY","LONDON CITY","DUSSELDORF",160406,160406,0
2018,"WESTERN EUROPE-EU","GERMANY","LONDON CITY","FRANKFURT MAIN",249937,249937,0
2018,"WESTERN EUROPE-EU","GERMANY","LONDON CITY","HAMBURG",0,0,0
2018,"WESTERN EUROPE-EU","GERMANY","LONDON CITY","MUNSTER-OSNABRUCK",0,0,0
2018,"WESTERN EUROPE-EU","GERMANY","LONDON CITY","SAARBRUCKEN",67,67,0
2018,"WESTERN EUROPE-EU","GERMANY","LUTON","BERLIN (SCHONEFELD)",179320,179320,0
2018,"WESTERN EUROPE-EU","GERMANY","LUTON","BERLIN (TEGEL)",461,461,0
2018,"WESTERN EUROPE-EU","GERMANY","LUTON","COLOGNE BONN",874,874,0
2018,"WESTERN EUROPE-EU","GERMANY","LUTON","DORTMUND",101750,101750,0
2018,"WESTERN EUROPE-EU","GERMANY","LUTON","DRESDEN",149,0,149
2018,"WESTERN EUROPE-EU","GERMANY","LUTON","FRANKFURT MAIN",217,0,217
2018,"WESTERN EUROPE-EU","GERMANY","LUTON","HAMBURG",12556,12556,0
2018,"WESTERN EUROPE-EU","GERMANY","LUTON","HANOVER",0,0,0
2018,"WESTERN EUROPE-EU","GERMANY","LUTON","LEIPZIG",193,193,0
2018,"WESTERN EUROPE-EU","GERMANY","LUTON","MEMMINGEN ALLGAU",0,0,0
2018,"WESTERN EUROPE-EU","GERMANY","LUTON","MUNICH",80873,80873,0
2018,"WESTERN EUROPE-EU","GERMANY","LUTON","MUNSTER-OSNABRUCK",223,223,0
2018,"WESTERN EUROPE-EU","GERMANY","LUTON","NIEDERRHEIN",175,175,0
2018,"WESTERN EUROPE-EU","GERMANY","LUTON","STUTTGART",0,0,0
2018,"WESTERN EUROPE-EU","GERMANY","SOUTHEND","BREMEN",0,0,0
2018,"WESTERN EUROPE-EU","GERMANY","SOUTHEND","COLOGNE BONN",30518,30518,0
2018,"WESTERN EUROPE-EU","GERMANY","SOUTHEND","DUSSELDORF",57,57,0
2018,"WESTERN EUROPE-EU","GERMANY","SOUTHEND","FRANKFURT MAIN",0,0,0
2018,"WESTERN EUROPE-EU","GERMANY","SOUTHEND","HAMBURG",0,0,0
2018,"WESTERN EUROPE-EU","GERMANY","SOUTHEND","PADERBORN",247,247,0
2018,"WESTERN EUROPE-EU","GERMANY","STANSTED","BERLIN (SCHONEFELD)",453167,453000,167
2018,"WESTERN EUROPE-EU","GERMANY","STANSTED","BERLIN (TEGEL)",7248,7152,96
2018,"WESTERN EUROPE-EU","GERMANY","STANSTED","BRAUNSCHWEIG",0,0,0
2018,"WESTERN EUROPE-EU","GERMANY","STANSTED","BREMEN",186731,186731,0
2018,"WESTERN EUROPE-EU","GERMANY","STANSTED","COLOGNE BONN",438037,437498,539
2018,"WESTERN EUROPE-EU","GERMANY","STANSTED","DORTMUND",118369,118302,67
2018,"WESTERN EUROPE-EU","GERMANY","STANSTED","DUSSELDORF",0,0,0
2018,"WESTERN EUROPE-EU","GERMANY","STANSTED","FRANKFURT MAIN",229780,229780,0
2018,"WESTERN EUROPE-EU","GERMANY","STANSTED","FRIEDRICHSHAFEN",160,160,0
2018,"WESTERN EUROPE-EU","GERMANY","STANSTED","HAHN",106260,106260,0
2018,"WESTERN EUROPE-EU","GERMANY","STANSTED","HAMBURG",199345,199345,0
2018,"WESTERN EUROPE-EU","GERMANY","STANSTED","HANOVER",74475,74475,0
2018,"WESTERN EUROPE-EU","GERMANY","STANSTED","KARLSRUHE/BADEN BADEN",127567,127567,0
2018,"WESTERN EUROPE-EU","GERMANY","STANSTED","LEIPZIG",48006,48006,0
2018,"WESTERN EUROPE-EU","GERMANY","STANSTED","MEMMINGEN ALLGAU",88960,88960,0
2018,"WESTERN EUROPE-EU","GERMANY","STANSTED","MUNICH",169474,168536,938
2018,"WESTERN EUROPE-EU","GERMANY","STANSTED","MUNSTER-OSNABRUCK",0,0,0
2018,"WESTERN EUROPE-EU","GERMANY","STANSTED","NIEDERRHEIN",42246,42246,0
2018,"WESTERN EUROPE-EU","GERMANY","STANSTED","NUREMBERG",192367,192367,0
2018,"WESTERN EUROPE-EU","GERMANY","STANSTED","STUTTGART",16508,16508,0
2018,"WESTERN EUROPE-EU","GIBRALTAR","GATWICK","GIBRALTAR",188144,187989,155
2018,"WESTERN EUROPE-EU","GIBRALTAR","HEATHROW","GIBRALTAR",152710,152710,0
2018,"WESTERN EUROPE-EU","GIBRALTAR","LUTON","GIBRALTAR",2120,2120,0
2018,"WESTERN EUROPE-EU","GREECE","GATWICK","ATHENS",202016,202016,0
2018,"WESTERN EUROPE-EU","GREECE","GATWICK","CHANIA",126705,87312,39393
2018,"WESTERN EUROPE-EU","GREECE","GATWICK","CORFU",233799,172869,60930
2018,"WESTERN EUROPE-EU","GREECE","GATWICK","HERAKLION",274029,224006,50023
2018,"WESTERN EUROPE-EU","GREECE","GATWICK","KALAMATA",37857,37857,0
2018,"WESTERN EUROPE-EU","GREECE","GATWICK","KAVALA",32898,19431,13467
2018,"WESTERN EUROPE-EU","GREECE","GATWICK","KEFALLINIA",126441,95723,30718
2018,"WESTERN EUROPE-EU","GREECE","GATWICK","KOS",124297,58784,65513
2018,"WESTERN EUROPE-EU","GREECE","GATWICK","LEMNOS",1065,0,1065
2018,"WESTERN EUROPE-EU","GREECE","GATWICK","MIKONOS",87815,87815,0
2018,"WESTERN EUROPE-EU","GREECE","GATWICK","MYTILINI",9244,9244,0
2018,"WESTERN EUROPE-EU","GREECE","GATWICK","PREVEZA",74887,39219,35668
2018,"WESTERN EUROPE-EU","GREECE","GATWICK","RHODES",192095,132033,60062
2018,"WESTERN EUROPE-EU","GREECE","GATWICK","SALONIKA",165304,146739,18565
2018,"WESTERN EUROPE-EU","GREECE","GATWICK","SAMOS",10219,0,10219
2018,"WESTERN EUROPE-EU","GREECE","GATWICK","SKIATHOS",46281,26139,20142
2018,"WESTERN EUROPE-EU","GREECE","GATWICK","THIRA (SANTORINI)",118106,108306,9800
2018,"WESTERN EUROPE-EU","GREECE","GATWICK","VOLOS NEA ANCHILOS",7806,6237,1569
2018,"WESTERN EUROPE-EU","GREECE","GATWICK","ZAKINTHOS",145669,102997,42672
2018,"WESTERN EUROPE-EU","GREECE","HEATHROW","ATHENS",753589,753589,0
2018,"WESTERN EUROPE-EU","GREECE","HEATHROW","CHANIA",13449,13449,0
2018,"WESTERN EUROPE-EU","GREECE","HEATHROW","CORFU",65992,60958,5034
2018,"WESTERN EUROPE-EU","GREECE","HEATHROW","KALAMATA",23157,13165,9992
2018,"WESTERN EUROPE-EU","GREECE","HEATHROW","KEFALLINIA",16194,11189,5005
2018,"WESTERN EUROPE-EU","GREECE","HEATHROW","KOS",2260,0,2260
2018,"WESTERN EUROPE-EU","GREECE","HEATHROW","LEMNOS",15361,0,15361
2018,"WESTERN EUROPE-EU","GREECE","HEATHROW","MIKONOS",36840,36840,0
2018,"WESTERN EUROPE-EU","GREECE","HEATHROW","PREVEZA",17354,208,17146
2018,"WESTERN EUROPE-EU","GREECE","HEATHROW","RHODES",11192,0,11192
2018,"WESTERN EUROPE-EU","GREECE","HEATHROW","THIRA (SANTORINI)",35393,35393,0
2018,"WESTERN EUROPE-EU","GREECE","HEATHROW","ZAKINTHOS",10096,10096,0
2018,"WESTERN EUROPE-EU","GREECE","LONDON CITY","MIKONOS",8314,8314,0
2018,"WESTERN EUROPE-EU","GREECE","LONDON CITY","SKIATHOS",3961,3961,0
2018,"WESTERN EUROPE-EU","GREECE","LONDON CITY","THIRA (SANTORINI)",3268,3268,0
2018,"WESTERN EUROPE-EU","GREECE","LUTON","ATHENS",99859,99859,0
2018,"WESTERN EUROPE-EU","GREECE","LUTON","CHANIA",169,169,0
2018,"WESTERN EUROPE-EU","GREECE","LUTON","CORFU",67662,58139,9523
2018,"WESTERN EUROPE-EU","GREECE","LUTON","HERAKLION",32740,32740,0
2018,"WESTERN EUROPE-EU","GREECE","LUTON","KALAMATA",0,0,0
2018,"WESTERN EUROPE-EU","GREECE","LUTON","KAVALA",0,0,0
2018,"WESTERN EUROPE-EU","GREECE","LUTON","KEFALLINIA",6813,0,6813
2018,"WESTERN EUROPE-EU","GREECE","LUTON","MIKONOS",17758,17758,0
2018,"WESTERN EUROPE-EU","GREECE","LUTON","RHODES",37972,18025,19947
2018,"WESTERN EUROPE-EU","GREECE","LUTON","SALONIKA",9026,9026,0
2018,"WESTERN EUROPE-EU","GREECE","LUTON","SKIATHOS",8018,0,8018
2018,"WESTERN EUROPE-EU","GREECE","LUTON","ZAKINTHOS",10786,0,10786
2018,"WESTERN EUROPE-EU","GREECE","SOUTHEND","RHODES",0,0,0
2018,"WESTERN EUROPE-EU","GREECE","STANSTED","ATHENS",209683,209683,0
2018,"WESTERN EUROPE-EU","GREECE","STANSTED","CHANIA",31553,31553,0
2018,"WESTERN EUROPE-EU","GREECE","STANSTED","CORFU",86222,70930,15292
2018,"WESTERN EUROPE-EU","GREECE","STANSTED","HERAKLION",57580,41609,15971
2018,"WESTERN EUROPE-EU","GREECE","STANSTED","KAVALA",182,182,0
2018,"WESTERN EUROPE-EU","GREECE","STANSTED","KEFALLINIA",48874,40405,8469
2018,"WESTERN EUROPE-EU","GREECE","STANSTED","KOS",42626,33848,8778
2018,"WESTERN EUROPE-EU","GREECE","STANSTED","MIKONOS",0,0,0
2018,"WESTERN EUROPE-EU","GREECE","STANSTED","PREVEZA",5780,0,5780
2018,"WESTERN EUROPE-EU","GREECE","STANSTED","RHODES",95025,77542,17483
2018,"WESTERN EUROPE-EU","GREECE","STANSTED","SALONIKA",128837,128837,0
2018,"WESTERN EUROPE-EU","GREECE","STANSTED","SKIATHOS",8477,8477,0
2018,"WESTERN EUROPE-EU","GREECE","STANSTED","ZAKINTHOS",78162,70380,7782
2018,"WESTERN EUROPE-EU","IRISH REPUBLIC","GATWICK","CORK",122810,122810,0
2018,"WESTERN EUROPE-EU","IRISH REPUBLIC","GATWICK","DUBLIN",1347017,1346905,112
2018,"WESTERN EUROPE-EU","IRISH REPUBLIC","GATWICK","IRELAND WEST(KNOCK)",83636,83636,0
2018,"WESTERN EUROPE-EU","IRISH REPUBLIC","GATWICK","SHANNON",115697,115695,2
2018,"WESTERN EUROPE-EU","IRISH REPUBLIC","HEATHROW","CORK",403542,403542,0
2018,"WESTERN EUROPE-EU","IRISH REPUBLIC","HEATHROW","DUBLIN",1809396,1809396,0
2018,"WESTERN EUROPE-EU","IRISH REPUBLIC","HEATHROW","SHANNON",274143,274143,0
2018,"WESTERN EUROPE-EU","IRISH REPUBLIC","LONDON CITY","CORK",0,0,0
2018,"WESTERN EUROPE-EU","IRISH REPUBLIC","LONDON CITY","DUBLIN",484467,484406,61
2018,"WESTERN EUROPE-EU","IRISH REPUBLIC","LONDON CITY","SHANNON",44,0,44
2018,"WESTERN EUROPE-EU","IRISH REPUBLIC","LUTON","CORK",13253,13253,0
2018,"WESTERN EUROPE-EU","IRISH REPUBLIC","LUTON","DUBLIN",356814,356814,0
2018,"WESTERN EUROPE-EU","IRISH REPUBLIC","LUTON","IRELAND WEST(KNOCK)",134530,134530,0
2018,"WESTERN EUROPE-EU","IRISH REPUBLIC","LUTON","KERRY COUNTY",112148,112148,0
2018,"WESTERN EUROPE-EU","IRISH REPUBLIC","LUTON","SHANNON",90,90,0
2018,"WESTERN EUROPE-EU","IRISH REPUBLIC","SOUTHEND","DUBLIN",122214,122214,0
2018,"WESTERN EUROPE-EU","IRISH REPUBLIC","STANSTED","CORK",347080,347080,0
2018,"WESTERN EUROPE-EU","IRISH REPUBLIC","STANSTED","DUBLIN",898295,898295,0
2018,"WESTERN EUROPE-EU","IRISH REPUBLIC","STANSTED","IRELAND WEST(KNOCK)",158349,158349,0
2018,"WESTERN EUROPE-EU","IRISH REPUBLIC","STANSTED","KERRY COUNTY",81186,81186,0
2018,"WESTERN EUROPE-EU","IRISH REPUBLIC","STANSTED","SHANNON",201589,201459,130
2018,"WESTERN EUROPE-EU","ITALY","GATWICK","ALGHERO (FERTILIA)",8440,0,8440
2018,"WESTERN EUROPE-EU","ITALY","GATWICK","ANCONA",6176,6176,0
2018,"WESTERN EUROPE-EU","ITALY","GATWICK","BARI (PALESE)",92968,92968,0
2018,"WESTERN EUROPE-EU","ITALY","GATWICK","BERGAMO",0,0,0
2018,"WESTERN EUROPE-EU","ITALY","GATWICK","BOLOGNA",97239,97239,0
2018,"WESTERN EUROPE-EU","ITALY","GATWICK","BRINDISI",17436,17436,0
2018,"WESTERN EUROPE-EU","ITALY","GATWICK","CAGLIARI (ELMAS)",36263,36237,26
2018,"WESTERN EUROPE-EU","ITALY","GATWICK","CATANIA (FONTANAROSSA)",206029,193652,12377
2018,"WESTERN EUROPE-EU","ITALY","GATWICK","FLORENCE",96458,96458,0
2018,"WESTERN EUROPE-EU","ITALY","GATWICK","GENOA",76750,76723,27
2018,"WESTERN EUROPE-EU","ITALY","GATWICK","MILAN (LINATE)",302431,302431,0
2018,"WESTERN EUROPE-EU","ITALY","GATWICK","MILAN (MALPENSA)",577949,577830,119
2018,"WESTERN EUROPE-EU","ITALY","GATWICK","NAPLES",417951,388881,29070
2018,"WESTERN EUROPE-EU","ITALY","GATWICK","OLBIA",103160,94351,8809
2018,"WESTERN EUROPE-EU","ITALY","GATWICK","PALERMO",65170,65170,0
2018,"WESTERN EUROPE-EU","ITALY","GATWICK","PISA",266199,266199,0
2018,"WESTERN EUROPE-EU","ITALY","GATWICK","ROME (FIUMICINO)",695278,691260,4018
2018,"WESTERN EUROPE-EU","ITALY","GATWICK","TREVISO",0,0,0
2018,"WESTERN EUROPE-EU","ITALY","GATWICK","TURIN",183844,160996,22848
2018,"WESTERN EUROPE-EU","ITALY","GATWICK","VENICE",704520,697273,7247
2018,"WESTERN EUROPE-EU","ITALY","GATWICK","VERONA VILLAFRANCA",281950,262190,19760
2018,"WESTERN EUROPE-EU","ITALY","HEATHROW","BOLOGNA",295711,295711,0
2018,"WESTERN EUROPE-EU","ITALY","HEATHROW","BRINDISI",10846,10846,0
2018,"WESTERN EUROPE-EU","ITALY","HEATHROW","CAGLIARI (ELMAS)",7587,0,7587
2018,"WESTERN EUROPE-EU","ITALY","HEATHROW","LAMETIA-TERME",8409,0,8409
2018,"WESTERN EUROPE-EU","ITALY","HEATHROW","MILAN (LINATE)",672959,672959,0
2018,"WESTERN EUROPE-EU","ITALY","HEATHROW","MILAN (MALPENSA)",248131,248131,0
2018,"WESTERN EUROPE-EU","ITALY","HEATHROW","OLBIA",33355,24271,9084
2018,"WESTERN EUROPE-EU","ITALY","HEATHROW","PALERMO",30845,30845,0
2018,"WESTERN EUROPE-EU","ITALY","HEATHROW","PISA",130957,130957,0
2018,"WESTERN EUROPE-EU","ITALY","HEATHROW","ROME (FIUMICINO)",1076489,1073620,2869
2018,"WESTERN EUROPE-EU","ITALY","HEATHROW","TREVISO",455,0,455
2018,"WESTERN EUROPE-EU","ITALY","HEATHROW","TRIESTE (RONCHI DEI LEGIONARI)",0,0,0
2018,"WESTERN EUROPE-EU","ITALY","HEATHROW","TURIN",5550,5550,0
2018,"WESTERN EUROPE-EU","ITALY","HEATHROW","VENICE",200412,199962,450
2018,"WESTERN EUROPE-EU","ITALY","LONDON CITY","BOLOGNA",532,532,0
2018,"WESTERN EUROPE-EU","ITALY","LONDON CITY","FLORENCE",94648,94648,0
2018,"WESTERN EUROPE-EU","ITALY","LONDON CITY","MILAN (LINATE)",362960,362960,0
2018,"WESTERN EUROPE-EU","ITALY","LONDON CITY","MILAN (MALPENSA)",0,0,0
2018,"WESTERN EUROPE-EU","ITALY","LONDON CITY","PISA",138,138,0
2018,"WESTERN EUROPE-EU","ITALY","LONDON CITY","ROME (FIUMICINO)",15043,15043,0
2018,"WESTERN EUROPE-EU","ITALY","LONDON CITY","VENICE",20897,20897,0
2018,"WESTERN EUROPE-EU","ITALY","LUTON","ALGHERO (FERTILIA)",30421,30421,0
2018,"WESTERN EUROPE-EU","ITALY","LUTON","BARI (PALESE)",43630,43630,0
2018,"WESTERN EUROPE-EU","ITALY","LUTON","BERGAMO",0,0,0
2018,"WESTERN EUROPE-EU","ITALY","LUTON","BOLOGNA",20500,20500,0
2018,"WESTERN EUROPE-EU","ITALY","LUTON","CAGLIARI (ELMAS)",0,0,0
2018,"WESTERN EUROPE-EU","ITALY","LUTON","CATANIA (FONTANAROSSA)",57011,57011,0
2018,"WESTERN EUROPE-EU","ITALY","LUTON","FLORENCE",23168,23168,0
2018,"WESTERN EUROPE-EU","ITALY","LUTON","GENOA",19418,19418,0
2018,"WESTERN EUROPE-EU","ITALY","LUTON","LAMETIA-TERME",0,0,0
2018,"WESTERN EUROPE-EU","ITALY","LUTON","MILAN (LINATE)",117,117,0
2018,"WESTERN EUROPE-EU","ITALY","LUTON","MILAN (MALPENSA)",171832,171591,241
2018,"WESTERN EUROPE-EU","ITALY","LUTON","NAPLES",133038,125214,7824
2018,"WESTERN EUROPE-EU","ITALY","LUTON","OLBIA",18305,18305,0
2018,"WESTERN EUROPE-EU","ITALY","LUTON","PALERMO",29270,29270,0
2018,"WESTERN EUROPE-EU","ITALY","LUTON","PISA",95821,95761,60
2018,"WESTERN EUROPE-EU","ITALY","LUTON","ROME (CIAMPINO)",0,0,0
2018,"WESTERN EUROPE-EU","ITALY","LUTON","ROME (FIUMICINO)",123515,123223,292
2018,"WESTERN EUROPE-EU","ITALY","LUTON","SALERNO COSTA AMALFI",0,0,0
2018,"WESTERN EUROPE-EU","ITALY","LUTON","TREVISO",0,0,0
2018,"WESTERN EUROPE-EU","ITALY","LUTON","TURIN",38682,38682,0
2018,"WESTERN EUROPE-EU","ITALY","LUTON","VENICE",96105,96105,0
2018,"WESTERN EUROPE-EU","ITALY","LUTON","VERONA VILLAFRANCA",1779,1411,368
2018,"WESTERN EUROPE-EU","ITALY","SOUTHEND","CAGLIARI (ELMAS)",11514,11514,0
2018,"WESTERN EUROPE-EU","ITALY","SOUTHEND","CATANIA (FONTANAROSSA)",17909,17909,0
2018,"WESTERN EUROPE-EU","ITALY","SOUTHEND","FLORENCE",0,0,0
2018,"WESTERN EUROPE-EU","ITALY","SOUTHEND","MILAN (LINATE)",43,43,0
2018,"WESTERN EUROPE-EU","ITALY","SOUTHEND","MILAN (MALPENSA)",16286,16286,0
2018,"WESTERN EUROPE-EU","ITALY","SOUTHEND","PISA",0,0,0
2018,"WESTERN EUROPE-EU","ITALY","SOUTHEND","VENICE",0,0,0
2018,"WESTERN EUROPE-EU","ITALY","STANSTED","ALGHERO (FERTILIA)",31057,31057,0
2018,"WESTERN EUROPE-EU","ITALY","STANSTED","ANCONA",112199,112199,0
2018,"WESTERN EUROPE-EU","ITALY","STANSTED","BARI (PALESE)",123400,122662,738
2018,"WESTERN EUROPE-EU","ITALY","STANSTED","BERGAMO",476531,476531,0
2018,"WESTERN EUROPE-EU","ITALY","STANSTED","BOLOGNA",222938,222938,0
2018,"WESTERN EUROPE-EU","ITALY","STANSTED","BRINDISI",84402,84402,0
2018,"WESTERN EUROPE-EU","ITALY","STANSTED","CAGLIARI (ELMAS)",131422,131422,0
2018,"WESTERN EUROPE-EU","ITALY","STANSTED","CATANIA (FONTANAROSSA)",0,0,0
2018,"WESTERN EUROPE-EU","ITALY","STANSTED","COMISO",20781,20781,0
2018,"WESTERN EUROPE-EU","ITALY","STANSTED","FLORENCE",7626,7626,0
2018,"WESTERN EUROPE-EU","ITALY","STANSTED","GENOA",82233,82233,0
2018,"WESTERN EUROPE-EU","ITALY","STANSTED","LAMETIA-TERME",61928,61928,0
2018,"WESTERN EUROPE-EU","ITALY","STANSTED","MILAN (LINATE)",11470,11470,0
2018,"WESTERN EUROPE-EU","ITALY","STANSTED","MILAN (MALPENSA)",217422,217366,56
2018,"WESTERN EUROPE-EU","ITALY","STANSTED","NAPLES",319553,319553,0
2018,"WESTERN EUROPE-EU","ITALY","STANSTED","PALERMO",108074,108074,0
2018,"WESTERN EUROPE-EU","ITALY","STANSTED","PERUGIA",96227,96227,0
2018,"WESTERN EUROPE-EU","ITALY","STANSTED","PESCARA",91024,91024,0
2018,"WESTERN EUROPE-EU","ITALY","STANSTED","PISA",308557,308557,0
2018,"WESTERN EUROPE-EU","ITALY","STANSTED","RIMINI",20775,20775,0
2018,"WESTERN EUROPE-EU","ITALY","STANSTED","ROME (CIAMPINO)",622875,622875,0
2018,"WESTERN EUROPE-EU","ITALY","STANSTED","ROME (FIUMICINO)",3050,2066,984
2018,"WESTERN EUROPE-EU","ITALY","STANSTED","TREVISO",320800,320800,0
2018,"WESTERN EUROPE-EU","ITALY","STANSTED","TRIESTE (RONCHI DEI LEGIONARI)",63765,63765,0
2018,"WESTERN EUROPE-EU","ITALY","STANSTED","TURIN",133865,126529,7336
2018,"WESTERN EUROPE-EU","ITALY","STANSTED","VENICE",538,538,0
2018,"WESTERN EUROPE-EU","ITALY","STANSTED","VERONA VILLAFRANCA",84866,84866,0
2018,"WESTERN EUROPE-EU","LUXEMBOURG","GATWICK","LUXEMBOURG",65487,65487,0
2018,"WESTERN EUROPE-EU","LUXEMBOURG","HEATHROW","LUXEMBOURG",168605,168605,0
2018,"WESTERN EUROPE-EU","LUXEMBOURG","LONDON CITY","LUXEMBOURG",184068,184068,0
2018,"WESTERN EUROPE-EU","LUXEMBOURG","LUTON","LUXEMBOURG",192,192,0
2018,"WESTERN EUROPE-EU","LUXEMBOURG","SOUTHEND","LUXEMBOURG",0,0,0
2018,"WESTERN EUROPE-EU","LUXEMBOURG","STANSTED","LUXEMBOURG",108122,108122,0
2018,"WESTERN EUROPE-EU","MALTA","GATWICK","MALTA",395639,368954,26685
2018,"WESTERN EUROPE-EU","MALTA","HEATHROW","MALTA",209863,209863,0
2018,"WESTERN EUROPE-EU","MALTA","LUTON","MALTA",116793,116793,0
2018,"WESTERN EUROPE-EU","MALTA","SOUTHEND","MALTA",58673,58673,0
2018,"WESTERN EUROPE-EU","MALTA","STANSTED","MALTA",110964,110633,331
2018,"WESTERN EUROPE-EU","NETHERLANDS","GATWICK","AMSTERDAM",1085024,1085023,1
2018,"WESTERN EUROPE-EU","NETHERLANDS","GATWICK","ROTTERDAM",0,0,0
2018,"WESTERN EUROPE-EU","NETHERLANDS","HEATHROW","AMSTERDAM",1746528,1746528,0
2018,"WESTERN EUROPE-EU","NETHERLANDS","LONDON CITY","AMSTERDAM",624965,624904,61
2018,"WESTERN EUROPE-EU","NETHERLANDS","LONDON CITY","ROTTERDAM",173208,173208,0
2018,"WESTERN EUROPE-EU","NETHERLANDS","LUTON","AMSTERDAM",808549,808549,0
2018,"WESTERN EUROPE-EU","NETHERLANDS","LUTON","EINDHOVEN",544,0,544
2018,"WESTERN EUROPE-EU","NETHERLANDS","LUTON","MAASTRICHT",63,0,63
2018,"WESTERN EUROPE-EU","NETHERLANDS","LUTON","ROTTERDAM",0,0,0
2018,"WESTERN EUROPE-EU","NETHERLANDS","SOUTHEND","AMSTERDAM",193652,193652,0
2018,"WESTERN EUROPE-EU","NETHERLANDS","SOUTHEND","GRONINGEN",55140,55140,0
2018,"WESTERN EUROPE-EU","NETHERLANDS","SOUTHEND","ROTTERDAM",0,0,0
2018,"WESTERN EUROPE-EU","NETHERLANDS","STANSTED","AMSTERDAM",358127,358127,0
2018,"WESTERN EUROPE-EU","NETHERLANDS","STANSTED","EINDHOVEN",259398,259398,0
2018,"WESTERN EUROPE-EU","NETHERLANDS","STANSTED","GRONINGEN",171,0,171
2018,"WESTERN EUROPE-EU","NETHERLANDS","STANSTED","MAASTRICHT",0,0,0
2018,"WESTERN EUROPE-EU","NETHERLANDS","STANSTED","ROTTERDAM",182,0,182
2018,"WESTERN EUROPE-EU","PORTUGAL(EXCLUDING MADEIRA)","GATWICK","AZORES LAJES TERCEIRA ISLAND",0,0,0
2018,"WESTERN EUROPE-EU","PORTUGAL(EXCLUDING MADEIRA)","GATWICK","AZORES PONTA DELGADA",4516,4516,0
2018,"WESTERN EUROPE-EU","PORTUGAL(EXCLUDING MADEIRA)","GATWICK","FARO",700128,662809,37319
2018,"WESTERN EUROPE-EU","PORTUGAL(EXCLUDING MADEIRA)","GATWICK","LISBON",349181,348545,636
2018,"WESTERN EUROPE-EU","PORTUGAL(EXCLUDING MADEIRA)","GATWICK","OPORTO (PORTUGAL)",364152,364152,0
2018,"WESTERN EUROPE-EU","PORTUGAL(EXCLUDING MADEIRA)","HEATHROW","FARO",32846,32846,0
2018,"WESTERN EUROPE-EU","PORTUGAL(EXCLUDING MADEIRA)","HEATHROW","LISBON",853048,853048,0
2018,"WESTERN EUROPE-EU","PORTUGAL(EXCLUDING MADEIRA)","LONDON CITY","FARO",12186,12186,0
2018,"WESTERN EUROPE-EU","PORTUGAL(EXCLUDING MADEIRA)","LONDON CITY","LISBON",83211,83211,0
2018,"WESTERN EUROPE-EU","PORTUGAL(EXCLUDING MADEIRA)","LONDON CITY","OPORTO (PORTUGAL)",30420,30420,0
2018,"WESTERN EUROPE-EU","PORTUGAL(EXCLUDING MADEIRA)","LUTON","FARO",289729,272353,17376
2018,"WESTERN EUROPE-EU","PORTUGAL(EXCLUDING MADEIRA)","LUTON","LISBON",301094,300923,171
2018,"WESTERN EUROPE-EU","PORTUGAL(EXCLUDING MADEIRA)","LUTON","OPORTO (PORTUGAL)",59302,58440,862
2018,"WESTERN EUROPE-EU","PORTUGAL(EXCLUDING MADEIRA)","SOUTHEND","FARO",95963,95963,0
2018,"WESTERN EUROPE-EU","PORTUGAL(EXCLUDING MADEIRA)","STANSTED","AZORES PONTA DELGADA",17521,17521,0
2018,"WESTERN EUROPE-EU","PORTUGAL(EXCLUDING MADEIRA)","STANSTED","FARO",365274,345085,20189
2018,"WESTERN EUROPE-EU","PORTUGAL(EXCLUDING MADEIRA)","STANSTED","LISBON",365819,365514,305
2018,"WESTERN EUROPE-EU","PORTUGAL(EXCLUDING MADEIRA)","STANSTED","OPORTO (PORTUGAL)",322504,322504,0
2018,"WESTERN EUROPE-EU","PORTUGAL(MADEIRA)","GATWICK","FUNCHAL",264426,234240,30186
2018,"WESTERN EUROPE-EU","PORTUGAL(MADEIRA)","GATWICK","PORTO SANTO",9090,76,9014
2018,"WESTERN EUROPE-EU","PORTUGAL(MADEIRA)","LUTON","FUNCHAL",8831,0,8831
2018,"WESTERN EUROPE-EU","PORTUGAL(MADEIRA)","STANSTED","FUNCHAL",43450,43450,0
2018,"WESTERN EUROPE-EU","SLOVENIA","GATWICK","LJUBLJANA",63032,63032,0
2018,"WESTERN EUROPE-EU","SLOVENIA","LUTON","LJUBLJANA",66047,66047,0
2018,"WESTERN EUROPE-EU","SLOVENIA","STANSTED","LJUBLJANA",118043,118043,0
2018,"WESTERN EUROPE-EU","SPAIN","GATWICK","ALICANTE",802860,751284,51576
2018,"WESTERN EUROPE-EU","SPAIN","GATWICK","ALMERIA",123432,114582,8850
2018,"WESTERN EUROPE-EU","SPAIN","GATWICK","ASTURIAS",34402,34402,0
2018,"WESTERN EUROPE-EU","SPAIN","GATWICK","BARCELONA",1555323,1553603,1720
2018,"WESTERN EUROPE-EU","SPAIN","GATWICK","BILBAO",108931,108795,136
2018,"WESTERN EUROPE-EU","SPAIN","GATWICK","GIRONA",14722,0,14722
2018,"WESTERN EUROPE-EU","SPAIN","GATWICK","GRANADA",45748,45748,0
2018,"WESTERN EUROPE-EU","SPAIN","GATWICK","IBIZA",287019,222201,64818
2018,"WESTERN EUROPE-EU","SPAIN","GATWICK","JEREZ",9055,0,9055
2018,"WESTERN EUROPE-EU","SPAIN","GATWICK","LIEIDA",7267,6056,1211
2018,"WESTERN EUROPE-EU","SPAIN","GATWICK","MADRID",1026627,1026606,21
2018,"WESTERN EUROPE-EU","SPAIN","GATWICK","MAHON",248486,177660,70826
2018,"WESTERN EUROPE-EU","SPAIN","GATWICK","MALAGA",1089976,1023731,66245
2018,"WESTERN EUROPE-EU","SPAIN","GATWICK","MURCIA SAN JAVIER",177396,177396,0
2018,"WESTERN EUROPE-EU","SPAIN","GATWICK","PALMA DE MALLORCA",782401,644042,138359
2018,"WESTERN EUROPE-EU","SPAIN","GATWICK","REUS",44849,17251,27598
2018,"WESTERN EUROPE-EU","SPAIN","GATWICK","SANTIAGO DE COMPOSTELA (SPAIN)",34105,34105,0
2018,"WESTERN EUROPE-EU","SPAIN","GATWICK","SEVILLE",202384,202384,0
2018,"WESTERN EUROPE-EU","SPAIN","GATWICK","VALENCIA",359889,359889,0
2018,"WESTERN EUROPE-EU","SPAIN","GATWICK","VALLADOLID",0,0,0
2018,"WESTERN EUROPE-EU","SPAIN","GATWICK","VIGO",47,0,47
2018,"WESTERN EUROPE-EU","SPAIN","GATWICK","VITORIA",0,0,0
2018,"WESTERN EUROPE-EU","SPAIN","GATWICK","ZARAGOZA",94,0,94
2018,"WESTERN EUROPE-EU","SPAIN","HEATHROW","A CORUNA",113013,113013,0
2018,"WESTERN EUROPE-EU","SPAIN","HEATHROW","ALMERIA",17759,17759,0
2018,"WESTERN EUROPE-EU","SPAIN","HEATHROW","ASTURIAS",18602,18602,0
2018,"WESTERN EUROPE-EU","SPAIN","HEATHROW","BARCELONA",764204,764204,0
2018,"WESTERN EUROPE-EU","SPAIN","HEATHROW","BILBAO",167530,167530,0
2018,"WESTERN EUROPE-EU","SPAIN","HEATHROW","IBIZA",46815,46815,0
2018,"WESTERN EUROPE-EU","SPAIN","HEATHROW","JEREZ",104,104,0
2018,"WESTERN EUROPE-EU","SPAIN","HEATHROW","MADRID",1417554,1417554,0
2018,"WESTERN EUROPE-EU","SPAIN","HEATHROW","MAHON",12561,12561,0
2018,"WESTERN EUROPE-EU","SPAIN","HEATHROW","MALAGA",106567,106567,0
2018,"WESTERN EUROPE-EU","SPAIN","HEATHROW","MURCIA SAN JAVIER",17334,17334,0
2018,"WESTERN EUROPE-EU","SPAIN","HEATHROW","PALMA DE MALLORCA",127862,127862,0
2018,"WESTERN EUROPE-EU","SPAIN","LONDON CITY","GRANADA",14641,14641,0
2018,"WESTERN EUROPE-EU","SPAIN","LONDON CITY","IBIZA",87787,87691,96
2018,"WESTERN EUROPE-EU","SPAIN","LONDON CITY","MADRID",99,99,0
2018,"WESTERN EUROPE-EU","SPAIN","LONDON CITY","MAHON",2854,2854,0
2018,"WESTERN EUROPE-EU","SPAIN","LONDON CITY","MALAGA",62870,62870,0
2018,"WESTERN EUROPE-EU","SPAIN","LONDON CITY","PALMA DE MALLORCA",44903,44903,0
2018,"WESTERN EUROPE-EU","SPAIN","LUTON","ALICANTE",211781,211344,437
2018,"WESTERN EUROPE-EU","SPAIN","LUTON","ALMERIA",123,0,123
2018,"WESTERN EUROPE-EU","SPAIN","LUTON","BARCELONA",403426,403271,155
2018,"WESTERN EUROPE-EU","SPAIN","LUTON","BILBAO",0,0,0
2018,"WESTERN EUROPE-EU","SPAIN","LUTON","GIRONA",30002,30002,0
2018,"WESTERN EUROPE-EU","SPAIN","LUTON","IBIZA",94316,73422,20894
2018,"WESTERN EUROPE-EU","SPAIN","LUTON","MADRID",132794,132253,541
2018,"WESTERN EUROPE-EU","SPAIN","LUTON","MAHON",60100,45490,14610
2018,"WESTERN EUROPE-EU","SPAIN","LUTON","MALAGA",303037,283091,19946
2018,"WESTERN EUROPE-EU","SPAIN","LUTON","MURCIA SAN JAVIER",95447,95447,0
2018,"WESTERN EUROPE-EU","SPAIN","LUTON","PALMA DE MALLORCA",239991,199709,40282
2018,"WESTERN EUROPE-EU","SPAIN","LUTON","REUS",25850,16273,9577
2018,"WESTERN EUROPE-EU","SPAIN","LUTON","SAN SEBASTIAN",0,0,0
2018,"WESTERN EUROPE-EU","SPAIN","LUTON","SEVILLE",50381,50381,0
2018,"WESTERN EUROPE-EU","SPAIN","LUTON","VALENCIA",45698,45698,0
2018,"WESTERN EUROPE-EU","SPAIN","LUTON","VIGO",2442,2442,0
2018,"WESTERN EUROPE-EU","SPAIN","SOUTHEND","ALICANTE",109963,109963,0
2018,"WESTERN EUROPE-EU","SPAIN","SOUTHEND","BARCELONA",45974,45974,0
2018,"WESTERN EUROPE-EU","SPAIN","SOUTHEND","GIRONA",4,4,0
2018,"WESTERN EUROPE-EU","SPAIN","SOUTHEND","IBIZA",21004,21004,0
2018,"WESTERN EUROPE-EU","SPAIN","SOUTHEND","MAHON",16529,16529,0
2018,"WESTERN EUROPE-EU","SPAIN","SOUTHEND","MALAGA",95413,95413,0
2018,"WESTERN EUROPE-EU","SPAIN","SOUTHEND","MURCIA SAN JAVIER",22255,22255,0
2018,"WESTERN EUROPE-EU","SPAIN","SOUTHEND","PALMA DE MALLORCA",66485,66485,0
2018,"WESTERN EUROPE-EU","SPAIN","SOUTHEND","REUS",0,0,0
2018,"WESTERN EUROPE-EU","SPAIN","STANSTED","ALICANTE",412693,412693,0
2018,"WESTERN EUROPE-EU","SPAIN","STANSTED","ALMERIA",38504,38504,0
2018,"WESTERN EUROPE-EU","SPAIN","STANSTED","ASTURIAS",46688,46688,0
2018,"WESTERN EUROPE-EU","SPAIN","STANSTED","BARCELONA",480917,479439,1478
2018,"WESTERN EUROPE-EU","SPAIN","STANSTED","BILBAO",126710,125461,1249
2018,"WESTERN EUROPE-EU","SPAIN","STANSTED","CASTELLON COSTA AZAHAR",35082,35082,0
2018,"WESTERN EUROPE-EU","SPAIN","STANSTED","CASTELLON DE LA PLANA AIRPORT",14783,14783,0
2018,"WESTERN EUROPE-EU","SPAIN","STANSTED","GIRONA",81411,81347,64
2018,"WESTERN EUROPE-EU","SPAIN","STANSTED","GRANADA",0,0,0
2018,"WESTERN EUROPE-EU","SPAIN","STANSTED","IBIZA",282312,265770,16542
2018,"WESTERN EUROPE-EU","SPAIN","STANSTED","JEREZ",57649,57649,0
2018,"WESTERN EUROPE-EU","SPAIN","STANSTED","LEON",341,0,341
2018,"WESTERN EUROPE-EU","SPAIN","STANSTED","LIEIDA",3115,0,3115
2018,"WESTERN EUROPE-EU","SPAIN","STANSTED","MADRID",470157,470157,0
2018,"WESTERN EUROPE-EU","SPAIN","STANSTED","MAHON",82877,64690,18187
2018,"WESTERN EUROPE-EU","SPAIN","STANSTED","MALAGA",541450,541450,0
2018,"WESTERN EUROPE-EU","SPAIN","STANSTED","MURCIA SAN JAVIER",130582,130582,0
2018,"WESTERN EUROPE-EU","SPAIN","STANSTED","PALMA DE MALLORCA",479582,460795,18787
2018,"WESTERN EUROPE-EU","SPAIN","STANSTED","REUS",83613,83448,165
2018,"WESTERN EUROPE-EU","SPAIN","STANSTED","SALAMANCA",315,0,315
2018,"WESTERN EUROPE-EU","SPAIN","STANSTED","SANTANDER",81988,81988,0
2018,"WESTERN EUROPE-EU","SPAIN","STANSTED","SANTIAGO DE COMPOSTELA (SPAIN)",76599,76599,0
2018,"WESTERN EUROPE-EU","SPAIN","STANSTED","SEVILLE",142478,142292,186
2018,"WESTERN EUROPE-EU","SPAIN","STANSTED","VALENCIA",134314,134314,0
2018,"WESTERN EUROPE-EU","SPAIN","STANSTED","VALLADOLID",175,0,175
2018,"WESTERN EUROPE-EU","SPAIN","STANSTED","ZARAGOZA",88202,88202,0
2018,"WESTERN EUROPE-EU","SPAIN(CANARY ISLANDS)","GATWICK","ARRECIFE",377218,301068,76150
2018,"WESTERN EUROPE-EU","SPAIN(CANARY ISLANDS)","GATWICK","FUERTEVENTURA",232071,177386,54685
2018,"WESTERN EUROPE-EU","SPAIN(CANARY ISLANDS)","GATWICK","LAS PALMAS",290729,204201,86528
2018,"WESTERN EUROPE-EU","SPAIN(CANARY ISLANDS)","GATWICK","SANTA CRUZ DE LA PALMA",40349,22633,17716
2018,"WESTERN EUROPE-EU","SPAIN(CANARY ISLANDS)","GATWICK","TENERIFE (SURREINA SOFIA)",710343,565026,145317
2018,"WESTERN EUROPE-EU","SPAIN(CANARY ISLANDS)","HEATHROW","LAS PALMAS",16584,16584,0
2018,"WESTERN EUROPE-EU","SPAIN(CANARY ISLANDS)","HEATHROW","TENERIFE (NORTE LOS RODEOS)",0,0,0
2018,"WESTERN EUROPE-EU","SPAIN(CANARY ISLANDS)","HEATHROW","TENERIFE (SURREINA SOFIA)",14382,14382,0
2018,"WESTERN EUROPE-EU","SPAIN(CANARY ISLANDS)","LUTON","ARRECIFE",107480,76943,30537
2018,"WESTERN EUROPE-EU","SPAIN(CANARY ISLANDS)","LUTON","FUERTEVENTURA",49197,34087,15110
2018,"WESTERN EUROPE-EU","SPAIN(CANARY ISLANDS)","LUTON","LAS PALMAS",41482,22510,18972
2018,"WESTERN EUROPE-EU","SPAIN(CANARY ISLANDS)","LUTON","TENERIFE (SURREINA SOFIA)",129868,90372,39496
2018,"WESTERN EUROPE-EU","SPAIN(CANARY ISLANDS)","SOUTHEND","ARRECIFE",13430,13430,0
2018,"WESTERN EUROPE-EU","SPAIN(CANARY ISLANDS)","SOUTHEND","LAS PALMAS",0,0,0
2018,"WESTERN EUROPE-EU","SPAIN(CANARY ISLANDS)","SOUTHEND","TENERIFE (SURREINA SOFIA)",13589,13589,0
2018,"WESTERN EUROPE-EU","SPAIN(CANARY ISLANDS)","STANSTED","ARRECIFE",239016,228685,10331
2018,"WESTERN EUROPE-EU","SPAIN(CANARY ISLANDS)","STANSTED","FUERTEVENTURA",162361,143587,18774
2018,"WESTERN EUROPE-EU","SPAIN(CANARY ISLANDS)","STANSTED","LAS PALMAS",189866,170890,18976
2018,"WESTERN EUROPE-EU","SPAIN(CANARY ISLANDS)","STANSTED","TENERIFE (SURREINA SOFIA)",352782,323346,29436
2018,"WESTERN EUROPE-EU","SWEDEN","GATWICK","GOTEBORG (LANDVETTER)",183873,183873,0
2018,"WESTERN EUROPE-EU","SWEDEN","GATWICK","JONKOPING",0,0,0
2018,"WESTERN EUROPE-EU","SWEDEN","GATWICK","KIRUNA",101,0,101
2018,"WESTERN EUROPE-EU","SWEDEN","GATWICK","OSTERSUND / FROSON",6582,6582,0
2018,"WESTERN EUROPE-EU","SWEDEN","GATWICK","PAJALA YLLAS",0,0,0
2018,"WESTERN EUROPE-EU","SWEDEN","GATWICK","STOCKHOLM (ARLANDA)",498756,498646,110
2018,"WESTERN EUROPE-EU","SWEDEN","GATWICK","STOCKHOLM (BROMMA)",0,0,0
2018,"WESTERN EUROPE-EU","SWEDEN","GATWICK","VISBY",0,0,0
2018,"WESTERN EUROPE-EU","SWEDEN","HEATHROW","GOTEBORG (LANDVETTER)",254676,254676,0
2018,"WESTERN EUROPE-EU","SWEDEN","HEATHROW","KIRUNA",2238,0,2238
2018,"WESTERN EUROPE-EU","SWEDEN","HEATHROW","STOCKHOLM (ARLANDA)",970622,970622,0
2018,"WESTERN EUROPE-EU","SWEDEN","LUTON","GOTEBORG (LANDVETTER)",0,0,0
2018,"WESTERN EUROPE-EU","SWEDEN","LUTON","NORRKOPING",0,0,0
2018,"WESTERN EUROPE-EU","SWEDEN","LUTON","OSTERSUND / FROSON",808,0,808
2018,"WESTERN EUROPE-EU","SWEDEN","LUTON","STOCKHOLM (ARLANDA)",49243,49243,0
2018,"WESTERN EUROPE-EU","SWEDEN","STANSTED","GOTEBORG (LANDVETTER)",155673,155602,71
2018,"WESTERN EUROPE-EU","SWEDEN","STANSTED","HALMSTAD",312,0,312
2018,"WESTERN EUROPE-EU","SWEDEN","STANSTED","MALMO",179,179,0
2018,"WESTERN EUROPE-EU","SWEDEN","STANSTED","NORRKOPING",174,174,0
2018,"WESTERN EUROPE-EU","SWEDEN","STANSTED","OSTERSUND / FROSON",87,0,87
2018,"WESTERN EUROPE-EU","SWEDEN","STANSTED","PAJALA YLLAS",378,0,378
2018,"WESTERN EUROPE-EU","SWEDEN","STANSTED","STOCKHOLM (ARLANDA)",1169,477,692
2018,"WESTERN EUROPE-EU","SWEDEN","STANSTED","STOCKHOLM (SKAVSTA)",256482,256482,0
2018,"WESTERN EUROPE-EU","SWEDEN","STANSTED","VASTERAS",69382,69382,0
2018,"WESTERN EUROPE-OTHER","BOSNIA-HERZEGOVINA","LUTON","TUZLA",0,0,0
2018,"WESTERN EUROPE-OTHER","ICELAND","GATWICK","EGILSSTADIR",0,0,0
2018,"WESTERN EUROPE-OTHER","ICELAND","GATWICK","KEFLAVIK",467058,452688,14370
2018,"WESTERN EUROPE-OTHER","ICELAND","HEATHROW","KEFLAVIK",378205,378205,0
2018,"WESTERN EUROPE-OTHER","ICELAND","LONDON CITY","KEFLAVIK",5034,5034,0
2018,"WESTERN EUROPE-OTHER","ICELAND","LUTON","KEFLAVIK",196481,196426,55
2018,"WESTERN EUROPE-OTHER","ICELAND","STANSTED","AKUREYRI",160,0,160
2018,"WESTERN EUROPE-OTHER","ICELAND","STANSTED","KEFLAVIK",88414,88282,132
2018,"WESTERN EUROPE-OTHER","KOSOVO","GATWICK","PRISTINA",430,430,0
2018,"WESTERN EUROPE-OTHER","KOSOVO","LUTON","PRISTINA",55944,55944,0
2018,"WESTERN EUROPE-OTHER","MACEDONIA","GATWICK","SKOPJE",1,1,0
2018,"WESTERN EUROPE-OTHER","MACEDONIA","LUTON","OHRID",17087,17087,0
2018,"WESTERN EUROPE-OTHER","MACEDONIA","LUTON","SKOPJE",67868,67868,0
2018,"WESTERN EUROPE-OTHER","NORWAY","GATWICK","ANDENES",1,0,1
2018,"WESTERN EUROPE-OTHER","NORWAY","GATWICK","BERGEN",210922,209419,1503
2018,"WESTERN EUROPE-OTHER","NORWAY","GATWICK","EVENES",0,0,0
2018,"WESTERN EUROPE-OTHER","NORWAY","GATWICK","FAGERNES/LEIRIN",1730,0,1730
2018,"WESTERN EUROPE-OTHER","NORWAY","GATWICK","HAUGESUND",0,0,0
2018,"WESTERN EUROPE-OTHER","NORWAY","GATWICK","OSLO (GARDERMOEN)",458875,458529,346
2018,"WESTERN EUROPE-OTHER","NORWAY","GATWICK","STAVANGER",108200,107843,357
2018,"WESTERN EUROPE-OTHER","NORWAY","GATWICK","TROMSOE",23477,22365,1112
2018,"WESTERN EUROPE-OTHER","NORWAY","GATWICK","TRONDHEIM (VAERNES)",64382,64382,0
2018,"WESTERN EUROPE-OTHER","NORWAY","HEATHROW","BERGEN",0,0,0
2018,"WESTERN EUROPE-OTHER","NORWAY","HEATHROW","OSLO (GARDERMOEN)",668983,668983,0
2018,"WESTERN EUROPE-OTHER","NORWAY","HEATHROW","STAVANGER",98250,98250,0
2018,"WESTERN EUROPE-OTHER","NORWAY","LUTON","TROMSOE",1586,1586,0
2018,"WESTERN EUROPE-OTHER","NORWAY","STANSTED","BERGEN",0,0,0
2018,"WESTERN EUROPE-OTHER","NORWAY","STANSTED","KRISTIANSAND (KJEVIK)",7637,7637,0
2018,"WESTERN EUROPE-OTHER","NORWAY","STANSTED","OSLO (GARDERMOEN)",307973,307973,0
2018,"WESTERN EUROPE-OTHER","NORWAY","STANSTED","RYGGE",135,135,0
2018,"WESTERN EUROPE-OTHER","NORWAY","STANSTED","SANDEFJORD(TORP)",56510,56510,0
2018,"WESTERN EUROPE-OTHER","NORWAY","STANSTED","TROMSOE",80,0,80
2018,"WESTERN EUROPE-OTHER","REPUBLIC OF MONTENEGRO","GATWICK","PODGORICA",12408,0,12408
2018,"WESTERN EUROPE-OTHER","REPUBLIC OF MONTENEGRO","GATWICK","TIVAT",33153,33153,0
2018,"WESTERN EUROPE-OTHER","REPUBLIC OF MONTENEGRO","LUTON","TIVAT",0,0,0
2018,"WESTERN EUROPE-OTHER","REPUBLIC OF MONTENEGRO","STANSTED","PODGORICA",36291,36291,0
2018,"WESTERN EUROPE-OTHER","REPUBLIC OF MONTENEGRO","STANSTED","TIVAT",1625,1625,0
2018,"WESTERN EUROPE-OTHER","REPUBLIC OF SERBIA","HEATHROW","BELGRADE",93419,93419,0
2018,"WESTERN EUROPE-OTHER","REPUBLIC OF SERBIA","LUTON","BELGRADE",51608,51346,262
2018,"WESTERN EUROPE-OTHER","REPUBLIC OF SERBIA","STANSTED","BELGRADE",0,0,0
2018,"WESTERN EUROPE-OTHER","SWITZERLAND","GATWICK","ALTENRHEIN",43,0,43
2018,"WESTERN EUROPE-OTHER","SWITZERLAND","GATWICK","BALE MULHOUSE",286579,286579,0
2018,"WESTERN EUROPE-OTHER","SWITZERLAND","GATWICK","GENEVA",828602,798350,30252
2018,"WESTERN EUROPE-OTHER","SWITZERLAND","GATWICK","ZURICH",158771,158505,266
2018,"WESTERN EUROPE-OTHER","SWITZERLAND","HEATHROW","BALE MULHOUSE",280223,280223,0
2018,"WESTERN EUROPE-OTHER","SWITZERLAND","HEATHROW","GENEVA",1056453,1056453,0
2018,"WESTERN EUROPE-OTHER","SWITZERLAND","HEATHROW","SION",1121,1121,0
2018,"WESTERN EUROPE-OTHER","SWITZERLAND","HEATHROW","ZURICH",1167980,1167388,592
2018,"WESTERN EUROPE-OTHER","SWITZERLAND","LONDON CITY","BALE MULHOUSE",0,0,0
2018,"WESTERN EUROPE-OTHER","SWITZERLAND","LONDON CITY","BERNE",7197,7197,0
2018,"WESTERN EUROPE-OTHER","SWITZERLAND","LONDON CITY","GENEVA",196756,196756,0
2018,"WESTERN EUROPE-OTHER","SWITZERLAND","LONDON CITY","SION",97,97,0
2018,"WESTERN EUROPE-OTHER","SWITZERLAND","LONDON CITY","ZURICH",422734,422734,0
2018,"WESTERN EUROPE-OTHER","SWITZERLAND","LUTON","BALE MULHOUSE",85937,85937,0
2018,"WESTERN EUROPE-OTHER","SWITZERLAND","LUTON","GENEVA",317049,317049,0
2018,"WESTERN EUROPE-OTHER","SWITZERLAND","LUTON","ZURICH",176957,176957,0
2018,"WESTERN EUROPE-OTHER","SWITZERLAND","SOUTHEND","BALE MULHOUSE",0,0,0
2018,"WESTERN EUROPE-OTHER","SWITZERLAND","SOUTHEND","GENEVA",31321,31321,0
2018,"WESTERN EUROPE-OTHER","SWITZERLAND","STANSTED","BALE MULHOUSE",88673,88673,0
2018,"WESTERN EUROPE-OTHER","SWITZERLAND","STANSTED","BERNE",0,0,0
2018,"WESTERN EUROPE-OTHER","SWITZERLAND","STANSTED","GENEVA",88800,88800,0
2018,"WESTERN EUROPE-OTHER","SWITZERLAND","STANSTED","ZURICH",1062,61,1001
2018,"WESTERN EUROPE-OTHER","TURKEY","GATWICK","ANKARA (ESENBOGA)",10,0,10
2018,"WESTERN EUROPE-OTHER","TURKEY","GATWICK","ANTALYA",318113,239708,78405
2018,"WESTERN EUROPE-OTHER","TURKEY","GATWICK","BODRUM (MILAS)",99937,83915,16022
2018,"WESTERN EUROPE-OTHER","TURKEY","GATWICK","DALAMAN",339519,281723,57796
2018,"WESTERN EUROPE-OTHER","TURKEY","GATWICK","ISTANBUL",228777,228777,0
2018,"WESTERN EUROPE-OTHER","TURKEY","GATWICK","ISTANBUL (SABIHA GOKCEN)",81237,81237,0
2018,"WESTERN EUROPE-OTHER","TURKEY","GATWICK","IZMIR (ADNAN MENDERES)",57277,47102,10175
2018,"WESTERN EUROPE-OTHER","TURKEY","HEATHROW","ISTANBUL",1074397,1074397,0
2018,"WESTERN EUROPE-OTHER","TURKEY","HEATHROW","ISTANBUL (SABIHA GOKCEN)",151,151,0
2018,"WESTERN EUROPE-OTHER","TURKEY","LUTON","ANKARA (ESENBOGA)",8755,8755,0
2018,"WESTERN EUROPE-OTHER","TURKEY","LUTON","ANTALYA",57367,52383,4984
2018,"WESTERN EUROPE-OTHER","TURKEY","LUTON","BODRUM (MILAS)",31078,31078,0
2018,"WESTERN EUROPE-OTHER","TURKEY","LUTON","DALAMAN",48439,41353,7086
2018,"WESTERN EUROPE-OTHER","TURKEY","LUTON","GAZIANTEP",2964,2964,0
2018,"WESTERN EUROPE-OTHER","TURKEY","LUTON","IZMIR (ADNAN MENDERES)",10010,10010,0
2018,"WESTERN EUROPE-OTHER","TURKEY","LUTON","TRABZON",0,0,0
2018,"WESTERN EUROPE-OTHER","TURKEY","SOUTHEND","BODRUM (MILAS)",0,0,0
2018,"WESTERN EUROPE-OTHER","TURKEY","STANSTED","ANTALYA",129302,120131,9171
2018,"WESTERN EUROPE-OTHER","TURKEY","STANSTED","BODRUM (MILAS)",46285,46285,0
2018,"WESTERN EUROPE-OTHER","TURKEY","STANSTED","DALAMAN",154140,137127,17013
2018,"WESTERN EUROPE-OTHER","TURKEY","STANSTED","ISTANBUL",90543,90543,0
2018,"WESTERN EUROPE-OTHER","TURKEY","STANSTED","ISTANBUL (SABIHA GOKCEN)",373221,373221,0
2018,"WESTERN EUROPE-OTHER","TURKEY","STANSTED","IZMIR (ADNAN MENDERES)",53043,53043,0
2018,"EASTERN EUROPE-EU","BULGARIA","GATWICK","BURGAS",58192,17527,40665
2018,"EASTERN EUROPE-EU","BULGARIA","GATWICK","SOFIA",130427,121139,9288
2018,"EASTERN EUROPE-EU","BULGARIA","GATWICK","VARNA",19110,9770,9340
2018,"EASTERN EUROPE-EU","BULGARIA","HEATHROW","SOFIA",169529,169529,0
2018,"EASTERN EUROPE-EU","BULGARIA","LUTON","BURGAS",100230,100011,219
2018,"EASTERN EUROPE-EU","BULGARIA","LUTON","SOFIA",314654,314654,0
2018,"EASTERN EUROPE-EU","BULGARIA","LUTON","VARNA",106698,106552,146
2018,"EASTERN EUROPE-EU","BULGARIA","SOUTHEND","SOFIA",1391,1391,0
2018,"EASTERN EUROPE-EU","BULGARIA","STANSTED","BURGAS",8362,0,8362
2018,"EASTERN EUROPE-EU","BULGARIA","STANSTED","PLOVDIV",55813,55813,0
2018,"EASTERN EUROPE-EU","BULGARIA","STANSTED","SOFIA",260817,260817,0
2018,"EASTERN EUROPE-EU","CZECH REPUBLIC","GATWICK","PRAGUE",266986,266986,0
2018,"EASTERN EUROPE-EU","CZECH REPUBLIC","HEATHROW","PRAGUE",443743,443743,0
2018,"EASTERN EUROPE-EU","CZECH REPUBLIC","LONDON CITY","PRAGUE",40730,40723,7
2018,"EASTERN EUROPE-EU","CZECH REPUBLIC","LUTON","BRNO (TURANY)",1083,1083,0
2018,"EASTERN EUROPE-EU","CZECH REPUBLIC","LUTON","PRAGUE",123629,123629,0
2018,"EASTERN EUROPE-EU","CZECH REPUBLIC","SOUTHEND","PRAGUE",73341,73341,0
2018,"EASTERN EUROPE-EU","CZECH REPUBLIC","STANSTED","BRNO (TURANY)",112158,112158,0
2018,"EASTERN EUROPE-EU","CZECH REPUBLIC","STANSTED","OSTRAVA",59430,59430,0
2018,"EASTERN EUROPE-EU","CZECH REPUBLIC","STANSTED","PARDUBICE",40857,40857,0
2018,"EASTERN EUROPE-EU","CZECH REPUBLIC","STANSTED","PRAGUE",407545,407545,0
2018,"EASTERN EUROPE-EU","ESTONIA","GATWICK","TALLIN",52944,52933,11
2018,"EASTERN EUROPE-EU","ESTONIA","HEATHROW","TALLIN",31350,31350,0
2018,"EASTERN EUROPE-EU","ESTONIA","LUTON","TALLIN",14500,14500,0
2018,"EASTERN EUROPE-EU","ESTONIA","STANSTED","TALLIN",74199,74199,0
2018,"EASTERN EUROPE-EU","HUNGARY","GATWICK","BUDAPEST",174585,173860,725
2018,"EASTERN EUROPE-EU","HUNGARY","HEATHROW","BUDAPEST",363488,363488,0
2018,"EASTERN EUROPE-EU","HUNGARY","LUTON","BUDAPEST",564102,564002,100
2018,"EASTERN EUROPE-EU","HUNGARY","LUTON","DEBRECEN",148516,148516,0
2018,"EASTERN EUROPE-EU","HUNGARY","SOUTHEND","BUDAPEST",26779,26779,0
2018,"EASTERN EUROPE-EU","HUNGARY","STANSTED","BUDAPEST",427179,427131,48
2018,"EASTERN EUROPE-EU","LATVIA","GATWICK","RIGA",140730,140730,0
2018,"EASTERN EUROPE-EU","LATVIA","LUTON","RIGA",205365,205365,0
2018,"EASTERN EUROPE-EU","LATVIA","STANSTED","RIGA",255325,255325,0
2018,"EASTERN EUROPE-EU","LITHUANIA","GATWICK","VILNIUS",0,0,0
2018,"EASTERN EUROPE-EU","LITHUANIA","LUTON","KAUNAS",244636,244636,0
2018,"EASTERN EUROPE-EU","LITHUANIA","LUTON","PALANGA",61353,61353,0
2018,"EASTERN EUROPE-EU","LITHUANIA","LUTON","VILNIUS",347688,347688,0
2018,"EASTERN EUROPE-EU","LITHUANIA","STANSTED","KAUNAS",93219,93219,0
2018,"EASTERN EUROPE-EU","LITHUANIA","STANSTED","PALANGA",37626,37626,0
2018,"EASTERN EUROPE-EU","LITHUANIA","STANSTED","VILNIUS",127393,127393,0
2018,"EASTERN EUROPE-EU","POLAND","GATWICK","GDANSK",0,0,0
2018,"EASTERN EUROPE-EU","POLAND","GATWICK","KATOWICE",180,180,0
2018,"EASTERN EUROPE-EU","POLAND","GATWICK","KRAKOW",147233,145543,1690
2018,"EASTERN EUROPE-EU","POLAND","GATWICK","POZNAN",0,0,0
2018,"EASTERN EUROPE-EU","POLAND","GATWICK","WARSAW (CHOPIN)",10637,10637,0
2018,"EASTERN EUROPE-EU","POLAND","GATWICK","WROCLAW",109,0,109
2018,"EASTERN EUROPE-EU","POLAND","HEATHROW","KRAKOW",103347,103347,0
2018,"EASTERN EUROPE-EU","POLAND","HEATHROW","WARSAW (CHOPIN)",501117,501117,0
2018,"EASTERN EUROPE-EU","POLAND","LUTON","BYDGOSZCZ",62601,62601,0
2018,"EASTERN EUROPE-EU","POLAND","LUTON","GDANSK",334909,334909,0
2018,"EASTERN EUROPE-EU","POLAND","LUTON","KATOWICE",374062,374062,0
2018,"EASTERN EUROPE-EU","POLAND","LUTON","KRAKOW",11133,10725,408
2018,"EASTERN EUROPE-EU","POLAND","LUTON","LUBLIN (PORT LOTNICZY)",122207,122207,0
2018,"EASTERN EUROPE-EU","POLAND","LUTON","POZNAN",169036,169036,0
2018,"EASTERN EUROPE-EU","POLAND","LUTON","RZESZOW",56169,56169,0
2018,"EASTERN EUROPE-EU","POLAND","LUTON","SZCZECIN (GOLENOW)",1556,1556,0
2018,"EASTERN EUROPE-EU","POLAND","LUTON","SZYMANY (MAZURY)",41954,41954,0
2018,"EASTERN EUROPE-EU","POLAND","LUTON","WARSAW (CHOPIN)",486006,486006,0
2018,"EASTERN EUROPE-EU","POLAND","LUTON","WROCLAW",150482,150482,0
2018,"EASTERN EUROPE-EU","POLAND","SOUTHEND","RZESZOW",31,31,0
2018,"EASTERN EUROPE-EU","POLAND","STANSTED","BYDGOSZCZ",116763,116763,0
2018,"EASTERN EUROPE-EU","POLAND","STANSTED","GDANSK",201724,201724,0
2018,"EASTERN EUROPE-EU","POLAND","STANSTED","KATOWICE",126864,126864,0
2018,"EASTERN EUROPE-EU","POLAND","STANSTED","KRAKOW",345191,344079,1112
2018,"EASTERN EUROPE-EU","POLAND","STANSTED","LODZ LUBLINEK",109485,109485,0
2018,"EASTERN EUROPE-EU","POLAND","STANSTED","LUBLIN (PORT LOTNICZY)",73660,73660,0
2018,"EASTERN EUROPE-EU","POLAND","STANSTED","POZNAN",157453,157453,0
2018,"EASTERN EUROPE-EU","POLAND","STANSTED","RZESZOW",136922,136548,374
2018,"EASTERN EUROPE-EU","POLAND","STANSTED","SZCZECIN (GOLENOW)",109531,109531,0
2018,"EASTERN EUROPE-EU","POLAND","STANSTED","SZYMANY (MAZURY)",49781,49781,0
2018,"EASTERN EUROPE-EU","POLAND","STANSTED","WARSAW (CHOPIN)",485,0,485
2018,"EASTERN EUROPE-EU","POLAND","STANSTED","WARSAW (MODLIN MASOVIA)",417121,417121,0
2018,"EASTERN EUROPE-EU","POLAND","STANSTED","WROCLAW",210781,210781,0
2018,"EASTERN EUROPE-EU","ROMANIA","GATWICK","BUCHAREST (OTOPENI)",141129,141129,0
2018,"EASTERN EUROPE-EU","ROMANIA","HEATHROW","BUCHAREST (OTOPENI)",257371,257371,0
2018,"EASTERN EUROPE-EU","ROMANIA","LUTON","BACAU",97302,97302,0
2018,"EASTERN EUROPE-EU","ROMANIA","LUTON","BUCHAREST (OTOPENI)",635685,635685,0
2018,"EASTERN EUROPE-EU","ROMANIA","LUTON","CLUJ NAPOCA",315630,315630,0
2018,"EASTERN EUROPE-EU","ROMANIA","LUTON","CONSTANTA",60421,60421,0
2018,"EASTERN EUROPE-EU","ROMANIA","LUTON","CRAIOVA",121250,121250,0
2018,"EASTERN EUROPE-EU","ROMANIA","LUTON","IASI",211843,211843,0
2018,"EASTERN EUROPE-EU","ROMANIA","LUTON","SATU MARE",38649,38649,0
2018,"EASTERN EUROPE-EU","ROMANIA","LUTON","SIBIU",97885,97885,0
2018,"EASTERN EUROPE-EU","ROMANIA","LUTON","SUCEAVA",124144,124144,0
2018,"EASTERN EUROPE-EU","ROMANIA","LUTON","TIMISOARA",121180,121180,0
2018,"EASTERN EUROPE-EU","ROMANIA","LUTON","TIRGU MURES",17626,17626,0
2018,"EASTERN EUROPE-EU","ROMANIA","STANSTED","BACAU",152,152,0
2018,"EASTERN EUROPE-EU","ROMANIA","STANSTED","BUCHAREST (OTOPENI)",231838,231838,0
2018,"EASTERN EUROPE-EU","ROMANIA","STANSTED","ORADEA",21496,21496,0
2018,"EASTERN EUROPE-EU","ROMANIA","STANSTED","TIMISOARA",27198,27198,0
2018,"EASTERN EUROPE-EU","SLOVAK REPUBLIC","GATWICK","BRATISLAVA",7,0,7
2018,"EASTERN EUROPE-EU","SLOVAK REPUBLIC","LUTON","BRATISLAVA",91211,91211,0
2018,"EASTERN EUROPE-EU","SLOVAK REPUBLIC","LUTON","KOSICE",140134,140134,0
2018,"EASTERN EUROPE-EU","SLOVAK REPUBLIC","LUTON","TATRY-POPRAD",60820,60820,0
2018,"EASTERN EUROPE-EU","SLOVAK REPUBLIC","STANSTED","BRATISLAVA",216383,216383,0
2018,"EASTERN EUROPE -OTHER","ALBANIA","GATWICK","TIRANA",104290,97969,6321
2018,"EASTERN EUROPE -OTHER","ALBANIA","LUTON","TIRANA",43205,43205,0
2018,"EASTERN EUROPE -OTHER","ALBANIA","STANSTED","TIRANA",853,0,853
2018,"EASTERN EUROPE -OTHER","AZERBAIJAN","GATWICK","BAKU (HEYDER ALIYEV INT'L)",234,0,234
2018,"EASTERN EUROPE -OTHER","AZERBAIJAN","HEATHROW","BAKU (HEYDER ALIYEV INT'L)",38815,38815,0
2018,"EASTERN EUROPE -OTHER","AZERBAIJAN","LUTON","BAKU (HEYDER ALIYEV INT'L)",1219,0,1219
2018,"EASTERN EUROPE -OTHER","BELARUS","GATWICK","MINSK INT'L ",31898,31568,330
2018,"EASTERN EUROPE -OTHER","BELARUS","LUTON","MINSK INT'L ",0,0,0
2018,"EASTERN EUROPE -OTHER","GEORGIA","GATWICK","TBILISI",13767,13767,0
2018,"EASTERN EUROPE -OTHER","GEORGIA","LUTON","KUTAISI",27427,27427,0
2018,"EASTERN EUROPE -OTHER","KAZAKHSTAN","HEATHROW","ASTANA",45379,45379,0
2018,"EASTERN EUROPE -OTHER","KAZAKHSTAN","LUTON","ALMATY",0,0,0
2018,"EASTERN EUROPE -OTHER","REPUBLIC OF MOLDOVA","LUTON","CHISINAU (KISHINEV)",117156,117156,0
2018,"EASTERN EUROPE -OTHER","REPUBLIC OF MOLDOVA","STANSTED","CHISINAU (KISHINEV)",67873,67873,0
2018,"EASTERN EUROPE -OTHER","RUSSIA","GATWICK","MOSCOW (SHEREMETYEVO)",16577,16577,0
2018,"EASTERN EUROPE -OTHER","RUSSIA","GATWICK","ST PETERSBURG",47097,47097,0
2018,"EASTERN EUROPE -OTHER","RUSSIA","HEATHROW","ADLER / SOCHI",0,0,0
2018,"EASTERN EUROPE -OTHER","RUSSIA","HEATHROW","MOSCOW (DOMODEDOVO)",248977,248977,0
2018,"EASTERN EUROPE -OTHER","RUSSIA","HEATHROW","MOSCOW (SHEREMETYEVO)",475473,475473,0
2018,"EASTERN EUROPE -OTHER","RUSSIA","HEATHROW","ST PETERSBURG",81017,81017,0
2018,"EASTERN EUROPE -OTHER","RUSSIA","LUTON","ADLER / SOCHI",400,0,400
2018,"EASTERN EUROPE -OTHER","RUSSIA","LUTON","MOSCOW (SHEREMETYEVO)",113,0,113
2018,"EASTERN EUROPE -OTHER","RUSSIA","LUTON","MOSCOW (VNUKOVO)",0,0,0
2018,"EASTERN EUROPE -OTHER","RUSSIA","LUTON","ST PETERSBURG",164,164,0
2018,"EASTERN EUROPE -OTHER","RUSSIA","STANSTED","MOSCOW (SHEREMETYEVO)",256,0,256
2018,"EASTERN EUROPE -OTHER","TURKMENISTAN","HEATHROW","ASHKHABAD",9467,9467,0
2018,"EASTERN EUROPE -OTHER","UKRAINE","GATWICK","KIEV (BORISPOL)",192351,192351,0
2018,"EASTERN EUROPE -OTHER","UKRAINE","HEATHROW","KIEV (BORISPOL)",82243,81750,493
2018,"EASTERN EUROPE -OTHER","UKRAINE","LUTON","KHARKOV OSNOVA INTL",3144,3144,0
2018,"EASTERN EUROPE -OTHER","UKRAINE","LUTON","KIEV (BORISPOL)",0,0,0
2018,"EASTERN EUROPE -OTHER","UKRAINE","LUTON","KIEV (ZHULYANY)",55289,55289,0
2018,"EASTERN EUROPE -OTHER","UKRAINE","LUTON","LVOV",32435,32435,0
2018,"EASTERN EUROPE -OTHER","UKRAINE","STANSTED","KIEV (BORISPOL)",13444,13444,0
2018,"EASTERN EUROPE -OTHER","UKRAINE","STANSTED","LVOV",7959,7959,0
2018,"EASTERN EUROPE -OTHER","UZBEKISTAN","HEATHROW","TASHKENT",28710,28710,0
2018,"NEAR EAST","ISRAEL","GATWICK","TEL AVIV",33787,33787,0
2018,"NEAR EAST","ISRAEL","HEATHROW","TEL AVIV",648088,648088,0
2018,"NEAR EAST","ISRAEL","LUTON","OVDA",5192,4806,386
2018,"NEAR EAST","ISRAEL","LUTON","TEL AVIV",472220,470812,1408
2018,"NEAR EAST","ISRAEL","STANSTED","TEL AVIV",30367,30195,172
2018,"NEAR EAST","JORDAN","GATWICK","AQABA",3087,2197,890
2018,"NEAR EAST","JORDAN","HEATHROW","AMMAN",230033,230033,0
2018,"NEAR EAST","JORDAN","STANSTED","AQABA",554,336,218
2018,"NEAR EAST","LEBANON","HEATHROW","BEIRUT",300706,300706,0
2018,"NORTH AFRICA","ALGERIA","GATWICK","ALGIERS",57169,57169,0
2018,"NORTH AFRICA","ALGERIA","HEATHROW","ALGIERS",74355,74355,0
2018,"NORTH AFRICA","EGYPT","GATWICK","HURGHADA",212439,212439,0
2018,"NORTH AFRICA","EGYPT","GATWICK","MARSA ALAM",28048,28048,0
2018,"NORTH AFRICA","EGYPT","HEATHROW","CAIRO",402530,402316,214
2018,"NORTH AFRICA","EGYPT","HEATHROW","LUXOR",8629,8629,0
2018,"NORTH AFRICA","EGYPT","LUTON","MARSA ALAM",49,49,0
2018,"NORTH AFRICA","EGYPT","STANSTED","HURGHADA",5616,5616,0
2018,"NORTH AFRICA","MOROCCO","GATWICK","AGADIR (AL MASSIRA)",91010,91010,0
2018,"NORTH AFRICA","MOROCCO","GATWICK","CASABLANCA MOHAMED V",65220,65220,0
2018,"NORTH AFRICA","MOROCCO","GATWICK","FEZ",16251,16251,0
2018,"NORTH AFRICA","MOROCCO","GATWICK","MARRAKESH",355350,355350,0
2018,"NORTH AFRICA","MOROCCO","GATWICK","OUARZAZATE",722,0,722
2018,"NORTH AFRICA","MOROCCO","GATWICK","RABAT",228,0,228
2018,"NORTH AFRICA","MOROCCO","GATWICK","TANGIERS (IBN BATUTA)",26187,26187,0
2018,"NORTH AFRICA","MOROCCO","HEATHROW","CASABLANCA MOHAMED V",86215,86215,0
2018,"NORTH AFRICA","MOROCCO","HEATHROW","MARRAKESH",8684,8684,0
2018,"NORTH AFRICA","MOROCCO","HEATHROW","RABAT",14147,14147,0
2018,"NORTH AFRICA","MOROCCO","LUTON","AGADIR (AL MASSIRA)",632,445,187
2018,"NORTH AFRICA","MOROCCO","LUTON","CASABLANCA MOHAMED V",38,0,38
2018,"NORTH AFRICA","MOROCCO","LUTON","ESSAOUIRA",20038,20038,0
2018,"NORTH AFRICA","MOROCCO","LUTON","MARRAKESH",59507,59507,0
2018,"NORTH AFRICA","MOROCCO","LUTON","RABAT",0,0,0
2018,"NORTH AFRICA","MOROCCO","STANSTED","AGADIR (AL MASSIRA)",37660,37660,0
2018,"NORTH AFRICA","MOROCCO","STANSTED","FEZ",35384,35384,0
2018,"NORTH AFRICA","MOROCCO","STANSTED","MARRAKESH",130668,128289,2379
2018,"NORTH AFRICA","MOROCCO","STANSTED","RABAT",52556,52556,0
2018,"NORTH AFRICA","TUNISIA","GATWICK","ENFIDHA - HAMMAMET INTL",67630,55691,11939
2018,"NORTH AFRICA","TUNISIA","GATWICK","MONASTIR",635,635,0
2018,"NORTH AFRICA","TUNISIA","GATWICK","TUNIS",31450,31077,373
2018,"NORTH AFRICA","TUNISIA","HEATHROW","TUNIS",46090,46090,0
2018,"NORTH AFRICA","TUNISIA","STANSTED","ENFIDHA - HAMMAMET INTL",8937,8937,0
2018,"NORTH AFRICA","TUNISIA","STANSTED","TUNIS",0,0,0
2018,"EAST AFRICA","ETHIOPIA","HEATHROW","ADDIS ABABA",237158,237158,0
2018,"EAST AFRICA","KENYA","HEATHROW","NAIROBI",360461,360461,0
2018,"EAST AFRICA","RWANDA","GATWICK","KIGALI",17684,17684,0
2018,"WEST AFRICA","GAMBIA","GATWICK","BANJUL",55848,34059,21789
2018,"WEST AFRICA","GHANA","GATWICK","ACCRA",794,0,794
2018,"WEST AFRICA","GHANA","HEATHROW","ACCRA",208978,208978,0
2018,"WEST AFRICA","NIGERIA","GATWICK","LAGOS",7273,7273,0
2018,"WEST AFRICA","NIGERIA","HEATHROW","ABUJA",121274,121274,0
2018,"WEST AFRICA","NIGERIA","HEATHROW","LAGOS",374601,374601,0
2018,"WEST AFRICA","NIGERIA","LUTON","ABUJA",0,0,0
2018,"WEST AFRICA","NIGERIA","SOUTHEND","IBADAN",0,0,0
2018,"CENTRAL AFRICA","ANGOLA","HEATHROW","LUANDA",3035,3035,0
2018,"SOUTHERN AFRICA","REPUBLIC OF SOUTH AFRICA","GATWICK","CAPE TOWN",50708,49260,1448
2018,"SOUTHERN AFRICA","REPUBLIC OF SOUTH AFRICA","HEATHROW","CAPE TOWN",331787,331787,0
2018,"SOUTHERN AFRICA","REPUBLIC OF SOUTH AFRICA","HEATHROW","DURBAN",9650,9650,0
2018,"SOUTHERN AFRICA","REPUBLIC OF SOUTH AFRICA","HEATHROW","JOHANNESBURG",933357,933357,0
2018,"MIDDLE EAST","BAHRAIN","HEATHROW","BAHRAIN",382507,382507,0
2018,"MIDDLE EAST","IRAN","HEATHROW","TEHRAN IMAM KHOMEINI",122937,122937,0
2018,"MIDDLE EAST","IRAQ","GATWICK","BAGHDAD (GECA)",9686,9686,0
2018,"MIDDLE EAST","IRAQ","GATWICK","ERBIL INTERNATIONAL",176,176,0
2018,"MIDDLE EAST","IRAQ","GATWICK","SULAYMANIYAH INT",6929,6929,0
2018,"MIDDLE EAST","KUWAIT","HEATHROW","KUWAIT",379240,379240,0
2018,"MIDDLE EAST","OMAN","GATWICK","MUSCAT",573,0,573
2018,"MIDDLE EAST","OMAN","HEATHROW","MUSCAT",384466,384466,0
2018,"MIDDLE EAST","QATAR","GATWICK","DOHA HAMAD",170314,170296,18
2018,"MIDDLE EAST","QATAR","HEATHROW","DOHA HAMAD",1181541,1181541,0
2018,"MIDDLE EAST","QATAR","STANSTED","DOHA HAMAD",0,0,0
2018,"MIDDLE EAST","SAUDI ARABIA","HEATHROW","JEDDAH",249869,249869,0
2018,"MIDDLE EAST","SAUDI ARABIA","HEATHROW","MEDINA",3300,3300,0
2018,"MIDDLE EAST","SAUDI ARABIA","HEATHROW","RIYADH",276302,276302,0
2018,"MIDDLE EAST","UNITED ARAB EMIRATES","GATWICK","ABU DHABI INTERNATIONAL",195,0,195
2018,"MIDDLE EAST","UNITED ARAB EMIRATES","GATWICK","DUBAI",1029841,1029841,0
2018,"MIDDLE EAST","UNITED ARAB EMIRATES","GATWICK","DUBAI (WORLD CENTRAL)",567,0,567
2018,"MIDDLE EAST","UNITED ARAB EMIRATES","HEATHROW","ABU DHABI INTERNATIONAL",1010388,1010160,228
2018,"MIDDLE EAST","UNITED ARAB EMIRATES","HEATHROW","DUBAI",2610784,2610784,0
2018,"MIDDLE EAST","UNITED ARAB EMIRATES","STANSTED","ABU DHABI INTERNATIONAL",234,0,234
2018,"MIDDLE EAST","UNITED ARAB EMIRATES","STANSTED","DUBAI",122643,122643,0
2018,"INDIAN SUB-CONTINENT","BANGLADESH","HEATHROW","DHAKHA",80436,80436,0
2018,"INDIAN SUB-CONTINENT","BANGLADESH","HEATHROW","SYLHET",52345,52345,0
2018,"INDIAN SUB-CONTINENT","INDIA","GATWICK","COCHIN",577,0,577
2018,"INDIAN SUB-CONTINENT","INDIA","GATWICK","GOA",43279,29584,13695
2018,"INDIAN SUB-CONTINENT","INDIA","HEATHROW","AHMEDABAD",65910,65910,0
2018,"INDIAN SUB-CONTINENT","INDIA","HEATHROW","AMRITSAR",4689,4689,0
2018,"INDIAN SUB-CONTINENT","INDIA","HEATHROW","BANGALORE (BENGALURU)",179321,179321,0
2018,"INDIAN SUB-CONTINENT","INDIA","HEATHROW","CHENNAI",136869,136869,0
2018,"INDIAN SUB-CONTINENT","INDIA","HEATHROW","DELHI",1021351,1021351,0
2018,"INDIAN SUB-CONTINENT","INDIA","HEATHROW","HYDERABAD ( RAJIV GHANDI )",140459,140459,0
2018,"INDIAN SUB-CONTINENT","INDIA","HEATHROW","MUMBAI",1121997,1121997,0
2018,"INDIAN SUB-CONTINENT","PAKISTAN","GATWICK","BENAZIR BHUTTO INTERNATIONAL AIRPORT",724,0,724
2018,"INDIAN SUB-CONTINENT","PAKISTAN","HEATHROW","BENAZIR BHUTTO INTERNATIONAL AIRPORT",123633,123633,0
2018,"INDIAN SUB-CONTINENT","PAKISTAN","HEATHROW","ISLAMABAD INTERNATIONAL AIRPORT",25933,25933,0
2018,"INDIAN SUB-CONTINENT","PAKISTAN","HEATHROW","KARACHI",49278,49278,0
2018,"INDIAN SUB-CONTINENT","PAKISTAN","HEATHROW","LAHORE",92561,92561,0
2018,"INDIAN SUB-CONTINENT","SRI LANKA","GATWICK","COLOMBO",8482,0,8482
2018,"INDIAN SUB-CONTINENT","SRI LANKA","HEATHROW","COLOMBO",225211,225211,0
2018,"INDIAN SUB-CONTINENT","SRI LANKA","HEATHROW","MATTALA RAJAPAKSA",0,0,0
2018,"FAR EAST","BRUNEI","HEATHROW","BANDAR SERI BEGAWAN",79062,79062,0
2018,"FAR EAST","CHINA","GATWICK","BEIJING",224,224,0
2018,"FAR EAST","CHINA","GATWICK","CHENGDU",27214,27214,0
2018,"FAR EAST","CHINA","GATWICK","CHONGQING JIANGBEI INTERNATIONAL",11034,11034,0
2018,"FAR EAST","CHINA","GATWICK","SHANGHAI (PU DONG)",4526,4526,0
2018,"FAR EAST","CHINA","GATWICK","TIANJIN",13821,13821,0
2018,"FAR EAST","CHINA","GATWICK","XIAMEN",0,0,0
2018,"FAR EAST","CHINA","HEATHROW","BEIJING",530314,530314,0
2018,"FAR EAST","CHINA","HEATHROW","CHANGSHA HUANGHUA INTERNATIONAL AIRPORT",34452,34452,0
2018,"FAR EAST","CHINA","HEATHROW","CHENGDU",0,0,0
2018,"FAR EAST","CHINA","HEATHROW","CHONGQING JIANGBEI INTERNATIONAL",12886,12886,0
2018,"FAR EAST","CHINA","HEATHROW","GUANGZHOU BAIYUN INTERNATIONAL",157231,157231,0
2018,"FAR EAST","CHINA","HEATHROW","QINGDAO",28699,26695,2004
2018,"FAR EAST","CHINA","HEATHROW","SANYA PHOENIX INTERNATIONAL",9383,9383,0
2018,"FAR EAST","CHINA","HEATHROW","SHANGHAI (PU DONG)",511003,511003,0
2018,"FAR EAST","CHINA","HEATHROW","TIANJIN",4851,4851,0
2018,"FAR EAST","CHINA","HEATHROW","WUHAN TIANHE INTERNATIONAL",30425,30425,0
2018,"FAR EAST","CHINA","HEATHROW","XIAN XIANYANG",25331,25331,0
2018,"FAR EAST","CHINA","STANSTED","BEIJING",0,0,0
2018,"FAR EAST","HONG KONG","GATWICK","HONG KONG (CHEK LAP KOK)",166758,166758,0
2018,"FAR EAST","HONG KONG","HEATHROW","HONG KONG (CHEK LAP KOK)",1572021,1572021,0
2018,"FAR EAST","INDONESIA","HEATHROW","JAKARTA (SOEKARNO-HATTA INTNL)",55264,55264,0
2018,"FAR EAST","JAPAN","HEATHROW","TOKYO (HANEDA)",587932,587932,0
2018,"FAR EAST","JAPAN","HEATHROW","TOKYO (NARITA)",130054,130054,0
2018,"FAR EAST","MALAYSIA","GATWICK","LANGKAWI",585,0,585
2018,"FAR EAST","MALAYSIA","HEATHROW","KUALA LUMPUR (SEPANG)",521674,521674,0
2018,"FAR EAST","MONGOLIA","GATWICK","ULAN BATOR",80,0,80
2018,"FAR EAST","PHILIPPINES","HEATHROW","MANILA",161339,161339,0
2018,"FAR EAST","REPUBLIC OF KOREA","GATWICK","SEOUL (INCHEON)",186,0,186
2018,"FAR EAST","REPUBLIC OF KOREA","HEATHROW","SEOUL (INCHEON)",526584,526584,0
2018,"FAR EAST","SINGAPORE","GATWICK","SINGAPORE",119140,119140,0
2018,"FAR EAST","SINGAPORE","HEATHROW","SINGAPORE",1421105,1421105,0
2018,"FAR EAST","TAIWAN","GATWICK","TAIPEI",114895,114895,0
2018,"FAR EAST","TAIWAN","HEATHROW","TAIPEI",31225,31225,0
2018,"FAR EAST","THAILAND","GATWICK","KRABI",4915,0,4915
2018,"FAR EAST","THAILAND","GATWICK","PHUKET",13970,0,13970
2018,"FAR EAST","THAILAND","GATWICK","U-TAPAO",585,0,585
2018,"FAR EAST","THAILAND","HEATHROW","BANGKOK SUVARNABHUMI ",828432,828432,0
2018,"FAR EAST","VIETNAM","GATWICK","PHU QUOC INTERNATIONAL",10074,0,10074
2018,"FAR EAST","VIETNAM","HEATHROW","HANOI",86576,86576,0
2018,"FAR EAST","VIETNAM","HEATHROW","HO CHI MINH CITY",65749,65749,0
2018,"AUSTRALASIA","AUSTRALIA","HEATHROW","BRISBANE",0,0,0
2018,"AUSTRALASIA","AUSTRALIA","HEATHROW","MELBOURNE",51499,51499,0
2018,"AUSTRALASIA","AUSTRALIA","HEATHROW","PERTH (AUSTRALIA)",108737,108737,0
2018,"AUSTRALASIA","AUSTRALIA","HEATHROW","SYDNEY",192603,192603,0
2018,"AUSTRALASIA","NEW ZEALAND","HEATHROW","AUCKLAND INTERNATIONAL",17419,17419,0
2018,"CANADA","CANADA","GATWICK","CALGARY",134547,134547,0
2018,"CANADA","CANADA","GATWICK","EDMONTON",11070,11070,0
2018,"CANADA","CANADA","GATWICK","GANDER",342,342,0
2018,"CANADA","CANADA","GATWICK","HALIFAX INT",49572,49572,0
2018,"CANADA","CANADA","GATWICK","MONTREAL (DORVAL)",25226,25226,0
2018,"CANADA","CANADA","GATWICK","OTTAWA INTERNATIONAL",774,774,0
2018,"CANADA","CANADA","GATWICK","ST JOHNS",500,500,0
2018,"CANADA","CANADA","GATWICK","TORONTO",431505,431505,0
2018,"CANADA","CANADA","GATWICK","VANCOUVER",163669,163669,0
2018,"CANADA","CANADA","GATWICK","WINNIPEG",5553,5553,0
2018,"CANADA","CANADA","HEATHROW","CALGARY",291248,291248,0
2018,"CANADA","CANADA","HEATHROW","HALIFAX INT",71799,71799,0
2018,"CANADA","CANADA","HEATHROW","MONTREAL (DORVAL)",321085,321085,0
2018,"CANADA","CANADA","HEATHROW","OTTAWA INTERNATIONAL",114365,114365,0
2018,"CANADA","CANADA","HEATHROW","ST JOHNS",39606,39606,0
2018,"CANADA","CANADA","HEATHROW","TORONTO",1091315,1091315,0
2018,"CANADA","CANADA","HEATHROW","VANCOUVER",546666,546666,0
2018,"CANADA","CANADA","STANSTED","TORONTO",20211,20211,0
2018,"UNITED STATES OF AMERICA","USA","GATWICK","AUSTIN (BERGSTROM)",54214,54214,0
2018,"UNITED STATES OF AMERICA","USA","GATWICK","BOSTON",209106,209106,0
2018,"UNITED STATES OF AMERICA","USA","GATWICK","CHARLOTTE",0,0,0
2018,"UNITED STATES OF AMERICA","USA","GATWICK","CHICAGO (O'HARE)",145697,145697,0
2018,"UNITED STATES OF AMERICA","USA","GATWICK","DALLAS/FORT WORTH",0,0,0
2018,"UNITED STATES OF AMERICA","USA","GATWICK","DENVER INTERNATIONAL",84217,84217,0
2018,"UNITED STATES OF AMERICA","USA","GATWICK","FORT LAUDERDALE",179438,179438,0
2018,"UNITED STATES OF AMERICA","USA","GATWICK","LAS VEGAS",306923,306923,0
2018,"UNITED STATES OF AMERICA","USA","GATWICK","LOS ANGELES INTERNATIONAL",283710,283710,0
2018,"UNITED STATES OF AMERICA","USA","GATWICK","NEW YORK (JF KENNEDY)",593620,593300,320
2018,"UNITED STATES OF AMERICA","USA","GATWICK","NEWBURGH/USA",344,344,0
2018,"UNITED STATES OF AMERICA","USA","GATWICK","OAKLAND",193615,193448,167
2018,"UNITED STATES OF AMERICA","USA","GATWICK","ORLANDO",876408,876102,306
2018,"UNITED STATES OF AMERICA","USA","GATWICK","PHOENIX",0,0,0
2018,"UNITED STATES OF AMERICA","USA","GATWICK","SAN BERNARDINO (NORTON AFB)",0,0,0
2018,"UNITED STATES OF AMERICA","USA","GATWICK","SANFORD",40391,0,40391
2018,"UNITED STATES OF AMERICA","USA","GATWICK","SEATTLE (TACOMA)",95714,95549,165
2018,"UNITED STATES OF AMERICA","USA","GATWICK","TAMPA",156527,156527,0
2018,"UNITED STATES OF AMERICA","USA","HEATHROW","ATLANTA",617007,617007,0
2018,"UNITED STATES OF AMERICA","USA","HEATHROW","AUSTIN (BERGSTROM)",171798,171798,0
2018,"UNITED STATES OF AMERICA","USA","HEATHROW","BALTIMORE",128387,128387,0
2018,"UNITED STATES OF AMERICA","USA","HEATHROW","BOSTON",849443,849443,0
2018,"UNITED STATES OF AMERICA","USA","HEATHROW","CHARLOTTE",302048,302048,0
2018,"UNITED STATES OF AMERICA","USA","HEATHROW","CHICAGO (O'HARE)",1158537,1158537,0
2018,"UNITED STATES OF AMERICA","USA","HEATHROW","CLEVELAND",147,0,147
2018,"UNITED STATES OF AMERICA","USA","HEATHROW","DALLAS/FORT WORTH",710461,710461,0
2018,"UNITED STATES OF AMERICA","USA","HEATHROW","DENVER INTERNATIONAL",282201,282201,0
2018,"UNITED STATES OF AMERICA","USA","HEATHROW","DETROIT",190484,190484,0
2018,"UNITED STATES OF AMERICA","USA","HEATHROW","FORT LAUDERDALE",0,0,0
2018,"UNITED STATES OF AMERICA","USA","HEATHROW","HOUSTON",500856,500856,0
2018,"UNITED STATES OF AMERICA","USA","HEATHROW","INDIANAPOLIS",0,0,0
2018,"UNITED STATES OF AMERICA","USA","HEATHROW","JACKSONVILLE",415,0,415
2018,"UNITED STATES OF AMERICA","USA","HEATHROW","LAS VEGAS",297490,297490,0
2018,"UNITED STATES OF AMERICA","USA","HEATHROW","LOS ANGELES INTERNATIONAL",1657737,1657580,157
2018,"UNITED STATES OF AMERICA","USA","HEATHROW","MIAMI INTERNATIONAL",1029366,1029176,190
2018,"UNITED STATES OF AMERICA","USA","HEATHROW","MINNEAPOLIS-ST PAUL",131244,131244,0
2018,"UNITED STATES OF AMERICA","USA","HEATHROW","NASHVILLE METROPOLITAN",58512,58183,329
2018,"UNITED STATES OF AMERICA","USA","HEATHROW","NEW ORLEANS",85932,85932,0
2018,"UNITED STATES OF AMERICA","USA","HEATHROW","NEW YORK (JF KENNEDY)",3034155,3034155,0
2018,"UNITED STATES OF AMERICA","USA","HEATHROW","NEW YORK (NEWARK)",1084275,1084275,0
2018,"UNITED STATES OF AMERICA","USA","HEATHROW","OAKLAND",164,0,164
2018,"UNITED STATES OF AMERICA","USA","HEATHROW","ORLANDO",2268,1611,657
2018,"UNITED STATES OF AMERICA","USA","HEATHROW","PHILADELPHIA INTERNATIONAL",466399,465749,650
2018,"UNITED STATES OF AMERICA","USA","HEATHROW","PHOENIX",248620,248620,0
2018,"UNITED STATES OF AMERICA","USA","HEATHROW","PORTLAND (OREGON)",32248,32248,0
2018,"UNITED STATES OF AMERICA","USA","HEATHROW","RALEIGH",132254,132254,0
2018,"UNITED STATES OF AMERICA","USA","HEATHROW","SALT LAKE CITY",71790,71790,0
2018,"UNITED STATES OF AMERICA","USA","HEATHROW","SAN DIEGO",173771,173771,0
2018,"UNITED STATES OF AMERICA","USA","HEATHROW","SAN FRANCISCO",1055976,1055976,0
2018,"UNITED STATES OF AMERICA","USA","HEATHROW","SAN JOSE",110016,110016,0
2018,"UNITED STATES OF AMERICA","USA","HEATHROW","SEATTLE (TACOMA)",397356,397356,0
2018,"UNITED STATES OF AMERICA","USA","HEATHROW","TAMPA",0,0,0
2018,"UNITED STATES OF AMERICA","USA","HEATHROW","WASHINGTON (DULLES)",838389,838389,0
2018,"UNITED STATES OF AMERICA","USA","LONDON CITY","NEW YORK (JF KENNEDY)",10514,10514,0
2018,"UNITED STATES OF AMERICA","USA","LUTON","MIAMI INTERNATIONAL",0,0,0
2018,"UNITED STATES OF AMERICA","USA","STANSTED","BOSTON",22494,22494,0
2018,"UNITED STATES OF AMERICA","USA","STANSTED","LAS VEGAS",3347,3347,0
2018,"UNITED STATES OF AMERICA","USA","STANSTED","LOS ANGELES INTERNATIONAL",0,0,0
2018,"UNITED STATES OF AMERICA","USA","STANSTED","NEW YORK (NEWARK)",48216,48216,0
2018,"UNITED STATES OF AMERICA","USA","STANSTED","ORLANDO",12242,12242,0
2018,"UNITED STATES OF AMERICA","USA","STANSTED","SANFORD",0,0,0
2018,"UNITED STATES OF AMERICA","USA","STANSTED","WASHINGTON (DULLES)",6033,6033,0
2018,"CENTRAL AMERICA","COSTA RICA","GATWICK","LIBERIA",30409,0,30409
2018,"CENTRAL AMERICA","COSTA RICA","GATWICK","SAN JOSE COST RICA",54659,54659,0
2018,"CENTRAL AMERICA","CUBA","GATWICK","CUNAGUA (CAYO COCO)",17163,17163,0
2018,"CENTRAL AMERICA","CUBA","GATWICK","HAVANA",77462,77381,81
2018,"CENTRAL AMERICA","CUBA","GATWICK","HOLGUIN (FRANK PAIS)",31796,31796,0
2018,"CENTRAL AMERICA","CUBA","GATWICK","VARADERO",25512,0,25512
2018,"CENTRAL AMERICA","CUBA","HEATHROW","HAVANA",385,385,0
2018,"CENTRAL AMERICA","DOMINICAN REPUBLIC","GATWICK","LA ROMANA",6502,0,6502
2018,"CENTRAL AMERICA","DOMINICAN REPUBLIC","GATWICK","PUERTO PLATA",9897,0,9897
2018,"CENTRAL AMERICA","DOMINICAN REPUBLIC","GATWICK","PUNTA CANA",168288,84743,83545
2018,"CENTRAL AMERICA","MEXICO","GATWICK","CANCUN",397071,397071,0
2018,"CENTRAL AMERICA","MEXICO","GATWICK","MERIDA",325,325,0
2018,"CENTRAL AMERICA","MEXICO","GATWICK","PUERTO VALLARTA",30800,0,30800
2018,"CENTRAL AMERICA","MEXICO","HEATHROW","MEXICO CITY",253958,253958,0
2018,"CENTRAL AMERICA","MEXICO","STANSTED","CANCUN",7089,7089,0
2018,"CENTRAL AMERICA","MEXICO","STANSTED","PUERTO VALLARTA",301,0,301
2018,"SOUTH AMERICA","ARGENTINA","GATWICK","BUENOS AIRES",105918,105918,0
2018,"SOUTH AMERICA","ARGENTINA","HEATHROW","BUENOS AIRES",173064,173064,0
2018,"SOUTH AMERICA","BRAZIL","HEATHROW","RIO DE JANEIRO (GALEAO)",122280,122280,0
2018,"SOUTH AMERICA","BRAZIL","HEATHROW","SAO PAULO (GUARULHOS)",451517,451517,0
2018,"SOUTH AMERICA","CHILE","HEATHROW","SANTIAGO DE CHILE",78256,78256,0
2018,"SOUTH AMERICA","COLOMBIA","HEATHROW","BOGOTA",162566,162566,0
2018,"SOUTH AMERICA","PERU","GATWICK","LIMA",45815,45815,0
2018,"SOUTH AMERICA","PERU","HEATHROW","LIMA",0,0,0
2018,"CARIBBEAN AREA","ANTIGUA AND BARBUDA","GATWICK","ANTIGUA",161620,161620,0
2018,"CARIBBEAN AREA","ANTIGUA AND BARBUDA","HEATHROW","ANTIGUA",268,268,0
2018,"CARIBBEAN AREA","BAHAMAS","HEATHROW","NASSAU",60556,60556,0
2018,"CARIBBEAN AREA","BARBADOS","GATWICK","BRIDGETOWN",463991,388696,75295
2018,"CARIBBEAN AREA","BARBADOS","HEATHROW","BRIDGETOWN",11840,9548,2292
2018,"CARIBBEAN AREA","BARBADOS","LUTON","BRIDGETOWN",300,300,0
2018,"CARIBBEAN AREA","BARBADOS","STANSTED","BRIDGETOWN",581,0,581
2018,"CARIBBEAN AREA","BERMUDA","GATWICK","BERMUDA",94895,94595,300
2018,"CARIBBEAN AREA","CAYMAN ISLANDS","HEATHROW","GRAND CAYMAN",35911,35911,0
2018,"CARIBBEAN AREA","GRENADA","GATWICK","GRENADA",30763,30763,0
2018,"CARIBBEAN AREA","GUADELOUPE","GATWICK","POINTE A PITRE GUADELOUPE",944,0,944
2018,"CARIBBEAN AREA","ISLE OF CURACAO NETH.ANTILLES","GATWICK","ARUBA",13534,0,13534
2018,"CARIBBEAN AREA","JAMAICA","GATWICK","KINGSTON",91204,91204,0
2018,"CARIBBEAN AREA","JAMAICA","GATWICK","MONTEGO BAY",213295,99241,114054
2018,"CARIBBEAN AREA","JAMAICA","STANSTED","MONTEGO BAY",612,0,612
2018,"CARIBBEAN AREA","PUERTO RICO","GATWICK","SAN JUAN (PUERTO RICO)",0,0,0
2018,"CARIBBEAN AREA","SAINT KITTS AND NEVIS","GATWICK","ST KITTS",16928,16928,0
2018,"CARIBBEAN AREA","ST LUCIA","GATWICK","ST LUCIA (HEWANORRA)",200141,168763,31378
2018,"CARIBBEAN AREA","TRINIDAD AND TOBAGO","GATWICK","PORT OF SPAIN",60122,60122,0
2018,"CARIBBEAN AREA","TRINIDAD AND TOBAGO","GATWICK","TOBAGO",33240,33240,0
2018,"CARIBBEAN AREA","TURKS AND CAICOS ISLANDS","GATWICK","PROVIDENCIALES",16251,16251,0
2018,"INDIAN OCEAN ISLANDS","MALDIVE ISLANDS","GATWICK","MALE INTERNATIONAL",28678,28678,0
2018,"INDIAN OCEAN ISLANDS","MALDIVE ISLANDS","HEATHROW","MALE INTERNATIONAL",242,242,0
2018,"INDIAN OCEAN ISLANDS","MAURITIUS","GATWICK","MAURITIUS",131786,129722,2064
2018,"INDIAN OCEAN ISLANDS","MAURITIUS","HEATHROW","MAURITIUS",88545,88545,0
2018,"INDIAN OCEAN ISLANDS","SEYCHELLES","HEATHROW","SEYCHELLES",28368,28368,0
2018,"ATLANTIC OCEAN ISLANDS","ASCENSION ISLAND","STANSTED","ASCENSION ISLAND",0,0,0
2018,"ATLANTIC OCEAN ISLANDS","CAPE VERDE ISLANDS","GATWICK","BOA VISTA (RABIL)",68377,68377,0
2018,"ATLANTIC OCEAN ISLANDS","CAPE VERDE ISLANDS","GATWICK","ILHA DO SAL C.VERDE",82010,81631,379
2018,"ATLANTIC OCEAN ISLANDS","CAPE VERDE ISLANDS","LUTON","BOA VISTA (RABIL)",217,0,217
2018,"ATLANTIC OCEAN ISLANDS","CAPE VERDE ISLANDS","LUTON","ILHA DO SAL C.VERDE",196,0,196
2018,"ATLANTIC OCEAN ISLANDS","CAPE VERDE ISLANDS","STANSTED","ILHA DO SAL C.VERDE",228,228,0
2019,"WESTERN EUROPE-EU","AUSTRIA","GATWICK","INNSBRUCK",189034,161407,27627
2019,"WESTERN EUROPE-EU","AUSTRIA","GATWICK","KLAGENFURT",8938,8938,0
2019,"WESTERN EUROPE-EU","AUSTRIA","GATWICK","LINZ",698,0,698
2019,"WESTERN EUROPE-EU","AUSTRIA","GATWICK","SALZBURG",130724,113882,16842
2019,"WESTERN EUROPE-EU","AUSTRIA","GATWICK","VIENNA",286944,286944,0
2019,"WESTERN EUROPE-EU","AUSTRIA","HEATHROW","INNSBRUCK",47564,47564,0
2019,"WESTERN EUROPE-EU","AUSTRIA","HEATHROW","SALZBURG",15474,15474,0
2019,"WESTERN EUROPE-EU","AUSTRIA","HEATHROW","VIENNA",835503,835503,0
2019,"WESTERN EUROPE-EU","AUSTRIA","LUTON","GRAZ",655,0,655
2019,"WESTERN EUROPE-EU","AUSTRIA","LUTON","INNSBRUCK",11716,11716,0
2019,"WESTERN EUROPE-EU","AUSTRIA","LUTON","LINZ",810,0,810
2019,"WESTERN EUROPE-EU","AUSTRIA","LUTON","SALZBURG",11769,8741,3028
2019,"WESTERN EUROPE-EU","AUSTRIA","LUTON","VIENNA",60324,60324,0
2019,"WESTERN EUROPE-EU","AUSTRIA","SOUTHEND","VIENNA",0,0,0
2019,"WESTERN EUROPE-EU","AUSTRIA","STANSTED","GRAZ",167,167,0
2019,"WESTERN EUROPE-EU","AUSTRIA","STANSTED","INNSBRUCK",9879,3375,6504
2019,"WESTERN EUROPE-EU","AUSTRIA","STANSTED","LINZ",238,0,238
2019,"WESTERN EUROPE-EU","AUSTRIA","STANSTED","SALZBURG",91881,87923,3958
2019,"WESTERN EUROPE-EU","AUSTRIA","STANSTED","VIENNA",231848,231744,104
2019,"WESTERN EUROPE-EU","BELGIUM","GATWICK","BRUSSELS",4111,4111,0
2019,"WESTERN EUROPE-EU","BELGIUM","HEATHROW","BRUSSELS",675645,675645,0
2019,"WESTERN EUROPE-EU","BELGIUM","LONDON CITY","ANTWERP",14995,14995,0
2019,"WESTERN EUROPE-EU","BELGIUM","LONDON CITY","BRUSSELS",0,0,0
2019,"WESTERN EUROPE-EU","BELGIUM","LUTON","ANTWERP",0,0,0
2019,"WESTERN EUROPE-EU","BELGIUM","LUTON","LIEGE",245,0,245
2019,"WESTERN EUROPE-EU","BELGIUM","LUTON","OSTEND",0,0,0
2019,"WESTERN EUROPE-EU","BELGIUM","SOUTHEND","ANTWERP",8121,8121,0
2019,"WESTERN EUROPE-EU","BELGIUM","STANSTED","BRUSSELS",291,181,110
2019,"WESTERN EUROPE-EU","BELGIUM","STANSTED","CHARLEROI",178,178,0
2019,"WESTERN EUROPE-EU","CROATIA","GATWICK","DUBROVNIK",237386,237386,0
2019,"WESTERN EUROPE-EU","CROATIA","GATWICK","PULA",51339,25906,25433
2019,"WESTERN EUROPE-EU","CROATIA","GATWICK","RIJEKA",6045,0,6045
2019,"WESTERN EUROPE-EU","CROATIA","GATWICK","SPLIT",178494,162597,15897
2019,"WESTERN EUROPE-EU","CROATIA","GATWICK","ZADAR",13897,13897,0
2019,"WESTERN EUROPE-EU","CROATIA","GATWICK","ZAGREB",217,217,0
2019,"WESTERN EUROPE-EU","CROATIA","HEATHROW","PULA",9114,9034,80
2019,"WESTERN EUROPE-EU","CROATIA","HEATHROW","SPLIT",49946,49946,0
2019,"WESTERN EUROPE-EU","CROATIA","HEATHROW","ZAGREB",141232,141232,0
2019,"WESTERN EUROPE-EU","CROATIA","LONDON CITY","SPLIT",5159,5159,0
2019,"WESTERN EUROPE-EU","CROATIA","LUTON","DUBROVNIK",24244,24244,0
2019,"WESTERN EUROPE-EU","CROATIA","LUTON","PULA",175,0,175
2019,"WESTERN EUROPE-EU","CROATIA","LUTON","SPLIT",89263,89136,127
2019,"WESTERN EUROPE-EU","CROATIA","LUTON","ZADAR",14630,14630,0
2019,"WESTERN EUROPE-EU","CROATIA","SOUTHEND","DUBROVNIK",17251,17251,0
2019,"WESTERN EUROPE-EU","CROATIA","SOUTHEND","PULA",15970,15970,0
2019,"WESTERN EUROPE-EU","CROATIA","SOUTHEND","ZADAR",0,0,0
2019,"WESTERN EUROPE-EU","CROATIA","STANSTED","DUBROVNIK",96119,96119,0
2019,"WESTERN EUROPE-EU","CROATIA","STANSTED","PULA",36735,36735,0
2019,"WESTERN EUROPE-EU","CROATIA","STANSTED","RIJEKA",11503,11503,0
2019,"WESTERN EUROPE-EU","CROATIA","STANSTED","SPLIT",50038,49666,372
2019,"WESTERN EUROPE-EU","CROATIA","STANSTED","ZADAR",42155,36170,5985
2019,"WESTERN EUROPE-EU","CYPRUS","GATWICK","LARNACA",242838,191167,51671
2019,"WESTERN EUROPE-EU","CYPRUS","GATWICK","PAPHOS",372265,285582,86683
2019,"WESTERN EUROPE-EU","CYPRUS","HEATHROW","LARNACA",234665,234665,0
2019,"WESTERN EUROPE-EU","CYPRUS","LUTON","LARNACA",255945,255945,0
2019,"WESTERN EUROPE-EU","CYPRUS","LUTON","PAPHOS",98097,81648,16449
2019,"WESTERN EUROPE-EU","CYPRUS","STANSTED","LARNACA",76769,67751,9018
2019,"WESTERN EUROPE-EU","CYPRUS","STANSTED","PAPHOS",238911,212272,26639
2019,"WESTERN EUROPE-EU","DENMARK","GATWICK","AALBORG",0,0,0
2019,"WESTERN EUROPE-EU","DENMARK","GATWICK","AARHUS (TIRSTRUP)",8753,8753,0
2019,"WESTERN EUROPE-EU","DENMARK","GATWICK","COPENHAGEN",770577,770527,50
2019,"WESTERN EUROPE-EU","DENMARK","GATWICK","RONNE",0,0,0
2019,"WESTERN EUROPE-EU","DENMARK","HEATHROW","BILLUND",91019,91019,0
2019,"WESTERN EUROPE-EU","DENMARK","HEATHROW","COPENHAGEN",947501,947501,0
2019,"WESTERN EUROPE-EU","DENMARK","LONDON CITY","BILLUND",21087,21087,0
2019,"WESTERN EUROPE-EU","DENMARK","LUTON","BILLUND",0,0,0
2019,"WESTERN EUROPE-EU","DENMARK","LUTON","COPENHAGEN",110981,110981,0
2019,"WESTERN EUROPE-EU","DENMARK","LUTON","KARUP",0,0,0
2019,"WESTERN EUROPE-EU","DENMARK","SOUTHEND","BILLUND",0,0,0
2019,"WESTERN EUROPE-EU","DENMARK","SOUTHEND","COPENHAGEN",25170,25170,0
2019,"WESTERN EUROPE-EU","DENMARK","SOUTHEND","KARUP",125,0,125
2019,"WESTERN EUROPE-EU","DENMARK","STANSTED","AALBORG",52411,52411,0
2019,"WESTERN EUROPE-EU","DENMARK","STANSTED","AARHUS (TIRSTRUP)",102796,102796,0
2019,"WESTERN EUROPE-EU","DENMARK","STANSTED","BILLUND",208715,208715,0
2019,"WESTERN EUROPE-EU","DENMARK","STANSTED","COPENHAGEN",384873,384873,0
2019,"WESTERN EUROPE-EU","DENMARK","STANSTED","KARUP",277,0,277
2019,"WESTERN EUROPE-EU","FINLAND","GATWICK","ENONTEKIO",2979,0,2979
2019,"WESTERN EUROPE-EU","FINLAND","GATWICK","HELSINKI",228891,228891,0
2019,"WESTERN EUROPE-EU","FINLAND","GATWICK","IVALO",13723,6608,7115
2019,"WESTERN EUROPE-EU","FINLAND","GATWICK","KITTILA",22153,2657,19496
2019,"WESTERN EUROPE-EU","FINLAND","GATWICK","KUUSAMO",5861,0,5861
2019,"WESTERN EUROPE-EU","FINLAND","GATWICK","ROVANIEMI",41057,29891,11166
2019,"WESTERN EUROPE-EU","FINLAND","HEATHROW","HELSINKI",817869,817869,0
2019,"WESTERN EUROPE-EU","FINLAND","LUTON","IVALO",722,0,722
2019,"WESTERN EUROPE-EU","FINLAND","LUTON","TURKU",11349,11349,0
2019,"WESTERN EUROPE-EU","FINLAND","STANSTED","ENONTEKIO",3313,0,3313
2019,"WESTERN EUROPE-EU","FINLAND","STANSTED","IVALO",2348,0,2348
2019,"WESTERN EUROPE-EU","FINLAND","STANSTED","KITTILA",375,0,375
2019,"WESTERN EUROPE-EU","FINLAND","STANSTED","ROVANIEMI",377,0,377
2019,"WESTERN EUROPE-EU","FRANCE","GATWICK","AJACCIO",3443,3443,0
2019,"WESTERN EUROPE-EU","FRANCE","GATWICK","BASTIA",6750,6750,0
2019,"WESTERN EUROPE-EU","FRANCE","GATWICK","BIARRITZ",23492,23492,0
2019,"WESTERN EUROPE-EU","FRANCE","GATWICK","BORDEAUX",325293,325293,0
2019,"WESTERN EUROPE-EU","FRANCE","GATWICK","CHAMBERY",48899,0,48899
2019,"WESTERN EUROPE-EU","FRANCE","GATWICK","FIGARI",6162,6162,0
2019,"WESTERN EUROPE-EU","FRANCE","GATWICK","GRENOBLE",111622,42822,68800
2019,"WESTERN EUROPE-EU","FRANCE","GATWICK","LA ROCHELLE",23253,23253,0
2019,"WESTERN EUROPE-EU","FRANCE","GATWICK","LILLE",164,0,164
2019,"WESTERN EUROPE-EU","FRANCE","GATWICK","LIMOGES",13199,13199,0
2019,"WESTERN EUROPE-EU","FRANCE","GATWICK","LYON",247110,228667,18443
2019,"WESTERN EUROPE-EU","FRANCE","GATWICK","MARSEILLE",154318,154218,100
2019,"WESTERN EUROPE-EU","FRANCE","GATWICK","MONTPELLIER",142629,142478,151
2019,"WESTERN EUROPE-EU","FRANCE","GATWICK","NANTES",164566,164566,0
2019,"WESTERN EUROPE-EU","FRANCE","GATWICK","NICE",620607,617704,2903
2019,"WESTERN EUROPE-EU","FRANCE","GATWICK","PARIS (CHARLES DE GAULLE)",580354,580354,0
2019,"WESTERN EUROPE-EU","FRANCE","GATWICK","PARIS (ORLY)",0,0,0
2019,"WESTERN EUROPE-EU","FRANCE","GATWICK","PAU",718,718,0
2019,"WESTERN EUROPE-EU","FRANCE","GATWICK","RENNES",182,0,182
2019,"WESTERN EUROPE-EU","FRANCE","GATWICK","TOULON / HYERES",78,0,78
2019,"WESTERN EUROPE-EU","FRANCE","GATWICK","TOULOUSE (BLAGNAC)",230131,224137,5994
2019,"WESTERN EUROPE-EU","FRANCE","HEATHROW","BASTIA",4711,4711,0
2019,"WESTERN EUROPE-EU","FRANCE","HEATHROW","FIGARI",4307,4307,0
2019,"WESTERN EUROPE-EU","FRANCE","HEATHROW","GRENOBLE",3779,3779,0
2019,"WESTERN EUROPE-EU","FRANCE","HEATHROW","LYON",273848,273848,0
2019,"WESTERN EUROPE-EU","FRANCE","HEATHROW","MARSEILLE",293354,293354,0
2019,"WESTERN EUROPE-EU","FRANCE","HEATHROW","MONTPELLIER",9157,9157,0
2019,"WESTERN EUROPE-EU","FRANCE","HEATHROW","NANTES",14404,14404,0
2019,"WESTERN EUROPE-EU","FRANCE","HEATHROW","NICE",511494,511494,0
2019,"WESTERN EUROPE-EU","FRANCE","HEATHROW","PARIS (CHARLES DE GAULLE)",1260985,1260985,0
2019,"WESTERN EUROPE-EU","FRANCE","HEATHROW","PARIS (ORLY)",0,0,0
2019,"WESTERN EUROPE-EU","FRANCE","HEATHROW","TOULOUSE (BLAGNAC)",269462,269462,0
2019,"WESTERN EUROPE-EU","FRANCE","LONDON CITY","BERGERAC",9747,9747,0
2019,"WESTERN EUROPE-EU","FRANCE","LONDON CITY","CHAMBERY",4838,4838,0
2019,"WESTERN EUROPE-EU","FRANCE","LONDON CITY","DINARD",135,0,135
2019,"WESTERN EUROPE-EU","FRANCE","LONDON CITY","NICE",40136,40136,0
2019,"WESTERN EUROPE-EU","FRANCE","LONDON CITY","PARIS (ORLY)",41221,41221,0
2019,"WESTERN EUROPE-EU","FRANCE","LONDON CITY","QUIMPER",6014,6014,0
2019,"WESTERN EUROPE-EU","FRANCE","LONDON CITY","RENNES",2726,2726,0
2019,"WESTERN EUROPE-EU","FRANCE","LUTON","BEZIERS",39403,39403,0
2019,"WESTERN EUROPE-EU","FRANCE","LUTON","BIARRITZ",4811,4811,0
2019,"WESTERN EUROPE-EU","FRANCE","LUTON","BORDEAUX",89542,89542,0
2019,"WESTERN EUROPE-EU","FRANCE","LUTON","CHAMBERY",2625,0,2625
2019,"WESTERN EUROPE-EU","FRANCE","LUTON","GRENOBLE",16335,15897,438
2019,"WESTERN EUROPE-EU","FRANCE","LUTON","LA ROCHELLE",168,168,0
2019,"WESTERN EUROPE-EU","FRANCE","LUTON","LYON",104615,104238,377
2019,"WESTERN EUROPE-EU","FRANCE","LUTON","MARSEILLE",43789,43789,0
2019,"WESTERN EUROPE-EU","FRANCE","LUTON","MONTPELLIER",11461,11461,0
2019,"WESTERN EUROPE-EU","FRANCE","LUTON","NANTES",49380,49380,0
2019,"WESTERN EUROPE-EU","FRANCE","LUTON","NICE",165727,164990,737
2019,"WESTERN EUROPE-EU","FRANCE","LUTON","NIMES",25947,25947,0
2019,"WESTERN EUROPE-EU","FRANCE","LUTON","PARIS (CHARLES DE GAULLE)",286380,286380,0
2019,"WESTERN EUROPE-EU","FRANCE","LUTON","PARIS (ORLY)",1284,0,1284
2019,"WESTERN EUROPE-EU","FRANCE","LUTON","PAU",193,193,0
2019,"WESTERN EUROPE-EU","FRANCE","LUTON","PERPIGNAN",0,0,0
2019,"WESTERN EUROPE-EU","FRANCE","LUTON","RENNES",146,0,146
2019,"WESTERN EUROPE-EU","FRANCE","LUTON","TARBES-LOURDES INTERNATIONAL",0,0,0
2019,"WESTERN EUROPE-EU","FRANCE","LUTON","TOULOUSE (BLAGNAC)",49742,49742,0
2019,"WESTERN EUROPE-EU","FRANCE","SOUTHEND","BORDEAUX",18367,18367,0
2019,"WESTERN EUROPE-EU","FRANCE","SOUTHEND","BREST",20268,20268,0
2019,"WESTERN EUROPE-EU","FRANCE","SOUTHEND","CAEN",17530,17530,0
2019,"WESTERN EUROPE-EU","FRANCE","SOUTHEND","CHATEAUROUX DEOLS",0,0,0
2019,"WESTERN EUROPE-EU","FRANCE","SOUTHEND","LYON",6312,6312,0
2019,"WESTERN EUROPE-EU","FRANCE","SOUTHEND","PARIS (CHARLES DE GAULLE)",54556,54556,0
2019,"WESTERN EUROPE-EU","FRANCE","SOUTHEND","PARIS (ORLY)",0,0,0
2019,"WESTERN EUROPE-EU","FRANCE","SOUTHEND","RENNES",42727,42727,0
2019,"WESTERN EUROPE-EU","FRANCE","SOUTHEND","TARBES-LOURDES INTERNATIONAL",1421,1421,0
2019,"WESTERN EUROPE-EU","FRANCE","STANSTED","AJACCIO",16748,16748,0
2019,"WESTERN EUROPE-EU","FRANCE","STANSTED","BASTIA",18400,18400,0
2019,"WESTERN EUROPE-EU","FRANCE","STANSTED","BERGERAC",93297,93297,0
2019,"WESTERN EUROPE-EU","FRANCE","STANSTED","BEZIERS",28245,28245,0
2019,"WESTERN EUROPE-EU","FRANCE","STANSTED","BIARRITZ",105069,105069,0
2019,"WESTERN EUROPE-EU","FRANCE","STANSTED","BORDEAUX",97419,97419,0
2019,"WESTERN EUROPE-EU","FRANCE","STANSTED","BREST",169,169,0
2019,"WESTERN EUROPE-EU","FRANCE","STANSTED","BRIVE-LA-GAILLARDE",17122,17122,0
2019,"WESTERN EUROPE-EU","FRANCE","STANSTED","CALVI",6656,6656,0
2019,"WESTERN EUROPE-EU","FRANCE","STANSTED","CARCASSONNE",85823,85823,0
2019,"WESTERN EUROPE-EU","FRANCE","STANSTED","CHAMBERY",18257,5202,13055
2019,"WESTERN EUROPE-EU","FRANCE","STANSTED","CLERMONT FERRAND",20020,20020,0
2019,"WESTERN EUROPE-EU","FRANCE","STANSTED","DINARD",77815,77815,0
2019,"WESTERN EUROPE-EU","FRANCE","STANSTED","DOLE",2768,2768,0
2019,"WESTERN EUROPE-EU","FRANCE","STANSTED","FIGARI",7772,7772,0
2019,"WESTERN EUROPE-EU","FRANCE","STANSTED","GRENOBLE",32717,30357,2360
2019,"WESTERN EUROPE-EU","FRANCE","STANSTED","LA ROCHELLE",55325,55325,0
2019,"WESTERN EUROPE-EU","FRANCE","STANSTED","LIMOGES",101735,101735,0
2019,"WESTERN EUROPE-EU","FRANCE","STANSTED","LYON",10832,9938,894
2019,"WESTERN EUROPE-EU","FRANCE","STANSTED","MARSEILLE",168675,168675,0
2019,"WESTERN EUROPE-EU","FRANCE","STANSTED","MONTPELLIER",88,88,0
2019,"WESTERN EUROPE-EU","FRANCE","STANSTED","NANTES",74068,74068,0
2019,"WESTERN EUROPE-EU","FRANCE","STANSTED","NICE",186784,186784,0
2019,"WESTERN EUROPE-EU","FRANCE","STANSTED","NIMES",39857,39857,0
2019,"WESTERN EUROPE-EU","FRANCE","STANSTED","PARIS (CHARLES DE GAULLE)",39685,39685,0
2019,"WESTERN EUROPE-EU","FRANCE","STANSTED","PARIS (ORLY)",150,150,0
2019,"WESTERN EUROPE-EU","FRANCE","STANSTED","PAU",367,367,0
2019,"WESTERN EUROPE-EU","FRANCE","STANSTED","PERPIGNAN",45858,45858,0
2019,"WESTERN EUROPE-EU","FRANCE","STANSTED","POITIERS",55874,55874,0
2019,"WESTERN EUROPE-EU","FRANCE","STANSTED","RENNES",564,189,375
2019,"WESTERN EUROPE-EU","FRANCE","STANSTED","RODEZ",9765,9765,0
2019,"WESTERN EUROPE-EU","FRANCE","STANSTED","STRASBOURG",18423,18423,0
2019,"WESTERN EUROPE-EU","FRANCE","STANSTED","TARBES-LOURDES INTERNATIONAL",60108,55237,4871
2019,"WESTERN EUROPE-EU","FRANCE","STANSTED","TOULON / HYERES",294,0,294
2019,"WESTERN EUROPE-EU","FRANCE","STANSTED","TOULOUSE (BLAGNAC)",211212,210844,368
2019,"WESTERN EUROPE-EU","FRANCE","STANSTED","TOURS",50608,50608,0
2019,"WESTERN EUROPE-EU","GERMANY","GATWICK","BERLIN (SCHONEFELD)",201998,201613,385
2019,"WESTERN EUROPE-EU","GERMANY","GATWICK","BERLIN (TEGEL)",279145,279145,0
2019,"WESTERN EUROPE-EU","GERMANY","GATWICK","BRAUNSCHWEIG",0,0,0
2019,"WESTERN EUROPE-EU","GERMANY","GATWICK","COLOGNE BONN",20633,20471,162
2019,"WESTERN EUROPE-EU","GERMANY","GATWICK","DUSSELDORF",129755,129698,57
2019,"WESTERN EUROPE-EU","GERMANY","GATWICK","FRANKFURT MAIN",109,0,109
2019,"WESTERN EUROPE-EU","GERMANY","GATWICK","FRIEDRICHSHAFEN",25389,14834,10555
2019,"WESTERN EUROPE-EU","GERMANY","GATWICK","HAMBURG",175124,175118,6
2019,"WESTERN EUROPE-EU","GERMANY","GATWICK","MUNICH",256926,256250,676
2019,"WESTERN EUROPE-EU","GERMANY","GATWICK","NUREMBERG",6219,6219,0
2019,"WESTERN EUROPE-EU","GERMANY","GATWICK","STUTTGART",124923,124923,0
2019,"WESTERN EUROPE-EU","GERMANY","HEATHROW","BERLIN (TEGEL)",752162,752162,0
2019,"WESTERN EUROPE-EU","GERMANY","HEATHROW","COLOGNE BONN",189557,189557,0
2019,"WESTERN EUROPE-EU","GERMANY","HEATHROW","DUSSELDORF",730850,730850,0
2019,"WESTERN EUROPE-EU","GERMANY","HEATHROW","FRANKFURT MAIN",1548995,1548995,0
2019,"WESTERN EUROPE-EU","GERMANY","HEATHROW","FRIEDRICHSHAFEN",574,0,574
2019,"WESTERN EUROPE-EU","GERMANY","HEATHROW","HAMBURG",613188,613188,0
2019,"WESTERN EUROPE-EU","GERMANY","HEATHROW","HANOVER",176409,176409,0
2019,"WESTERN EUROPE-EU","GERMANY","HEATHROW","MUNICH",1266993,1266993,0
2019,"WESTERN EUROPE-EU","GERMANY","HEATHROW","STUTTGART",342408,342408,0
2019,"WESTERN EUROPE-EU","GERMANY","LONDON CITY","BERLIN (TEGEL)",134994,134994,0
2019,"WESTERN EUROPE-EU","GERMANY","LONDON CITY","DUSSELDORF",150598,150598,0
2019,"WESTERN EUROPE-EU","GERMANY","LONDON CITY","FRANKFURT MAIN",267654,267654,0
2019,"WESTERN EUROPE-EU","GERMANY","LONDON CITY","MUNICH",107983,107864,119
2019,"WESTERN EUROPE-EU","GERMANY","LONDON CITY","SAARBRUCKEN",0,0,0
2019,"WESTERN EUROPE-EU","GERMANY","LUTON","BERLIN (SCHONEFELD)",182850,182850,0
2019,"WESTERN EUROPE-EU","GERMANY","LUTON","BERLIN (TEGEL)",0,0,0
2019,"WESTERN EUROPE-EU","GERMANY","LUTON","COLOGNE BONN",0,0,0
2019,"WESTERN EUROPE-EU","GERMANY","LUTON","DORTMUND",106914,106914,0
2019,"WESTERN EUROPE-EU","GERMANY","LUTON","DRESDEN",357,0,357
2019,"WESTERN EUROPE-EU","GERMANY","LUTON","DUSSELDORF",18,18,0
2019,"WESTERN EUROPE-EU","GERMANY","LUTON","FRANKFURT MAIN",216,216,0
2019,"WESTERN EUROPE-EU","GERMANY","LUTON","HAMBURG",0,0,0
2019,"WESTERN EUROPE-EU","GERMANY","LUTON","LEIPZIG",0,0,0
2019,"WESTERN EUROPE-EU","GERMANY","LUTON","MUNICH",82042,82042,0
2019,"WESTERN EUROPE-EU","GERMANY","LUTON","MUNSTER-OSNABRUCK",0,0,0
2019,"WESTERN EUROPE-EU","GERMANY","LUTON","NIEDERRHEIN",0,0,0
2019,"WESTERN EUROPE-EU","GERMANY","SOUTHEND","COLOGNE BONN",3988,3988,0
2019,"WESTERN EUROPE-EU","GERMANY","SOUTHEND","DUSSELDORF",35,35,0
2019,"WESTERN EUROPE-EU","GERMANY","SOUTHEND","MUNICH",38,38,0
2019,"WESTERN EUROPE-EU","GERMANY","SOUTHEND","PADERBORN",26,26,0
2019,"WESTERN EUROPE-EU","GERMANY","STANSTED","BERLIN (SCHONEFELD)",453874,453874,0
2019,"WESTERN EUROPE-EU","GERMANY","STANSTED","BERLIN (TEGEL)",6333,6333,0
2019,"WESTERN EUROPE-EU","GERMANY","STANSTED","BREMEN",187344,187344,0
2019,"WESTERN EUROPE-EU","GERMANY","STANSTED","COLOGNE BONN",380648,380292,356
2019,"WESTERN EUROPE-EU","GERMANY","STANSTED","DORTMUND",117708,117443,265
2019,"WESTERN EUROPE-EU","GERMANY","STANSTED","DRESDEN",8578,8433,145
2019,"WESTERN EUROPE-EU","GERMANY","STANSTED","FRANKFURT MAIN",254807,254345,462
2019,"WESTERN EUROPE-EU","GERMANY","STANSTED","FRIEDRICHSHAFEN",486,486,0
2019,"WESTERN EUROPE-EU","GERMANY","STANSTED","HAHN",18936,18857,79
2019,"WESTERN EUROPE-EU","GERMANY","STANSTED","HAMBURG",191584,191584,0
2019,"WESTERN EUROPE-EU","GERMANY","STANSTED","HANOVER",17127,16900,227
2019,"WESTERN EUROPE-EU","GERMANY","STANSTED","KARLSRUHE/BADEN BADEN",121023,121023,0
2019,"WESTERN EUROPE-EU","GERMANY","STANSTED","LEIPZIG",11090,11090,0
2019,"WESTERN EUROPE-EU","GERMANY","STANSTED","MEMMINGEN ALLGAU",79279,79279,0
2019,"WESTERN EUROPE-EU","GERMANY","STANSTED","MUNICH",122831,121395,1436
2019,"WESTERN EUROPE-EU","GERMANY","STANSTED","MUNSTER-OSNABRUCK",333,0,333
2019,"WESTERN EUROPE-EU","GERMANY","STANSTED","NIEDERRHEIN",27100,27100,0
2019,"WESTERN EUROPE-EU","GERMANY","STANSTED","NUREMBERG",192972,192972,0
2019,"WESTERN EUROPE-EU","GERMANY","STANSTED","STUTTGART",187,187,0
2019,"WESTERN EUROPE-EU","GIBRALTAR","GATWICK","GIBRALTAR",193394,193394,0
2019,"WESTERN EUROPE-EU","GIBRALTAR","HEATHROW","GIBRALTAR",162975,162975,0
2019,"WESTERN EUROPE-EU","GIBRALTAR","LUTON","GIBRALTAR",25609,25609,0
2019,"WESTERN EUROPE-EU","GIBRALTAR","STANSTED","GIBRALTAR",72,0,72
2019,"WESTERN EUROPE-EU","GREECE","GATWICK","ATHENS",225636,225571,65
2019,"WESTERN EUROPE-EU","GREECE","GATWICK","CHANIA",122304,89771,32533
2019,"WESTERN EUROPE-EU","GREECE","GATWICK","CORFU",217565,165292,52273
2019,"WESTERN EUROPE-EU","GREECE","GATWICK","HERAKLION",270599,222315,48284
2019,"WESTERN EUROPE-EU","GREECE","GATWICK","KALAMATA",35092,35028,64
2019,"WESTERN EUROPE-EU","GREECE","GATWICK","KAVALA",20559,7125,13434
2019,"WESTERN EUROPE-EU","GREECE","GATWICK","KEFALLINIA",121342,93428,27914
2019,"WESTERN EUROPE-EU","GREECE","GATWICK","KOS",135315,73434,61881
2019,"WESTERN EUROPE-EU","GREECE","GATWICK","LEMNOS",2955,2819,136
2019,"WESTERN EUROPE-EU","GREECE","GATWICK","MIKONOS",96128,95778,350
2019,"WESTERN EUROPE-EU","GREECE","GATWICK","MYTILINI",8838,8838,0
2019,"WESTERN EUROPE-EU","GREECE","GATWICK","PREVEZA",83669,53227,30442
2019,"WESTERN EUROPE-EU","GREECE","GATWICK","RHODES",194289,133767,60522
2019,"WESTERN EUROPE-EU","GREECE","GATWICK","SALONIKA",186533,168858,17675
2019,"WESTERN EUROPE-EU","GREECE","GATWICK","SAMOS",8553,1512,7041
2019,"WESTERN EUROPE-EU","GREECE","GATWICK","SKIATHOS",42396,24114,18282
2019,"WESTERN EUROPE-EU","GREECE","GATWICK","THIRA (SANTORINI)",115333,107261,8072
2019,"WESTERN EUROPE-EU","GREECE","GATWICK","VOLOS NEA ANCHILOS",13585,10306,3279
2019,"WESTERN EUROPE-EU","GREECE","GATWICK","ZAKINTHOS",137263,96639,40624
2019,"WESTERN EUROPE-EU","GREECE","HEATHROW","ATHENS",748688,748688,0
2019,"WESTERN EUROPE-EU","GREECE","HEATHROW","CHANIA",21036,21036,0
2019,"WESTERN EUROPE-EU","GREECE","HEATHROW","CORFU",90653,84848,5805
2019,"WESTERN EUROPE-EU","GREECE","HEATHROW","KALAMATA",25966,17484,8482
2019,"WESTERN EUROPE-EU","GREECE","HEATHROW","KEFALLINIA",16594,11172,5422
2019,"WESTERN EUROPE-EU","GREECE","HEATHROW","KOS",0,0,0
2019,"WESTERN EUROPE-EU","GREECE","HEATHROW","LEMNOS",15521,0,15521
2019,"WESTERN EUROPE-EU","GREECE","HEATHROW","MIKONOS",45918,45918,0
2019,"WESTERN EUROPE-EU","GREECE","HEATHROW","PREVEZA",30261,15007,15254
2019,"WESTERN EUROPE-EU","GREECE","HEATHROW","RHODES",9170,0,9170
2019,"WESTERN EUROPE-EU","GREECE","HEATHROW","THIRA (SANTORINI)",45106,45106,0
2019,"WESTERN EUROPE-EU","GREECE","HEATHROW","ZAKINTHOS",9943,9943,0
2019,"WESTERN EUROPE-EU","GREECE","LONDON CITY","MIKONOS",14433,14433,0
2019,"WESTERN EUROPE-EU","GREECE","LONDON CITY","SKIATHOS",5889,5889,0
2019,"WESTERN EUROPE-EU","GREECE","LONDON CITY","THIRA (SANTORINI)",3256,3256,0
2019,"WESTERN EUROPE-EU","GREECE","LUTON","ATHENS",244994,244994,0
2019,"WESTERN EUROPE-EU","GREECE","LUTON","CHANIA",0,0,0
2019,"WESTERN EUROPE-EU","GREECE","LUTON","CORFU",65949,55944,10005
2019,"WESTERN EUROPE-EU","GREECE","LUTON","HERAKLION",33555,31394,2161
2019,"WESTERN EUROPE-EU","GREECE","LUTON","KEFALLINIA",0,0,0
2019,"WESTERN EUROPE-EU","GREECE","LUTON","MIKONOS",19929,19929,0
2019,"WESTERN EUROPE-EU","GREECE","LUTON","RHODES",42546,20502,22044
2019,"WESTERN EUROPE-EU","GREECE","LUTON","SALONIKA",48950,40124,8826
2019,"WESTERN EUROPE-EU","GREECE","LUTON","SKIATHOS",6129,0,6129
2019,"WESTERN EUROPE-EU","GREECE","LUTON","ZAKINTHOS",10381,0,10381
2019,"WESTERN EUROPE-EU","GREECE","SOUTHEND","CORFU",20793,20793,0
2019,"WESTERN EUROPE-EU","GREECE","STANSTED","ATHENS",194579,193018,1561
2019,"WESTERN EUROPE-EU","GREECE","STANSTED","CHANIA",45650,45650,0
2019,"WESTERN EUROPE-EU","GREECE","STANSTED","CORFU",89281,73706,15575
2019,"WESTERN EUROPE-EU","GREECE","STANSTED","HERAKLION",67734,51087,16647
2019,"WESTERN EUROPE-EU","GREECE","STANSTED","KALAMATA",5855,5855,0
2019,"WESTERN EUROPE-EU","GREECE","STANSTED","KAVALA",0,0,0
2019,"WESTERN EUROPE-EU","GREECE","STANSTED","KEFALLINIA",38229,30514,7715
2019,"WESTERN EUROPE-EU","GREECE","STANSTED","KOS",41632,33279,8353
2019,"WESTERN EUROPE-EU","GREECE","STANSTED","MIKONOS",2578,2578,0
2019,"WESTERN EUROPE-EU","GREECE","STANSTED","MYTILINI",73,0,73
2019,"WESTERN EUROPE-EU","GREECE","STANSTED","PREVEZA",8414,5752,2662
2019,"WESTERN EUROPE-EU","GREECE","STANSTED","RHODES",96246,77505,18741
2019,"WESTERN EUROPE-EU","GREECE","STANSTED","SALONIKA",136253,136253,0
2019,"WESTERN EUROPE-EU","GREECE","STANSTED","SKIATHOS",7889,7889,0
2019,"WESTERN EUROPE-EU","GREECE","STANSTED","ZAKINTHOS",73550,66246,7304
2019,"WESTERN EUROPE-EU","IRISH REPUBLIC","GATWICK","CORK",125833,125833,0
2019,"WESTERN EUROPE-EU","IRISH REPUBLIC","GATWICK","DUBLIN",1347200,1347200,0
2019,"WESTERN EUROPE-EU","IRISH REPUBLIC","GATWICK","IRELAND WEST(KNOCK)",83361,83361,0
2019,"WESTERN EUROPE-EU","IRISH REPUBLIC","GATWICK","SHANNON",117088,117088,0
2019,"WESTERN EUROPE-EU","IRISH REPUBLIC","HEATHROW","CORK",379107,379107,0
2019,"WESTERN EUROPE-EU","IRISH REPUBLIC","HEATHROW","DUBLIN",1855333,1855333,0
2019,"WESTERN EUROPE-EU","IRISH REPUBLIC","HEATHROW","SHANNON",268189,268189,0
2019,"WESTERN EUROPE-EU","IRISH REPUBLIC","LONDON CITY","DUBLIN",462420,462410,10
2019,"WESTERN EUROPE-EU","IRISH REPUBLIC","LUTON","CORK",97243,97243,0
2019,"WESTERN EUROPE-EU","IRISH REPUBLIC","LUTON","DUBLIN",379069,379069,0
2019,"WESTERN EUROPE-EU","IRISH REPUBLIC","LUTON","IRELAND WEST(KNOCK)",135271,135271,0
2019,"WESTERN EUROPE-EU","IRISH REPUBLIC","LUTON","KERRY COUNTY",111742,111742,0
2019,"WESTERN EUROPE-EU","IRISH REPUBLIC","LUTON","SHANNON",41,41,0
2019,"WESTERN EUROPE-EU","IRISH REPUBLIC","SOUTHEND","DUBLIN",153995,153849,146
2019,"WESTERN EUROPE-EU","IRISH REPUBLIC","SOUTHEND","SHANNON",64,64,0
2019,"WESTERN EUROPE-EU","IRISH REPUBLIC","STANSTED","CORK",347059,347059,0
2019,"WESTERN EUROPE-EU","IRISH REPUBLIC","STANSTED","DUBLIN",908262,907857,405
2019,"WESTERN EUROPE-EU","IRISH REPUBLIC","STANSTED","IRELAND WEST(KNOCK)",162232,162232,0
2019,"WESTERN EUROPE-EU","IRISH REPUBLIC","STANSTED","KERRY COUNTY",83246,83246,0
2019,"WESTERN EUROPE-EU","IRISH REPUBLIC","STANSTED","SHANNON",201249,201249,0
2019,"WESTERN EUROPE-EU","ITALY","GATWICK","ALGHERO (FERTILIA)",7603,0,7603
2019,"WESTERN EUROPE-EU","ITALY","GATWICK","ANCONA",14930,14930,0
2019,"WESTERN EUROPE-EU","ITALY","GATWICK","BARI (PALESE)",107939,107939,0
2019,"WESTERN EUROPE-EU","ITALY","GATWICK","BERGAMO",27076,26889,187
2019,"WESTERN EUROPE-EU","ITALY","GATWICK","BOLOGNA",95938,95938,0
2019,"WESTERN EUROPE-EU","ITALY","GATWICK","BRINDISI",21945,21945,0
2019,"WESTERN EUROPE-EU","ITALY","GATWICK","CAGLIARI (ELMAS)",42835,42835,0
2019,"WESTERN EUROPE-EU","ITALY","GATWICK","CATANIA (FONTANAROSSA)",204132,193972,10160
2019,"WESTERN EUROPE-EU","ITALY","GATWICK","FLORENCE",121526,121526,0
2019,"WESTERN EUROPE-EU","ITALY","GATWICK","GENOA",72769,72769,0
2019,"WESTERN EUROPE-EU","ITALY","GATWICK","LAMETIA-TERME",8680,0,8680
2019,"WESTERN EUROPE-EU","ITALY","GATWICK","MILAN (LINATE)",218656,218656,0
2019,"WESTERN EUROPE-EU","ITALY","GATWICK","MILAN (MALPENSA)",644227,644094,133
2019,"WESTERN EUROPE-EU","ITALY","GATWICK","NAPLES",435312,387431,47881
2019,"WESTERN EUROPE-EU","ITALY","GATWICK","OLBIA",95199,86186,9013
2019,"WESTERN EUROPE-EU","ITALY","GATWICK","PALERMO",63938,63938,0
2019,"WESTERN EUROPE-EU","ITALY","GATWICK","PISA",188044,188044,0
2019,"WESTERN EUROPE-EU","ITALY","GATWICK","ROME (FIUMICINO)",740666,740666,0
2019,"WESTERN EUROPE-EU","ITALY","GATWICK","TURIN",209938,188088,21850
2019,"WESTERN EUROPE-EU","ITALY","GATWICK","VENICE",696161,689090,7071
2019,"WESTERN EUROPE-EU","ITALY","GATWICK","VERONA VILLAFRANCA",275519,256484,19035
2019,"WESTERN EUROPE-EU","ITALY","HEATHROW","BOLOGNA",310343,310343,0
2019,"WESTERN EUROPE-EU","ITALY","HEATHROW","BRINDISI",11992,11992,0
2019,"WESTERN EUROPE-EU","ITALY","HEATHROW","CAGLIARI (ELMAS)",4057,0,4057
2019,"WESTERN EUROPE-EU","ITALY","HEATHROW","LAMETIA-TERME",8315,0,8315
2019,"WESTERN EUROPE-EU","ITALY","HEATHROW","MILAN (LINATE)",501815,501815,0
2019,"WESTERN EUROPE-EU","ITALY","HEATHROW","MILAN (MALPENSA)",365044,365044,0
2019,"WESTERN EUROPE-EU","ITALY","HEATHROW","OLBIA",38798,28497,10301
2019,"WESTERN EUROPE-EU","ITALY","HEATHROW","PALERMO",28507,28507,0
2019,"WESTERN EUROPE-EU","ITALY","HEATHROW","PISA",174155,174155,0
2019,"WESTERN EUROPE-EU","ITALY","HEATHROW","ROME (FIUMICINO)",930930,930930,0
2019,"WESTERN EUROPE-EU","ITALY","HEATHROW","TREVISO",0,0,0
2019,"WESTERN EUROPE-EU","ITALY","HEATHROW","TURIN",0,0,0
2019,"WESTERN EUROPE-EU","ITALY","HEATHROW","VENICE",174134,174134,0
2019,"WESTERN EUROPE-EU","ITALY","HEATHROW","VERONA VILLAFRANCA",156,156,0
2019,"WESTERN EUROPE-EU","ITALY","LONDON CITY","BOLOGNA",0,0,0
2019,"WESTERN EUROPE-EU","ITALY","LONDON CITY","FLORENCE",73781,73781,0
2019,"WESTERN EUROPE-EU","ITALY","LONDON CITY","MILAN (LINATE)",276576,276576,0
2019,"WESTERN EUROPE-EU","ITALY","LONDON CITY","MILAN (MALPENSA)",80007,79898,109
2019,"WESTERN EUROPE-EU","ITALY","LONDON CITY","PISA",61,61,0
2019,"WESTERN EUROPE-EU","ITALY","LONDON CITY","ROME (FIUMICINO)",43842,43842,0
2019,"WESTERN EUROPE-EU","ITALY","LONDON CITY","TREVISO",2,2,0
2019,"WESTERN EUROPE-EU","ITALY","LONDON CITY","VENICE",20171,20171,0
2019,"WESTERN EUROPE-EU","ITALY","LUTON","ALGHERO (FERTILIA)",29357,29357,0
2019,"WESTERN EUROPE-EU","ITALY","LUTON","BARI (PALESE)",52054,52054,0
2019,"WESTERN EUROPE-EU","ITALY","LUTON","BOLOGNA",122695,122695,0
2019,"WESTERN EUROPE-EU","ITALY","LUTON","CATANIA (FONTANAROSSA)",62827,62827,0
2019,"WESTERN EUROPE-EU","ITALY","LUTON","FLORENCE",16042,16042,0
2019,"WESTERN EUROPE-EU","ITALY","LUTON","GENOA",18387,18387,0
2019,"WESTERN EUROPE-EU","ITALY","LUTON","MILAN (LINATE)",0,0,0
2019,"WESTERN EUROPE-EU","ITALY","LUTON","MILAN (MALPENSA)",171423,171171,252
2019,"WESTERN EUROPE-EU","ITALY","LUTON","NAPLES",126155,126040,115
2019,"WESTERN EUROPE-EU","ITALY","LUTON","OLBIA",20355,20355,0
2019,"WESTERN EUROPE-EU","ITALY","LUTON","PALERMO",30878,30878,0
2019,"WESTERN EUROPE-EU","ITALY","LUTON","PISA",91107,91107,0
2019,"WESTERN EUROPE-EU","ITALY","LUTON","ROME (FIUMICINO)",93481,93481,0
2019,"WESTERN EUROPE-EU","ITALY","LUTON","TURIN",11354,11354,0
2019,"WESTERN EUROPE-EU","ITALY","LUTON","VENICE",95243,95243,0
2019,"WESTERN EUROPE-EU","ITALY","LUTON","VERONA VILLAFRANCA",6478,6118,360
2019,"WESTERN EUROPE-EU","ITALY","SOUTHEND","BERGAMO",44672,44672,0
2019,"WESTERN EUROPE-EU","ITALY","SOUTHEND","CAGLIARI (ELMAS)",0,0,0
2019,"WESTERN EUROPE-EU","ITALY","SOUTHEND","CATANIA (FONTANAROSSA)",775,775,0
2019,"WESTERN EUROPE-EU","ITALY","SOUTHEND","MILAN (LINATE)",0,0,0
2019,"WESTERN EUROPE-EU","ITALY","SOUTHEND","MILAN (MALPENSA)",0,0,0
2019,"WESTERN EUROPE-EU","ITALY","SOUTHEND","TREVISO",7520,7520,0
2019,"WESTERN EUROPE-EU","ITALY","SOUTHEND","VENICE",37758,37758,0
2019,"WESTERN EUROPE-EU","ITALY","STANSTED","ALGHERO (FERTILIA)",31068,31068,0
2019,"WESTERN EUROPE-EU","ITALY","STANSTED","ANCONA",109197,109197,0
2019,"WESTERN EUROPE-EU","ITALY","STANSTED","BARI (PALESE)",125471,125471,0
2019,"WESTERN EUROPE-EU","ITALY","STANSTED","BERGAMO",504192,504192,0
2019,"WESTERN EUROPE-EU","ITALY","STANSTED","BOLOGNA",264822,264822,0
2019,"WESTERN EUROPE-EU","ITALY","STANSTED","BRINDISI",74901,74901,0
2019,"WESTERN EUROPE-EU","ITALY","STANSTED","CAGLIARI (ELMAS)",127945,127945,0
2019,"WESTERN EUROPE-EU","ITALY","STANSTED","CATANIA (FONTANAROSSA)",183,183,0
2019,"WESTERN EUROPE-EU","ITALY","STANSTED","COMISO",8338,8338,0
2019,"WESTERN EUROPE-EU","ITALY","STANSTED","FLORENCE",3874,3874,0
2019,"WESTERN EUROPE-EU","ITALY","STANSTED","GENOA",83609,83609,0
2019,"WESTERN EUROPE-EU","ITALY","STANSTED","LAMETIA-TERME",59509,59509,0
2019,"WESTERN EUROPE-EU","ITALY","STANSTED","MILAN (LINATE)",0,0,0
2019,"WESTERN EUROPE-EU","ITALY","STANSTED","MILAN (MALPENSA)",246679,246679,0
2019,"WESTERN EUROPE-EU","ITALY","STANSTED","NAPLES",319387,319057,330
2019,"WESTERN EUROPE-EU","ITALY","STANSTED","PALERMO",108148,108148,0
2019,"WESTERN EUROPE-EU","ITALY","STANSTED","PERUGIA",91897,91897,0
2019,"WESTERN EUROPE-EU","ITALY","STANSTED","PESCARA",92570,92570,0
2019,"WESTERN EUROPE-EU","ITALY","STANSTED","PISA",327625,327625,0
2019,"WESTERN EUROPE-EU","ITALY","STANSTED","RIMINI",20294,20198,96
2019,"WESTERN EUROPE-EU","ITALY","STANSTED","ROME (CIAMPINO)",626868,626868,0
2019,"WESTERN EUROPE-EU","ITALY","STANSTED","ROME (FIUMICINO)",1583,1583,0
2019,"WESTERN EUROPE-EU","ITALY","STANSTED","TREVISO",80828,80828,0
2019,"WESTERN EUROPE-EU","ITALY","STANSTED","TRIESTE (RONCHI DEI LEGIONARI)",62815,62815,0
2019,"WESTERN EUROPE-EU","ITALY","STANSTED","TURIN",140139,135240,4899
2019,"WESTERN EUROPE-EU","ITALY","STANSTED","VENICE",254921,254921,0
2019,"WESTERN EUROPE-EU","ITALY","STANSTED","VERONA VILLAFRANCA",87772,87194,578
2019,"WESTERN EUROPE-EU","LUXEMBOURG","GATWICK","LUXEMBOURG",65662,65662,0
2019,"WESTERN EUROPE-EU","LUXEMBOURG","HEATHROW","LUXEMBOURG",181538,181538,0
2019,"WESTERN EUROPE-EU","LUXEMBOURG","LONDON CITY","LUXEMBOURG",177018,177018,0
2019,"WESTERN EUROPE-EU","LUXEMBOURG","LUTON","LUXEMBOURG",66,66,0
2019,"WESTERN EUROPE-EU","LUXEMBOURG","SOUTHEND","LUXEMBOURG",73,73,0
2019,"WESTERN EUROPE-EU","LUXEMBOURG","STANSTED","LUXEMBOURG",104466,104466,0
2019,"WESTERN EUROPE-EU","MALTA","GATWICK","MALTA",400620,376073,24547
2019,"WESTERN EUROPE-EU","MALTA","HEATHROW","MALTA",201035,201035,0
2019,"WESTERN EUROPE-EU","MALTA","LUTON","MALTA",115466,115466,0
2019,"WESTERN EUROPE-EU","MALTA","SOUTHEND","MALTA",66329,66329,0
2019,"WESTERN EUROPE-EU","MALTA","STANSTED","MALTA",115975,115975,0
2019,"WESTERN EUROPE-EU","NETHERLANDS","GATWICK","AMSTERDAM",1098936,1098711,225
2019,"WESTERN EUROPE-EU","NETHERLANDS","HEATHROW","AMSTERDAM",1748216,1748216,0
2019,"WESTERN EUROPE-EU","NETHERLANDS","LONDON CITY","AMSTERDAM",667584,667584,0
2019,"WESTERN EUROPE-EU","NETHERLANDS","LONDON CITY","ROTTERDAM",177797,177797,0
2019,"WESTERN EUROPE-EU","NETHERLANDS","LUTON","AMSTERDAM",840703,840703,0
2019,"WESTERN EUROPE-EU","NETHERLANDS","LUTON","EINDHOVEN",228,228,0
2019,"WESTERN EUROPE-EU","NETHERLANDS","LUTON","MAASTRICHT",0,0,0
2019,"WESTERN EUROPE-EU","NETHERLANDS","LUTON","ROTTERDAM",288,0,288
2019,"WESTERN EUROPE-EU","NETHERLANDS","SOUTHEND","AMSTERDAM",201625,201625,0
2019,"WESTERN EUROPE-EU","NETHERLANDS","SOUTHEND","GRONINGEN",41847,41847,0
2019,"WESTERN EUROPE-EU","NETHERLANDS","STANSTED","AMSTERDAM",363360,363114,246
2019,"WESTERN EUROPE-EU","NETHERLANDS","STANSTED","EINDHOVEN",316885,316885,0
2019,"WESTERN EUROPE-EU","NETHERLANDS","STANSTED","GRONINGEN",0,0,0
2019,"WESTERN EUROPE-EU","NETHERLANDS","STANSTED","ROTTERDAM",95,95,0
2019,"WESTERN EUROPE-EU","PORTUGAL(EXCLUDING MADEIRA)","GATWICK","AZORES PONTA DELGADA",3030,3030,0
2019,"WESTERN EUROPE-EU","PORTUGAL(EXCLUDING MADEIRA)","GATWICK","FARO",714325,688842,25483
2019,"WESTERN EUROPE-EU","PORTUGAL(EXCLUDING MADEIRA)","GATWICK","LISBON",376093,376000,93
2019,"WESTERN EUROPE-EU","PORTUGAL(EXCLUDING MADEIRA)","GATWICK","OPORTO (PORTUGAL)",387074,387074,0
2019,"WESTERN EUROPE-EU","PORTUGAL(EXCLUDING MADEIRA)","HEATHROW","FARO",71325,71325,0
2019,"WESTERN EUROPE-EU","PORTUGAL(EXCLUDING MADEIRA)","HEATHROW","LISBON",943228,943228,0
2019,"WESTERN EUROPE-EU","PORTUGAL(EXCLUDING MADEIRA)","LONDON CITY","FARO",12476,12476,0
2019,"WESTERN EUROPE-EU","PORTUGAL(EXCLUDING MADEIRA)","LONDON CITY","LISBON",66171,66171,0
2019,"WESTERN EUROPE-EU","PORTUGAL(EXCLUDING MADEIRA)","LONDON CITY","OPORTO (PORTUGAL)",32809,32809,0
2019,"WESTERN EUROPE-EU","PORTUGAL(EXCLUDING MADEIRA)","LUTON","FARO",284291,281897,2394
2019,"WESTERN EUROPE-EU","PORTUGAL(EXCLUDING MADEIRA)","LUTON","LISBON",414477,414349,128
2019,"WESTERN EUROPE-EU","PORTUGAL(EXCLUDING MADEIRA)","LUTON","OPORTO (PORTUGAL)",87697,87578,119
2019,"WESTERN EUROPE-EU","PORTUGAL(EXCLUDING MADEIRA)","SOUTHEND","FARO",161755,161755,0
2019,"WESTERN EUROPE-EU","PORTUGAL(EXCLUDING MADEIRA)","SOUTHEND","OPORTO (PORTUGAL)",156,156,0
2019,"WESTERN EUROPE-EU","PORTUGAL(EXCLUDING MADEIRA)","STANSTED","AZORES PONTA DELGADA",17090,17090,0
2019,"WESTERN EUROPE-EU","PORTUGAL(EXCLUDING MADEIRA)","STANSTED","FARO",399477,381652,17825
2019,"WESTERN EUROPE-EU","PORTUGAL(EXCLUDING MADEIRA)","STANSTED","LISBON",465027,464503,524
2019,"WESTERN EUROPE-EU","PORTUGAL(EXCLUDING MADEIRA)","STANSTED","OPORTO (PORTUGAL)",348232,348027,205
2019,"WESTERN EUROPE-EU","PORTUGAL(MADEIRA)","GATWICK","FUNCHAL",262527,232302,30225
2019,"WESTERN EUROPE-EU","PORTUGAL(MADEIRA)","GATWICK","PORTO SANTO",8927,0,8927
2019,"WESTERN EUROPE-EU","PORTUGAL(MADEIRA)","LUTON","FUNCHAL",2138,0,2138
2019,"WESTERN EUROPE-EU","PORTUGAL(MADEIRA)","STANSTED","FUNCHAL",60500,60500,0
2019,"WESTERN EUROPE-EU","SLOVENIA","GATWICK","LJUBLJANA",61299,61299,0
2019,"WESTERN EUROPE-EU","SLOVENIA","HEATHROW","LJUBLJANA",4497,4497,0
2019,"WESTERN EUROPE-EU","SLOVENIA","LUTON","LJUBLJANA",45493,45493,0
2019,"WESTERN EUROPE-EU","SLOVENIA","STANSTED","LJUBLJANA",120413,120413,0
2019,"WESTERN EUROPE-EU","SPAIN","GATWICK","ALICANTE",891356,856788,34568
2019,"WESTERN EUROPE-EU","SPAIN","GATWICK","ALMERIA",145469,136823,8646
2019,"WESTERN EUROPE-EU","SPAIN","GATWICK","ASTURIAS",35520,35520,0
2019,"WESTERN EUROPE-EU","SPAIN","GATWICK","BARCELONA",1586932,1586574,358
2019,"WESTERN EUROPE-EU","SPAIN","GATWICK","BILBAO",215907,215907,0
2019,"WESTERN EUROPE-EU","SPAIN","GATWICK","GIRONA",14479,0,14479
2019,"WESTERN EUROPE-EU","SPAIN","GATWICK","GRANADA",47591,47591,0
2019,"WESTERN EUROPE-EU","SPAIN","GATWICK","IBIZA",280657,225573,55084
2019,"WESTERN EUROPE-EU","SPAIN","GATWICK","JEREZ",35195,25967,9228
2019,"WESTERN EUROPE-EU","SPAIN","GATWICK","LIEIDA",5674,0,5674
2019,"WESTERN EUROPE-EU","SPAIN","GATWICK","MADRID",1030956,1030956,0
2019,"WESTERN EUROPE-EU","SPAIN","GATWICK","MAHON",237337,187069,50268
2019,"WESTERN EUROPE-EU","SPAIN","GATWICK","MALAGA",1112615,1070960,41655
2019,"WESTERN EUROPE-EU","SPAIN","GATWICK","MURCIA INTERNATIONAL",181236,181236,0
2019,"WESTERN EUROPE-EU","SPAIN","GATWICK","MURCIA SAN JAVIER",3557,3557,0
2019,"WESTERN EUROPE-EU","SPAIN","GATWICK","PALMA DE MALLORCA",772671,665136,107535
2019,"WESTERN EUROPE-EU","SPAIN","GATWICK","REUS",43331,16400,26931
2019,"WESTERN EUROPE-EU","SPAIN","GATWICK","SANTIAGO DE COMPOSTELA (SPAIN)",22084,22084,0
2019,"WESTERN EUROPE-EU","SPAIN","GATWICK","SEVILLE",240453,239445,1008
2019,"WESTERN EUROPE-EU","SPAIN","GATWICK","VALENCIA",307712,307435,277
2019,"WESTERN EUROPE-EU","SPAIN","GATWICK","VIGO",0,0,0
2019,"WESTERN EUROPE-EU","SPAIN","GATWICK","VITORIA",44,0,44
2019,"WESTERN EUROPE-EU","SPAIN","GATWICK","ZARAGOZA",0,0,0
2019,"WESTERN EUROPE-EU","SPAIN","HEATHROW","A CORUNA",112412,112412,0
2019,"WESTERN EUROPE-EU","SPAIN","HEATHROW","ALMERIA",0,0,0
2019,"WESTERN EUROPE-EU","SPAIN","HEATHROW","ASTURIAS",0,0,0
2019,"WESTERN EUROPE-EU","SPAIN","HEATHROW","BARCELONA",785125,785125,0
2019,"WESTERN EUROPE-EU","SPAIN","HEATHROW","BILBAO",24617,24617,0
2019,"WESTERN EUROPE-EU","SPAIN","HEATHROW","IBIZA",72057,72057,0
2019,"WESTERN EUROPE-EU","SPAIN","HEATHROW","JEREZ",0,0,0
2019,"WESTERN EUROPE-EU","SPAIN","HEATHROW","MADRID",1476551,1475893,658
2019,"WESTERN EUROPE-EU","SPAIN","HEATHROW","MAHON",0,0,0
2019,"WESTERN EUROPE-EU","SPAIN","HEATHROW","MALAGA",120345,120345,0
2019,"WESTERN EUROPE-EU","SPAIN","HEATHROW","MURCIA SAN JAVIER",0,0,0
2019,"WESTERN EUROPE-EU","SPAIN","HEATHROW","PALMA DE MALLORCA",141246,141246,0
2019,"WESTERN EUROPE-EU","SPAIN","HEATHROW","SANTIAGO DE COMPOSTELA (SPAIN)",204,204,0
2019,"WESTERN EUROPE-EU","SPAIN","HEATHROW","VALENCIA",99320,99320,0
2019,"WESTERN EUROPE-EU","SPAIN","LONDON CITY","GRANADA",14832,14832,0
2019,"WESTERN EUROPE-EU","SPAIN","LONDON CITY","IBIZA",95785,95785,0
2019,"WESTERN EUROPE-EU","SPAIN","LONDON CITY","MADRID",0,0,0
2019,"WESTERN EUROPE-EU","SPAIN","LONDON CITY","MAHON",3278,3278,0
2019,"WESTERN EUROPE-EU","SPAIN","LONDON CITY","MALAGA",60396,60396,0
2019,"WESTERN EUROPE-EU","SPAIN","LONDON CITY","PALMA DE MALLORCA",44714,44714,0
2019,"WESTERN EUROPE-EU","SPAIN","LUTON","ALICANTE",317161,317161,0
2019,"WESTERN EUROPE-EU","SPAIN","LUTON","ALMERIA",0,0,0
2019,"WESTERN EUROPE-EU","SPAIN","LUTON","BARCELONA",468761,468761,0
2019,"WESTERN EUROPE-EU","SPAIN","LUTON","CASTELLON COSTA AZAHAR",1349,1349,0
2019,"WESTERN EUROPE-EU","SPAIN","LUTON","CASTELLON DE LA PLANA AIRPORT",559,559,0
2019,"WESTERN EUROPE-EU","SPAIN","LUTON","GIRONA",29914,29914,0
2019,"WESTERN EUROPE-EU","SPAIN","LUTON","IBIZA",86686,75764,10922
2019,"WESTERN EUROPE-EU","SPAIN","LUTON","MADRID",134769,132905,1864
2019,"WESTERN EUROPE-EU","SPAIN","LUTON","MAHON",47508,45460,2048
2019,"WESTERN EUROPE-EU","SPAIN","LUTON","MALAGA",381836,377588,4248
2019,"WESTERN EUROPE-EU","SPAIN","LUTON","MURCIA INTERNATIONAL",81037,81037,0
2019,"WESTERN EUROPE-EU","SPAIN","LUTON","MURCIA SAN JAVIER",1827,1827,0
2019,"WESTERN EUROPE-EU","SPAIN","LUTON","PALMA DE MALLORCA",235183,209199,25984
2019,"WESTERN EUROPE-EU","SPAIN","LUTON","REUS",19744,17682,2062
2019,"WESTERN EUROPE-EU","SPAIN","LUTON","SEVILLE",55223,55223,0
2019,"WESTERN EUROPE-EU","SPAIN","LUTON","VALENCIA",42781,42640,141
2019,"WESTERN EUROPE-EU","SPAIN","LUTON","VIGO",0,0,0
2019,"WESTERN EUROPE-EU","SPAIN","LUTON","VITORIA",90,0,90
2019,"WESTERN EUROPE-EU","SPAIN","SOUTHEND","ALICANTE",199397,199397,0
2019,"WESTERN EUROPE-EU","SPAIN","SOUTHEND","BARCELONA",49125,49125,0
2019,"WESTERN EUROPE-EU","SPAIN","SOUTHEND","BILBAO",41500,41500,0
2019,"WESTERN EUROPE-EU","SPAIN","SOUTHEND","GIRONA",13,13,0
2019,"WESTERN EUROPE-EU","SPAIN","SOUTHEND","IBIZA",24569,24569,0
2019,"WESTERN EUROPE-EU","SPAIN","SOUTHEND","MAHON",17254,17254,0
2019,"WESTERN EUROPE-EU","SPAIN","SOUTHEND","MALAGA",163639,163639,0
2019,"WESTERN EUROPE-EU","SPAIN","SOUTHEND","MURCIA INTERNATIONAL",28500,28500,0
2019,"WESTERN EUROPE-EU","SPAIN","SOUTHEND","MURCIA SAN JAVIER",967,967,0
2019,"WESTERN EUROPE-EU","SPAIN","SOUTHEND","PALMA DE MALLORCA",143888,143888,0
2019,"WESTERN EUROPE-EU","SPAIN","SOUTHEND","REUS",20214,20214,0
2019,"WESTERN EUROPE-EU","SPAIN","STANSTED","ALICANTE",372931,372931,0
2019,"WESTERN EUROPE-EU","SPAIN","STANSTED","ALMERIA",39417,39417,0
2019,"WESTERN EUROPE-EU","SPAIN","STANSTED","ASTURIAS",0,0,0
2019,"WESTERN EUROPE-EU","SPAIN","STANSTED","BARCELONA",519495,519038,457
2019,"WESTERN EUROPE-EU","SPAIN","STANSTED","BILBAO",119782,119782,0
2019,"WESTERN EUROPE-EU","SPAIN","STANSTED","CASTELLON COSTA AZAHAR",31944,31944,0
2019,"WESTERN EUROPE-EU","SPAIN","STANSTED","CASTELLON DE LA PLANA AIRPORT",15004,15004,0
2019,"WESTERN EUROPE-EU","SPAIN","STANSTED","GIRONA",80751,80751,0
2019,"WESTERN EUROPE-EU","SPAIN","STANSTED","IBIZA",281760,266563,15197
2019,"WESTERN EUROPE-EU","SPAIN","STANSTED","JEREZ",56249,56249,0
2019,"WESTERN EUROPE-EU","SPAIN","STANSTED","LEON",0,0,0
2019,"WESTERN EUROPE-EU","SPAIN","STANSTED","LIEIDA",3546,3546,0
2019,"WESTERN EUROPE-EU","SPAIN","STANSTED","MADRID",500640,496200,4440
2019,"WESTERN EUROPE-EU","SPAIN","STANSTED","MAHON",88944,71627,17317
2019,"WESTERN EUROPE-EU","SPAIN","STANSTED","MALAGA",492948,492948,0
2019,"WESTERN EUROPE-EU","SPAIN","STANSTED","MURCIA INTERNATIONAL",129163,125766,3397
2019,"WESTERN EUROPE-EU","SPAIN","STANSTED","MURCIA SAN JAVIER",2778,2778,0
2019,"WESTERN EUROPE-EU","SPAIN","STANSTED","PALMA DE MALLORCA",478128,453661,24467
2019,"WESTERN EUROPE-EU","SPAIN","STANSTED","REUS",80611,80611,0
2019,"WESTERN EUROPE-EU","SPAIN","STANSTED","SALAMANCA",0,0,0
2019,"WESTERN EUROPE-EU","SPAIN","STANSTED","SANTANDER",86110,86110,0
2019,"WESTERN EUROPE-EU","SPAIN","STANSTED","SANTIAGO DE COMPOSTELA (SPAIN)",115128,115128,0
2019,"WESTERN EUROPE-EU","SPAIN","STANSTED","SEVILLE",164094,163998,96
2019,"WESTERN EUROPE-EU","SPAIN","STANSTED","VALENCIA",166276,166276,0
2019,"WESTERN EUROPE-EU","SPAIN","STANSTED","VALLADOLID",0,0,0
2019,"WESTERN EUROPE-EU","SPAIN","STANSTED","VIGO",3325,3325,0
2019,"WESTERN EUROPE-EU","SPAIN","STANSTED","ZARAGOZA",91724,91724,0
2019,"WESTERN EUROPE-EU","SPAIN(CANARY ISLANDS)","GATWICK","ARRECIFE",354946,279998,74948
2019,"WESTERN EUROPE-EU","SPAIN(CANARY ISLANDS)","GATWICK","FUERTEVENTURA",201762,150087,51675
2019,"WESTERN EUROPE-EU","SPAIN(CANARY ISLANDS)","GATWICK","LAS PALMAS",259755,181387,78368
2019,"WESTERN EUROPE-EU","SPAIN(CANARY ISLANDS)","GATWICK","SANTA CRUZ DE LA PALMA",31845,13984,17861
2019,"WESTERN EUROPE-EU","SPAIN(CANARY ISLANDS)","GATWICK","TENERIFE (NORTE LOS RODEOS)",142,142,0
2019,"WESTERN EUROPE-EU","SPAIN(CANARY ISLANDS)","GATWICK","TENERIFE (SURREINA SOFIA)",697879,562917,134962
2019,"WESTERN EUROPE-EU","SPAIN(CANARY ISLANDS)","HEATHROW","LAS PALMAS",15916,15916,0
2019,"WESTERN EUROPE-EU","SPAIN(CANARY ISLANDS)","HEATHROW","TENERIFE (SURREINA SOFIA)",14408,14408,0
2019,"WESTERN EUROPE-EU","SPAIN(CANARY ISLANDS)","LUTON","ARRECIFE",108892,75763,33129
2019,"WESTERN EUROPE-EU","SPAIN(CANARY ISLANDS)","LUTON","FUERTEVENTURA",31033,29938,1095
2019,"WESTERN EUROPE-EU","SPAIN(CANARY ISLANDS)","LUTON","LAS PALMAS",38739,22542,16197
2019,"WESTERN EUROPE-EU","SPAIN(CANARY ISLANDS)","LUTON","TENERIFE (SURREINA SOFIA)",127321,95075,32246
2019,"WESTERN EUROPE-EU","SPAIN(CANARY ISLANDS)","SOUTHEND","ARRECIFE",14653,14653,0
2019,"WESTERN EUROPE-EU","SPAIN(CANARY ISLANDS)","SOUTHEND","TENERIFE (SURREINA SOFIA)",15042,15042,0
2019,"WESTERN EUROPE-EU","SPAIN(CANARY ISLANDS)","STANSTED","ARRECIFE",249481,241588,7893
2019,"WESTERN EUROPE-EU","SPAIN(CANARY ISLANDS)","STANSTED","FUERTEVENTURA",146059,140482,5577
2019,"WESTERN EUROPE-EU","SPAIN(CANARY ISLANDS)","STANSTED","LAS PALMAS",202055,183776,18279
2019,"WESTERN EUROPE-EU","SPAIN(CANARY ISLANDS)","STANSTED","TENERIFE (SURREINA SOFIA)",404079,376286,27793
2019,"WESTERN EUROPE-EU","SWEDEN","GATWICK","GOTEBORG (LANDVETTER)",172358,172358,0
2019,"WESTERN EUROPE-EU","SWEDEN","GATWICK","KIRUNA",0,0,0
2019,"WESTERN EUROPE-EU","SWEDEN","GATWICK","MALMO",222,0,222
2019,"WESTERN EUROPE-EU","SWEDEN","GATWICK","OSTERSUND / FROSON",9641,9641,0
2019,"WESTERN EUROPE-EU","SWEDEN","GATWICK","PAJALA YLLAS",376,0,376
2019,"WESTERN EUROPE-EU","SWEDEN","GATWICK","STOCKHOLM (ARLANDA)",436077,436067,10
2019,"WESTERN EUROPE-EU","SWEDEN","HEATHROW","GOTEBORG (LANDVETTER)",247369,247369,0
2019,"WESTERN EUROPE-EU","SWEDEN","HEATHROW","KIRUNA",2101,0,2101
2019,"WESTERN EUROPE-EU","SWEDEN","HEATHROW","STOCKHOLM (ARLANDA)",959928,959928,0
2019,"WESTERN EUROPE-EU","SWEDEN","LUTON","HALMSTAD",174,0,174
2019,"WESTERN EUROPE-EU","SWEDEN","LUTON","MALMO",165,0,165
2019,"WESTERN EUROPE-EU","SWEDEN","LUTON","OSTERSUND / FROSON",0,0,0
2019,"WESTERN EUROPE-EU","SWEDEN","LUTON","STOCKHOLM (ARLANDA)",22549,22549,0
2019,"WESTERN EUROPE-EU","SWEDEN","STANSTED","GOTEBORG (LANDVETTER)",159137,159137,0
2019,"WESTERN EUROPE-EU","SWEDEN","STANSTED","HALMSTAD",0,0,0
2019,"WESTERN EUROPE-EU","SWEDEN","STANSTED","MALMO",0,0,0
2019,"WESTERN EUROPE-EU","SWEDEN","STANSTED","NORRKOPING",0,0,0
2019,"WESTERN EUROPE-EU","SWEDEN","STANSTED","OSTERSUND / FROSON",0,0,0
2019,"WESTERN EUROPE-EU","SWEDEN","STANSTED","PAJALA YLLAS",0,0,0
2019,"WESTERN EUROPE-EU","SWEDEN","STANSTED","STOCKHOLM (ARLANDA)",909,0,909
2019,"WESTERN EUROPE-EU","SWEDEN","STANSTED","STOCKHOLM (SKAVSTA)",214869,214869,0
2019,"WESTERN EUROPE-EU","SWEDEN","STANSTED","VASTERAS",63525,63525,0
2019,"WESTERN EUROPE-OTHER","BOSNIA-HERZEGOVINA","LUTON","SARAJEVO",2174,2174,0
2019,"WESTERN EUROPE-OTHER","ICELAND","GATWICK","KEFLAVIK",242035,226805,15230
2019,"WESTERN EUROPE-OTHER","ICELAND","HEATHROW","KEFLAVIK",353509,353509,0
2019,"WESTERN EUROPE-OTHER","ICELAND","LONDON CITY","KEFLAVIK",3207,3207,0
2019,"WESTERN EUROPE-OTHER","ICELAND","LUTON","KEFLAVIK",256908,256908,0
2019,"WESTERN EUROPE-OTHER","ICELAND","SOUTHEND","AKUREYRI",402,402,0
2019,"WESTERN EUROPE-OTHER","ICELAND","STANSTED","AKUREYRI",0,0,0
2019,"WESTERN EUROPE-OTHER","ICELAND","STANSTED","KEFLAVIK",10579,10579,0
2019,"WESTERN EUROPE-OTHER","KOSOVO","GATWICK","PRISTINA",64,0,64
2019,"WESTERN EUROPE-OTHER","KOSOVO","LUTON","PRISTINA",72440,72440,0
2019,"WESTERN EUROPE-OTHER","KOSOVO","STANSTED","PRISTINA",294,0,294
2019,"WESTERN EUROPE-OTHER","MACEDONIA","GATWICK","SKOPJE",0,0,0
2019,"WESTERN EUROPE-OTHER","MACEDONIA","LUTON","OHRID",22917,22917,0
2019,"WESTERN EUROPE-OTHER","MACEDONIA","LUTON","SKOPJE",61539,61539,0
2019,"WESTERN EUROPE-OTHER","NORWAY","GATWICK","ANDENES",0,0,0
2019,"WESTERN EUROPE-OTHER","NORWAY","GATWICK","BERGEN",208585,205917,2668
2019,"WESTERN EUROPE-OTHER","NORWAY","GATWICK","FAGERNES/LEIRIN",0,0,0
2019,"WESTERN EUROPE-OTHER","NORWAY","GATWICK","MOLDE",249,145,104
2019,"WESTERN EUROPE-OTHER","NORWAY","GATWICK","OSLO (GARDERMOEN)",410482,410311,171
2019,"WESTERN EUROPE-OTHER","NORWAY","GATWICK","STAVANGER",87056,87056,0
2019,"WESTERN EUROPE-OTHER","NORWAY","GATWICK","TROMSOE",27297,27297,0
2019,"WESTERN EUROPE-OTHER","NORWAY","GATWICK","TRONDHEIM (VAERNES)",62719,62719,0
2019,"WESTERN EUROPE-OTHER","NORWAY","HEATHROW","OSLO (GARDERMOEN)",685981,685981,0
2019,"WESTERN EUROPE-OTHER","NORWAY","HEATHROW","STAVANGER",68605,68605,0
2019,"WESTERN EUROPE-OTHER","NORWAY","LUTON","BERGEN",33276,33276,0
2019,"WESTERN EUROPE-OTHER","NORWAY","LUTON","OSLO (GARDERMOEN)",27653,27653,0
2019,"WESTERN EUROPE-OTHER","NORWAY","LUTON","STAVANGER",12003,12003,0
2019,"WESTERN EUROPE-OTHER","NORWAY","LUTON","TROMSOE",10104,10104,0
2019,"WESTERN EUROPE-OTHER","NORWAY","STANSTED","KRISTIANSAND (KJEVIK)",25155,25155,0
2019,"WESTERN EUROPE-OTHER","NORWAY","STANSTED","KRISTIANSUND (KUERNBERGET)",86,0,86
2019,"WESTERN EUROPE-OTHER","NORWAY","STANSTED","OSLO (GARDERMOEN)",291754,291652,102
2019,"WESTERN EUROPE-OTHER","NORWAY","STANSTED","RYGGE",0,0,0
2019,"WESTERN EUROPE-OTHER","NORWAY","STANSTED","SANDEFJORD(TORP)",56020,56020,0
2019,"WESTERN EUROPE-OTHER","NORWAY","STANSTED","TROMSOE",0,0,0
2019,"WESTERN EUROPE-OTHER","REPUBLIC OF MONTENEGRO","GATWICK","PODGORICA",14885,112,14773
2019,"WESTERN EUROPE-OTHER","REPUBLIC OF MONTENEGRO","GATWICK","TIVAT",34930,34930,0
2019,"WESTERN EUROPE-OTHER","REPUBLIC OF MONTENEGRO","STANSTED","PODGORICA",37265,36866,399
2019,"WESTERN EUROPE-OTHER","REPUBLIC OF MONTENEGRO","STANSTED","TIVAT",0,0,0
2019,"WESTERN EUROPE-OTHER","REPUBLIC OF SERBIA","HEATHROW","BELGRADE",102600,102600,0
2019,"WESTERN EUROPE-OTHER","REPUBLIC OF SERBIA","LUTON","BELGRADE",70119,69843,276
2019,"WESTERN EUROPE-OTHER","REPUBLIC OF SERBIA","STANSTED","BELGRADE",288,0,288
2019,"WESTERN EUROPE-OTHER","SWITZERLAND","GATWICK","ALTENRHEIN",0,0,0
2019,"WESTERN EUROPE-OTHER","SWITZERLAND","GATWICK","BALE MULHOUSE",288862,288862,0
2019,"WESTERN EUROPE-OTHER","SWITZERLAND","GATWICK","GENEVA",833621,817139,16482
2019,"WESTERN EUROPE-OTHER","SWITZERLAND","GATWICK","ZURICH",157026,157026,0
2019,"WESTERN EUROPE-OTHER","SWITZERLAND","HEATHROW","BALE MULHOUSE",278482,278482,0
2019,"WESTERN EUROPE-OTHER","SWITZERLAND","HEATHROW","GENEVA",1070524,1070524,0
2019,"WESTERN EUROPE-OTHER","SWITZERLAND","HEATHROW","SION",515,515,0
2019,"WESTERN EUROPE-OTHER","SWITZERLAND","HEATHROW","ZURICH",1188545,1187935,610
2019,"WESTERN EUROPE-OTHER","SWITZERLAND","LONDON CITY","BERNE",0,0,0
2019,"WESTERN EUROPE-OTHER","SWITZERLAND","LONDON CITY","GENEVA",192170,192170,0
2019,"WESTERN EUROPE-OTHER","SWITZERLAND","LONDON CITY","SION",143,143,0
2019,"WESTERN EUROPE-OTHER","SWITZERLAND","LONDON CITY","ZURICH",431401,431401,0
2019,"WESTERN EUROPE-OTHER","SWITZERLAND","LUTON","BALE MULHOUSE",88662,88662,0
2019,"WESTERN EUROPE-OTHER","SWITZERLAND","LUTON","GENEVA",325624,325624,0
2019,"WESTERN EUROPE-OTHER","SWITZERLAND","LUTON","ZURICH",174970,174970,0
2019,"WESTERN EUROPE-OTHER","SWITZERLAND","SOUTHEND","GENEVA",29418,29418,0
2019,"WESTERN EUROPE-OTHER","SWITZERLAND","SOUTHEND","ZURICH",54,54,0
2019,"WESTERN EUROPE-OTHER","SWITZERLAND","STANSTED","BALE MULHOUSE",0,0,0
2019,"WESTERN EUROPE-OTHER","SWITZERLAND","STANSTED","GENEVA",96509,96010,499
2019,"WESTERN EUROPE-OTHER","SWITZERLAND","STANSTED","ZURICH",171,40,131
2019,"WESTERN EUROPE-OTHER","TURKEY","GATWICK","ANKARA (ESENBOGA)",21791,21791,0
2019,"WESTERN EUROPE-OTHER","TURKEY","GATWICK","ANTALYA",331860,246502,85358
2019,"WESTERN EUROPE-OTHER","TURKEY","GATWICK","BODRUM (MILAS)",114243,97470,16773
2019,"WESTERN EUROPE-OTHER","TURKEY","GATWICK","DALAMAN",359520,283147,76373
2019,"WESTERN EUROPE-OTHER","TURKEY","GATWICK","ISTANBUL",219243,218471,772
2019,"WESTERN EUROPE-OTHER","TURKEY","GATWICK","ISTANBUL (SABIHA GOKCEN)",77274,77274,0
2019,"WESTERN EUROPE-OTHER","TURKEY","GATWICK","ISTANBUL ATATURK",4534,4534,0
2019,"WESTERN EUROPE-OTHER","TURKEY","GATWICK","IZMIR (ADNAN MENDERES)",61554,43169,18385
2019,"WESTERN EUROPE-OTHER","TURKEY","HEATHROW","ANTALYA",423,423,0
2019,"WESTERN EUROPE-OTHER","TURKEY","HEATHROW","ISTANBUL",1026032,1026032,0
2019,"WESTERN EUROPE-OTHER","TURKEY","HEATHROW","ISTANBUL (SABIHA GOKCEN)",0,0,0
2019,"WESTERN EUROPE-OTHER","TURKEY","HEATHROW","ISTANBUL ATATURK",45806,45806,0
2019,"WESTERN EUROPE-OTHER","TURKEY","HEATHROW","IZMIR (ADNAN MENDERES)",7373,0,7373
2019,"WESTERN EUROPE-OTHER","TURKEY","LUTON","ANKARA (ESENBOGA)",5001,5001,0
2019,"WESTERN EUROPE-OTHER","TURKEY","LUTON","ANTALYA",43777,37499,6278
2019,"WESTERN EUROPE-OTHER","TURKEY","LUTON","BODRUM (MILAS)",31725,31725,0
2019,"WESTERN EUROPE-OTHER","TURKEY","LUTON","DALAMAN",28163,21667,6496
2019,"WESTERN EUROPE-OTHER","TURKEY","LUTON","GAZIANTEP",3911,3911,0
2019,"WESTERN EUROPE-OTHER","TURKEY","LUTON","ISTANBUL ATATURK",140,140,0
2019,"WESTERN EUROPE-OTHER","TURKEY","LUTON","IZMIR (ADNAN MENDERES)",11286,11286,0
2019,"WESTERN EUROPE-OTHER","TURKEY","STANSTED","ANKARA (ESENBOGA)",313,313,0
2019,"WESTERN EUROPE-OTHER","TURKEY","STANSTED","ANTALYA",169964,154095,15869
2019,"WESTERN EUROPE-OTHER","TURKEY","STANSTED","BODRUM (MILAS)",54211,54211,0
2019,"WESTERN EUROPE-OTHER","TURKEY","STANSTED","DALAMAN",194321,176029,18292
2019,"WESTERN EUROPE-OTHER","TURKEY","STANSTED","ISTANBUL",104610,104610,0
2019,"WESTERN EUROPE-OTHER","TURKEY","STANSTED","ISTANBUL (SABIHA GOKCEN)",472590,472590,0
2019,"WESTERN EUROPE-OTHER","TURKEY","STANSTED","ISTANBUL ATATURK",0,0,0
2019,"WESTERN EUROPE-OTHER","TURKEY","STANSTED","IZMIR (ADNAN MENDERES)",75472,75472,0
2019,"EASTERN EUROPE-EU","BULGARIA","GATWICK","BURGAS",49916,15250,34666
2019,"EASTERN EUROPE-EU","BULGARIA","GATWICK","SOFIA",129163,120486,8677
2019,"EASTERN EUROPE-EU","BULGARIA","GATWICK","VARNA",24274,9316,14958
2019,"EASTERN EUROPE-EU","BULGARIA","HEATHROW","SOFIA",176292,176292,0
2019,"EASTERN EUROPE-EU","BULGARIA","LUTON","BURGAS",98484,98484,0
2019,"EASTERN EUROPE-EU","BULGARIA","LUTON","SOFIA",333044,332924,120
2019,"EASTERN EUROPE-EU","BULGARIA","LUTON","VARNA",128440,128440,0
2019,"EASTERN EUROPE-EU","BULGARIA","SOUTHEND","SOFIA",9087,9087,0
2019,"EASTERN EUROPE-EU","BULGARIA","STANSTED","BURGAS",20600,14312,6288
2019,"EASTERN EUROPE-EU","BULGARIA","STANSTED","PLOVDIV",57156,57156,0
2019,"EASTERN EUROPE-EU","BULGARIA","STANSTED","SOFIA",273071,272985,86
2019,"EASTERN EUROPE-EU","CZECH REPUBLIC","GATWICK","PRAGUE",265909,264648,1261
2019,"EASTERN EUROPE-EU","CZECH REPUBLIC","HEATHROW","PRAGUE",447235,447235,0
2019,"EASTERN EUROPE-EU","CZECH REPUBLIC","LONDON CITY","PRAGUE",43998,43898,100
2019,"EASTERN EUROPE-EU","CZECH REPUBLIC","LUTON","BRNO (TURANY)",0,0,0
2019,"EASTERN EUROPE-EU","CZECH REPUBLIC","LUTON","PRAGUE",133889,133889,0
2019,"EASTERN EUROPE-EU","CZECH REPUBLIC","SOUTHEND","PRAGUE",50334,50334,0
2019,"EASTERN EUROPE-EU","CZECH REPUBLIC","STANSTED","BRNO (TURANY)",112756,112756,0
2019,"EASTERN EUROPE-EU","CZECH REPUBLIC","STANSTED","OSTRAVA",56525,56525,0
2019,"EASTERN EUROPE-EU","CZECH REPUBLIC","STANSTED","PARDUBICE",23851,23851,0
2019,"EASTERN EUROPE-EU","CZECH REPUBLIC","STANSTED","PRAGUE",436400,436106,294
2019,"EASTERN EUROPE-EU","ESTONIA","GATWICK","TALLIN",77678,77678,0
2019,"EASTERN EUROPE-EU","ESTONIA","HEATHROW","TALLIN",7800,7800,0
2019,"EASTERN EUROPE-EU","ESTONIA","LUTON","TALLIN",38986,38986,0
2019,"EASTERN EUROPE-EU","ESTONIA","STANSTED","TALLIN",70457,70457,0
2019,"EASTERN EUROPE-EU","HUNGARY","GATWICK","BUDAPEST",304980,304884,96
2019,"EASTERN EUROPE-EU","HUNGARY","HEATHROW","BUDAPEST",371847,371847,0
2019,"EASTERN EUROPE-EU","HUNGARY","LONDON CITY","BUDAPEST",60892,60892,0
2019,"EASTERN EUROPE-EU","HUNGARY","LUTON","BUDAPEST",568670,568670,0
2019,"EASTERN EUROPE-EU","HUNGARY","LUTON","DEBRECEN",155170,155170,0
2019,"EASTERN EUROPE-EU","HUNGARY","SOUTHEND","BUDAPEST",12131,12131,0
2019,"EASTERN EUROPE-EU","HUNGARY","STANSTED","BUDAPEST",440486,440456,30
2019,"EASTERN EUROPE-EU","LATVIA","GATWICK","RIGA",145412,145412,0
2019,"EASTERN EUROPE-EU","LATVIA","LUTON","RIGA",197632,197632,0
2019,"EASTERN EUROPE-EU","LATVIA","STANSTED","RIGA",260581,260581,0
2019,"EASTERN EUROPE-EU","LITHUANIA","LONDON CITY","VILNIUS",55252,55252,0
2019,"EASTERN EUROPE-EU","LITHUANIA","LUTON","KAUNAS",237516,237516,0
2019,"EASTERN EUROPE-EU","LITHUANIA","LUTON","PALANGA",65751,65751,0
2019,"EASTERN EUROPE-EU","LITHUANIA","LUTON","VILNIUS",303279,303279,0
2019,"EASTERN EUROPE-EU","LITHUANIA","SOUTHEND","VILNIUS",13652,13652,0
2019,"EASTERN EUROPE-EU","LITHUANIA","STANSTED","KAUNAS",80308,80308,0
2019,"EASTERN EUROPE-EU","LITHUANIA","STANSTED","PALANGA",38203,38203,0
2019,"EASTERN EUROPE-EU","LITHUANIA","STANSTED","VILNIUS",127909,127909,0
2019,"EASTERN EUROPE-EU","POLAND","GATWICK","GDANSK",75980,75980,0
2019,"EASTERN EUROPE-EU","POLAND","GATWICK","KATOWICE",0,0,0
2019,"EASTERN EUROPE-EU","POLAND","GATWICK","KRAKOW",164630,163707,923
2019,"EASTERN EUROPE-EU","POLAND","GATWICK","LODZ LUBLINEK",185,0,185
2019,"EASTERN EUROPE-EU","POLAND","GATWICK","WARSAW (CHOPIN)",15540,15459,81
2019,"EASTERN EUROPE-EU","POLAND","GATWICK","WROCLAW",0,0,0
2019,"EASTERN EUROPE-EU","POLAND","HEATHROW","KRAKOW",112086,112086,0
2019,"EASTERN EUROPE-EU","POLAND","HEATHROW","WARSAW (CHOPIN)",453361,453361,0
2019,"EASTERN EUROPE-EU","POLAND","LONDON CITY","WARSAW (CHOPIN)",80034,80034,0
2019,"EASTERN EUROPE-EU","POLAND","LUTON","BYDGOSZCZ",52399,52399,0
2019,"EASTERN EUROPE-EU","POLAND","LUTON","GDANSK",310034,310034,0
2019,"EASTERN EUROPE-EU","POLAND","LUTON","KATOWICE",314704,314478,226
2019,"EASTERN EUROPE-EU","POLAND","LUTON","KRAKOW",254087,254087,0
2019,"EASTERN EUROPE-EU","POLAND","LUTON","LUBLIN (PORT LOTNICZY)",159239,159239,0
2019,"EASTERN EUROPE-EU","POLAND","LUTON","POZNAN",148574,148574,0
2019,"EASTERN EUROPE-EU","POLAND","LUTON","RZESZOW",55869,55491,378
2019,"EASTERN EUROPE-EU","POLAND","LUTON","SZCZECIN (GOLENOW)",0,0,0
2019,"EASTERN EUROPE-EU","POLAND","LUTON","SZYMANY (MAZURY)",45342,45342,0
2019,"EASTERN EUROPE-EU","POLAND","LUTON","WARSAW (CHOPIN)",478730,478730,0
2019,"EASTERN EUROPE-EU","POLAND","LUTON","WROCLAW",159536,159536,0
2019,"EASTERN EUROPE-EU","POLAND","SOUTHEND","RZESZOW",0,0,0
2019,"EASTERN EUROPE-EU","POLAND","STANSTED","BYDGOSZCZ",113362,113362,0
2019,"EASTERN EUROPE-EU","POLAND","STANSTED","GDANSK",204425,204425,0
2019,"EASTERN EUROPE-EU","POLAND","STANSTED","KATOWICE",127023,127023,0
2019,"EASTERN EUROPE-EU","POLAND","STANSTED","KRAKOW",358577,357128,1449
2019,"EASTERN EUROPE-EU","POLAND","STANSTED","LODZ LUBLINEK",108519,108379,140
2019,"EASTERN EUROPE-EU","POLAND","STANSTED","LUBLIN (PORT LOTNICZY)",18056,18056,0
2019,"EASTERN EUROPE-EU","POLAND","STANSTED","POZNAN",161465,161465,0
2019,"EASTERN EUROPE-EU","POLAND","STANSTED","RZESZOW",136334,136334,0
2019,"EASTERN EUROPE-EU","POLAND","STANSTED","SZCZECIN (GOLENOW)",110550,110550,0
2019,"EASTERN EUROPE-EU","POLAND","STANSTED","SZYMANY (MAZURY)",49160,49160,0
2019,"EASTERN EUROPE-EU","POLAND","STANSTED","WARSAW (CHOPIN)",140,0,140
2019,"EASTERN EUROPE-EU","POLAND","STANSTED","WARSAW (MODLIN MASOVIA)",379209,379209,0
2019,"EASTERN EUROPE-EU","POLAND","STANSTED","WROCLAW",215414,215414,0
2019,"EASTERN EUROPE-EU","ROMANIA","GATWICK","BUCHAREST (OTOPENI)",150745,150745,0
2019,"EASTERN EUROPE-EU","ROMANIA","GATWICK","CLUJ NAPOCA",82336,82336,0
2019,"EASTERN EUROPE-EU","ROMANIA","HEATHROW","BUCHAREST (OTOPENI)",267255,267255,0
2019,"EASTERN EUROPE-EU","ROMANIA","LUTON","BACAU",100392,100392,0
2019,"EASTERN EUROPE-EU","ROMANIA","LUTON","BUCHAREST (OTOPENI)",677876,677876,0
2019,"EASTERN EUROPE-EU","ROMANIA","LUTON","CLUJ NAPOCA",280134,280134,0
2019,"EASTERN EUROPE-EU","ROMANIA","LUTON","CONSTANTA",74300,74300,0
2019,"EASTERN EUROPE-EU","ROMANIA","LUTON","CRAIOVA",143578,143578,0
2019,"EASTERN EUROPE-EU","ROMANIA","LUTON","IASI",202567,202567,0
2019,"EASTERN EUROPE-EU","ROMANIA","LUTON","SATU MARE",52918,52918,0
2019,"EASTERN EUROPE-EU","ROMANIA","LUTON","SIBIU",103577,103577,0
2019,"EASTERN EUROPE-EU","ROMANIA","LUTON","SUCEAVA",159865,159865,0
2019,"EASTERN EUROPE-EU","ROMANIA","LUTON","TIMISOARA",146661,146661,0
2019,"EASTERN EUROPE-EU","ROMANIA","LUTON","TIRGU MURES",51171,51171,0
2019,"EASTERN EUROPE-EU","ROMANIA","SOUTHEND","BUCHAREST (OTOPENI)",21861,21861,0
2019,"EASTERN EUROPE-EU","ROMANIA","SOUTHEND","CLUJ NAPOCA",26726,26726,0
2019,"EASTERN EUROPE-EU","ROMANIA","SOUTHEND","SIBIU",17371,17371,0
2019,"EASTERN EUROPE-EU","ROMANIA","STANSTED","BACAU",0,0,0
2019,"EASTERN EUROPE-EU","ROMANIA","STANSTED","BUCHAREST (OTOPENI)",257972,257972,0
2019,"EASTERN EUROPE-EU","ROMANIA","STANSTED","ORADEA",0,0,0
2019,"EASTERN EUROPE-EU","ROMANIA","STANSTED","TIMISOARA",0,0,0
2019,"EASTERN EUROPE-EU","SLOVAK REPUBLIC","GATWICK","BRATISLAVA",0,0,0
2019,"EASTERN EUROPE-EU","SLOVAK REPUBLIC","LUTON","BRATISLAVA",114364,114364,0
2019,"EASTERN EUROPE-EU","SLOVAK REPUBLIC","LUTON","KOSICE",149795,149795,0
2019,"EASTERN EUROPE-EU","SLOVAK REPUBLIC","LUTON","TATRY-POPRAD",55976,55976,0
2019,"EASTERN EUROPE-EU","SLOVAK REPUBLIC","SOUTHEND","KOSICE",27669,27669,0
2019,"EASTERN EUROPE-EU","SLOVAK REPUBLIC","STANSTED","BRATISLAVA",196608,196608,0
2019,"EASTERN EUROPE -OTHER","ALBANIA","GATWICK","TIRANA",106224,105866,358
2019,"EASTERN EUROPE -OTHER","ALBANIA","LUTON","TIRANA",101617,101617,0
2019,"EASTERN EUROPE -OTHER","ALBANIA","STANSTED","TIRANA",15547,15420,127
2019,"EASTERN EUROPE -OTHER","AZERBAIJAN","GATWICK","BAKU (HEYDER ALIYEV INT'L)",241,0,241
2019,"EASTERN EUROPE -OTHER","AZERBAIJAN","HEATHROW","BAKU (HEYDER ALIYEV INT'L)",38709,38709,0
2019,"EASTERN EUROPE -OTHER","AZERBAIJAN","LUTON","BAKU (HEYDER ALIYEV INT'L)",2130,0,2130
2019,"EASTERN EUROPE -OTHER","AZERBAIJAN","STANSTED","BAKU (HEYDER ALIYEV INT'L)",1154,0,1154
2019,"EASTERN EUROPE -OTHER","BELARUS","GATWICK","MINSK INT'L ",34255,34255,0
2019,"EASTERN EUROPE -OTHER","BELARUS","LUTON","MINSK INT'L ",77,0,77
2019,"EASTERN EUROPE -OTHER","GEORGIA","GATWICK","TBILISI",18938,18938,0
2019,"EASTERN EUROPE -OTHER","GEORGIA","LUTON","KUTAISI",25619,25619,0
2019,"EASTERN EUROPE -OTHER","KAZAKHSTAN","HEATHROW","ASTANA",45726,45726,0
2019,"EASTERN EUROPE -OTHER","REPUBLIC OF MOLDOVA","LUTON","CHISINAU (KISHINEV)",166404,166404,0
2019,"EASTERN EUROPE -OTHER","REPUBLIC OF MOLDOVA","STANSTED","CHISINAU (KISHINEV)",74542,74542,0
2019,"EASTERN EUROPE -OTHER","RUSSIA","GATWICK","MOSCOW (SHEREMETYEVO)",555,555,0
2019,"EASTERN EUROPE -OTHER","RUSSIA","GATWICK","MOSCOW (VNUKOVO)",6,0,6
2019,"EASTERN EUROPE -OTHER","RUSSIA","GATWICK","ST PETERSBURG",71682,71682,0
2019,"EASTERN EUROPE -OTHER","RUSSIA","HEATHROW","MOSCOW (DOMODEDOVO)",176047,176047,0
2019,"EASTERN EUROPE -OTHER","RUSSIA","HEATHROW","MOSCOW (SHEREMETYEVO)",530753,530753,0
2019,"EASTERN EUROPE -OTHER","RUSSIA","HEATHROW","ST PETERSBURG",59136,59136,0
2019,"EASTERN EUROPE -OTHER","RUSSIA","LUTON","ADLER / SOCHI",626,0,626
2019,"EASTERN EUROPE -OTHER","RUSSIA","LUTON","MOSCOW (SHEREMETYEVO)",0,0,0
2019,"EASTERN EUROPE -OTHER","RUSSIA","LUTON","MOSCOW (VNUKOVO)",35092,35092,0
2019,"EASTERN EUROPE -OTHER","RUSSIA","LUTON","ST PETERSBURG",29763,29763,0
2019,"EASTERN EUROPE -OTHER","RUSSIA","STANSTED","KAZAN",105,0,105
2019,"EASTERN EUROPE -OTHER","RUSSIA","STANSTED","MOSCOW (DOMODEDOVO)",1305,1305,0
2019,"EASTERN EUROPE -OTHER","RUSSIA","STANSTED","MOSCOW (SHEREMETYEVO)",0,0,0
2019,"EASTERN EUROPE -OTHER","RUSSIA","STANSTED","ST PETERSBURG",9659,9659,0
2019,"EASTERN EUROPE -OTHER","TURKMENISTAN","HEATHROW","ASHKHABAD",1163,1163,0
2019,"EASTERN EUROPE -OTHER","UKRAINE","GATWICK","KIEV (BORISPOL)",202201,201744,457
2019,"EASTERN EUROPE -OTHER","UKRAINE","HEATHROW","KIEV (BORISPOL)",54049,54049,0
2019,"EASTERN EUROPE -OTHER","UKRAINE","LUTON","KHARKOV OSNOVA INTL",2725,2725,0
2019,"EASTERN EUROPE -OTHER","UKRAINE","LUTON","KIEV (BORISPOL)",1645,1645,0
2019,"EASTERN EUROPE -OTHER","UKRAINE","LUTON","KIEV (ZHULYANY)",53166,53166,0
2019,"EASTERN EUROPE -OTHER","UKRAINE","LUTON","LVOV",47322,47322,0
2019,"EASTERN EUROPE -OTHER","UKRAINE","STANSTED","KIEV (BORISPOL)",80788,80788,0
2019,"EASTERN EUROPE -OTHER","UKRAINE","STANSTED","LVOV",49046,49046,0
2019,"EASTERN EUROPE -OTHER","UZBEKISTAN","HEATHROW","TASHKENT",29622,29622,0
2019,"NEAR EAST","ISRAEL","GATWICK","TEL AVIV",22329,22011,318
2019,"NEAR EAST","ISRAEL","HEATHROW","TEL AVIV",678130,678130,0
2019,"NEAR EAST","ISRAEL","LUTON","OVDA",5994,5994,0
2019,"NEAR EAST","ISRAEL","LUTON","RAMON",308,0,308
2019,"NEAR EAST","ISRAEL","LUTON","TEL AVIV",485140,484854,286
2019,"NEAR EAST","ISRAEL","STANSTED","TEL AVIV",44500,43870,630
2019,"NEAR EAST","JORDAN","GATWICK","AQABA",11047,10039,1008
2019,"NEAR EAST","JORDAN","HEATHROW","AMMAN",232636,232636,0
2019,"NEAR EAST","JORDAN","LUTON","AMMAN",218,218,0
2019,"NEAR EAST","JORDAN","STANSTED","AQABA",0,0,0
2019,"NEAR EAST","LEBANON","HEATHROW","BEIRUT",301512,301512,0
2019,"NORTH AFRICA","ALGERIA","GATWICK","ALGIERS",64659,64659,0
2019,"NORTH AFRICA","ALGERIA","HEATHROW","ALGIERS",68352,68352,0
2019,"NORTH AFRICA","EGYPT","GATWICK","HURGHADA",183359,180733,2626
2019,"NORTH AFRICA","EGYPT","GATWICK","MARSA ALAM",35097,35097,0
2019,"NORTH AFRICA","EGYPT","GATWICK","SHARM EL SHEIKH (OPHIRA)",495,0,495
2019,"NORTH AFRICA","EGYPT","HEATHROW","CAIRO",414952,414952,0
2019,"NORTH AFRICA","EGYPT","HEATHROW","LUXOR",8150,8150,0
2019,"NORTH AFRICA","EGYPT","LUTON","MARSA ALAM",0,0,0
2019,"NORTH AFRICA","EGYPT","STANSTED","HURGHADA",24730,24509,221
2019,"NORTH AFRICA","MOROCCO","GATWICK","AGADIR (AL MASSIRA)",95390,95390,0
2019,"NORTH AFRICA","MOROCCO","GATWICK","CASABLANCA MOHAMED V",65239,65233,6
2019,"NORTH AFRICA","MOROCCO","GATWICK","ERRACHIDIA",2,0,2
2019,"NORTH AFRICA","MOROCCO","GATWICK","FEZ",16667,16667,0
2019,"NORTH AFRICA","MOROCCO","GATWICK","MARRAKESH",386636,386615,21
2019,"NORTH AFRICA","MOROCCO","GATWICK","OUARZAZATE",398,0,398
2019,"NORTH AFRICA","MOROCCO","GATWICK","RABAT",298,0,298
2019,"NORTH AFRICA","MOROCCO","GATWICK","TANGIERS (IBN BATUTA)",29802,29802,0
2019,"NORTH AFRICA","MOROCCO","HEATHROW","CASABLANCA MOHAMED V",96222,96222,0
2019,"NORTH AFRICA","MOROCCO","HEATHROW","MARRAKESH",29638,29638,0
2019,"NORTH AFRICA","MOROCCO","HEATHROW","RABAT",12942,12942,0
2019,"NORTH AFRICA","MOROCCO","LUTON","AGADIR (AL MASSIRA)",0,0,0
2019,"NORTH AFRICA","MOROCCO","LUTON","CASABLANCA MOHAMED V",0,0,0
2019,"NORTH AFRICA","MOROCCO","LUTON","ESSAOUIRA",0,0,0
2019,"NORTH AFRICA","MOROCCO","LUTON","MARRAKESH",57691,57691,0
2019,"NORTH AFRICA","MOROCCO","STANSTED","AGADIR (AL MASSIRA)",36430,36430,0
2019,"NORTH AFRICA","MOROCCO","STANSTED","ESSAOUIRA",5565,5565,0
2019,"NORTH AFRICA","MOROCCO","STANSTED","FEZ",35015,35015,0
2019,"NORTH AFRICA","MOROCCO","STANSTED","MARRAKESH",133995,131891,2104
2019,"NORTH AFRICA","MOROCCO","STANSTED","RABAT",55524,55524,0
2019,"NORTH AFRICA","TUNISIA","GATWICK","ENFIDHA - HAMMAMET INTL",77293,48852,28441
2019,"NORTH AFRICA","TUNISIA","GATWICK","MONASTIR",0,0,0
2019,"NORTH AFRICA","TUNISIA","GATWICK","TUNIS",27713,27713,0
2019,"NORTH AFRICA","TUNISIA","HEATHROW","TUNIS",44951,44951,0
2019,"NORTH AFRICA","TUNISIA","LUTON","ENFIDHA - HAMMAMET INTL",9283,0,9283
2019,"NORTH AFRICA","TUNISIA","STANSTED","ENFIDHA - HAMMAMET INTL",10869,10869,0
2019,"EAST AFRICA","ETHIOPIA","HEATHROW","ADDIS ABABA",246383,246383,0
2019,"EAST AFRICA","KENYA","HEATHROW","NAIROBI",337919,337919,0
2019,"EAST AFRICA","RWANDA","GATWICK","KIGALI",28504,28504,0
2019,"WEST AFRICA","GAMBIA","GATWICK","BANJUL",46683,23332,23351
2019,"WEST AFRICA","GAMBIA","STANSTED","BANJUL",79,0,79
2019,"WEST AFRICA","GHANA","GATWICK","ACCRA",184,0,184
2019,"WEST AFRICA","GHANA","HEATHROW","ACCRA",221188,221188,0
2019,"WEST AFRICA","NIGERIA","GATWICK","LAGOS",0,0,0
2019,"WEST AFRICA","NIGERIA","HEATHROW","ABUJA",136534,136534,0
2019,"WEST AFRICA","NIGERIA","HEATHROW","LAGOS",382375,382375,0
2019,"WEST AFRICA","SIERRA LEONE","GATWICK","FREETOWN",265,0,265
2019,"CENTRAL AFRICA","ANGOLA","HEATHROW","LUANDA",0,0,0
2019,"SOUTHERN AFRICA","REPUBLIC OF SOUTH AFRICA","GATWICK","CAPE TOWN",48642,48642,0
2019,"SOUTHERN AFRICA","REPUBLIC OF SOUTH AFRICA","HEATHROW","CAPE TOWN",329296,329045,251
2019,"SOUTHERN AFRICA","REPUBLIC OF SOUTH AFRICA","HEATHROW","DURBAN",56657,56657,0
2019,"SOUTHERN AFRICA","REPUBLIC OF SOUTH AFRICA","HEATHROW","JOHANNESBURG",1004190,1004190,0
2019,"MIDDLE EAST","BAHRAIN","HEATHROW","BAHRAIN",426683,426683,0
2019,"MIDDLE EAST","IRAN","HEATHROW","TEHRAN IMAM KHOMEINI",55008,55008,0
2019,"MIDDLE EAST","IRAQ","GATWICK","BAGHDAD (GECA)",6469,6432,37
2019,"MIDDLE EAST","IRAQ","GATWICK","ERBIL INTERNATIONAL",0,0,0
2019,"MIDDLE EAST","IRAQ","GATWICK","SULAYMANIYAH INT",6574,6574,0
2019,"MIDDLE EAST","KUWAIT","GATWICK","KUWAIT",7264,7264,0
2019,"MIDDLE EAST","KUWAIT","HEATHROW","KUWAIT",436088,436088,0
2019,"MIDDLE EAST","OMAN","GATWICK","MUSCAT",1033,0,1033
2019,"MIDDLE EAST","OMAN","HEATHROW","MUSCAT",359470,359470,0
2019,"MIDDLE EAST","QATAR","GATWICK","DOHA HAMAD",372378,372378,0
2019,"MIDDLE EAST","QATAR","HEATHROW","DOHA HAMAD",1264687,1264687,0
2019,"MIDDLE EAST","SAUDI ARABIA","HEATHROW","DAMMAM",1564,1564,0
2019,"MIDDLE EAST","SAUDI ARABIA","HEATHROW","JEDDAH",248762,248762,0
2019,"MIDDLE EAST","SAUDI ARABIA","HEATHROW","MEDINA",4944,4944,0
2019,"MIDDLE EAST","SAUDI ARABIA","HEATHROW","RIYADH",288758,288758,0
2019,"MIDDLE EAST","SAUDI ARABIA","LUTON","NEOM BAY",804,0,804
2019,"MIDDLE EAST","SAUDI ARABIA","LUTON","RIYADH",106,0,106
2019,"MIDDLE EAST","SAUDI ARABIA","STANSTED","RIYADH",0,0,0
2019,"MIDDLE EAST","UNITED ARAB EMIRATES","GATWICK","ABU DHABI INTERNATIONAL",0,0,0
2019,"MIDDLE EAST","UNITED ARAB EMIRATES","GATWICK","DUBAI",979723,979723,0
2019,"MIDDLE EAST","UNITED ARAB EMIRATES","GATWICK","DUBAI (WORLD CENTRAL)",1025,0,1025
2019,"MIDDLE EAST","UNITED ARAB EMIRATES","HEATHROW","ABU DHABI INTERNATIONAL",1119673,1119673,0
2019,"MIDDLE EAST","UNITED ARAB EMIRATES","HEATHROW","DUBAI",2333127,2333108,19
2019,"MIDDLE EAST","UNITED ARAB EMIRATES","STANSTED","ABU DHABI INTERNATIONAL",0,0,0
2019,"MIDDLE EAST","UNITED ARAB EMIRATES","STANSTED","DUBAI",317846,317846,0
2019,"INDIAN SUB-CONTINENT","BANGLADESH","HEATHROW","DHAKHA",87419,87419,0
2019,"INDIAN SUB-CONTINENT","BANGLADESH","HEATHROW","SYLHET",54413,54413,0
2019,"INDIAN SUB-CONTINENT","INDIA","GATWICK","COCHIN",990,0,990
2019,"INDIAN SUB-CONTINENT","INDIA","GATWICK","GOA",41495,23273,18222
2019,"INDIAN SUB-CONTINENT","INDIA","HEATHROW","AHMEDABAD",94291,94291,0
2019,"INDIAN SUB-CONTINENT","INDIA","HEATHROW","AMRITSAR",294,294,0
2019,"INDIAN SUB-CONTINENT","INDIA","HEATHROW","BANGALORE (BENGALURU)",231123,231123,0
2019,"INDIAN SUB-CONTINENT","INDIA","HEATHROW","CHENNAI",136841,136841,0
2019,"INDIAN SUB-CONTINENT","INDIA","HEATHROW","DELHI",871188,871188,0
2019,"INDIAN SUB-CONTINENT","INDIA","HEATHROW","HYDERABAD ( RAJIV GHANDI )",141438,141438,0
2019,"INDIAN SUB-CONTINENT","INDIA","HEATHROW","MUMBAI",724449,724449,0
2019,"INDIAN SUB-CONTINENT","INDIA","STANSTED","AMRITSAR",9377,9377,0
2019,"INDIAN SUB-CONTINENT","PAKISTAN","GATWICK","BENAZIR BHUTTO INTERNATIONAL AIRPORT",120,51,69
2019,"INDIAN SUB-CONTINENT","PAKISTAN","HEATHROW","BENAZIR BHUTTO INTERNATIONAL AIRPORT",12840,12840,0
2019,"INDIAN SUB-CONTINENT","PAKISTAN","HEATHROW","ISLAMABAD INTERNATIONAL AIRPORT",165252,165252,0
2019,"INDIAN SUB-CONTINENT","PAKISTAN","HEATHROW","KARACHI",42998,42998,0
2019,"INDIAN SUB-CONTINENT","PAKISTAN","HEATHROW","LAHORE",89978,89978,0
2019,"INDIAN SUB-CONTINENT","PAKISTAN","HEATHROW","SIALKOT",6451,6451,0
2019,"INDIAN SUB-CONTINENT","SRI LANKA","GATWICK","COLOMBO",10303,0,10303
2019,"INDIAN SUB-CONTINENT","SRI LANKA","HEATHROW","COLOMBO",219395,219395,0
2019,"FAR EAST","BRUNEI","HEATHROW","BANDAR SERI BEGAWAN",127023,127023,0
2019,"FAR EAST","CHINA","GATWICK","BEIJING",0,0,0
2019,"FAR EAST","CHINA","GATWICK","CHENGDU",11205,11205,0
2019,"FAR EAST","CHINA","GATWICK","CHONGQING JIANGBEI INTERNATIONAL",0,0,0
2019,"FAR EAST","CHINA","GATWICK","SHANGHAI (PU DONG)",79040,79040,0
2019,"FAR EAST","CHINA","GATWICK","TIANJIN",0,0,0
2019,"FAR EAST","CHINA","HEATHROW","BEIJING",585832,585832,0
2019,"FAR EAST","CHINA","HEATHROW","BEIJING DAXING INTERNATIONAL AIRPORT",21928,21928,0
2019,"FAR EAST","CHINA","HEATHROW","CHANGSHA HUANGHUA INTERNATIONAL AIRPORT",43833,43833,0
2019,"FAR EAST","CHINA","HEATHROW","CHENGDU",41051,41051,0
2019,"FAR EAST","CHINA","HEATHROW","CHONGQING JIANGBEI INTERNATIONAL",28816,28816,0
2019,"FAR EAST","CHINA","HEATHROW","GUANGZHOU BAIYUN INTERNATIONAL",165630,165630,0
2019,"FAR EAST","CHINA","HEATHROW","QINGDAO",34369,34369,0
2019,"FAR EAST","CHINA","HEATHROW","SANYA PHOENIX INTERNATIONAL",16204,16204,0
2019,"FAR EAST","CHINA","HEATHROW","SHANGHAI (PU DONG)",510675,510675,0
2019,"FAR EAST","CHINA","HEATHROW","SHENZHEN (HUANGTIAN)",65841,65841,0
2019,"FAR EAST","CHINA","HEATHROW","TIANJIN",10031,10031,0
2019,"FAR EAST","CHINA","HEATHROW","WUHAN TIANHE INTERNATIONAL",54772,54772,0
2019,"FAR EAST","CHINA","HEATHROW","XIAN XIANYANG",45516,45516,0
2019,"FAR EAST","CHINA","HEATHROW","ZHENGZHOU XINZHENG",17938,17938,0
2019,"FAR EAST","HONG KONG","GATWICK","HONG KONG (CHEK LAP KOK)",168823,168823,0
2019,"FAR EAST","HONG KONG","HEATHROW","HONG KONG (CHEK LAP KOK)",1612530,1612530,0
2019,"FAR EAST","INDONESIA","HEATHROW","BALI INTERNATIONAL",13102,13102,0
2019,"FAR EAST","INDONESIA","HEATHROW","JAKARTA (SOEKARNO-HATTA INTNL)",9161,9161,0
2019,"FAR EAST","INDONESIA","HEATHROW","KUALANAMU INTERNATIONAL AIRPORT",8608,8608,0
2019,"FAR EAST","JAPAN","HEATHROW","OSAKA (KANSAI)",51706,51706,0
2019,"FAR EAST","JAPAN","HEATHROW","TOKYO (HANEDA)",586226,586226,0
2019,"FAR EAST","JAPAN","HEATHROW","TOKYO (NARITA)",137180,137180,0
2019,"FAR EAST","MALAYSIA","GATWICK","LANGKAWI",5218,0,5218
2019,"FAR EAST","MALAYSIA","HEATHROW","KUALA LUMPUR (SEPANG)",478219,478219,0
2019,"FAR EAST","MONGOLIA","GATWICK","ULAN BATOR",0,0,0
2019,"FAR EAST","PHILIPPINES","HEATHROW","MANILA",111217,111217,0
2019,"FAR EAST","REPUBLIC OF KOREA","GATWICK","SEOUL (INCHEON)",0,0,0
2019,"FAR EAST","REPUBLIC OF KOREA","HEATHROW","SEOUL (INCHEON)",528363,528363,0
2019,"FAR EAST","SINGAPORE","GATWICK","SINGAPORE",4228,4228,0
2019,"FAR EAST","SINGAPORE","HEATHROW","SINGAPORE",1526634,1526634,0
2019,"FAR EAST","TAIWAN","GATWICK","TAIPEI",112445,112445,0
2019,"FAR EAST","TAIWAN","HEATHROW","TAIPEI",30465,30465,0
2019,"FAR EAST","THAILAND","GATWICK","KRABI",0,0,0
2019,"FAR EAST","THAILAND","GATWICK","PHUKET",14195,0,14195
2019,"FAR EAST","THAILAND","GATWICK","U-TAPAO",4488,0,4488
2019,"FAR EAST","THAILAND","HEATHROW","BANGKOK SUVARNABHUMI ",863175,863175,0
2019,"FAR EAST","VIETNAM","GATWICK","PHU QUOC INTERNATIONAL",8331,0,8331
2019,"FAR EAST","VIETNAM","HEATHROW","HANOI",89598,89598,0
2019,"FAR EAST","VIETNAM","HEATHROW","HO CHI MINH CITY",65413,65413,0
2019,"AUSTRALASIA","AUSTRALIA","HEATHROW","MELBOURNE",16769,16769,0
2019,"AUSTRALASIA","AUSTRALIA","HEATHROW","PERTH (AUSTRALIA)",141724,141724,0
2019,"AUSTRALASIA","AUSTRALIA","HEATHROW","SYDNEY",179503,179465,38
2019,"AUSTRALASIA","NEW ZEALAND","HEATHROW","AUCKLAND INTERNATIONAL",17895,17895,0
2019,"CANADA","CANADA","GATWICK","CALGARY",179185,179185,0
2019,"CANADA","CANADA","GATWICK","EDMONTON",5430,5430,0
2019,"CANADA","CANADA","GATWICK","GANDER",0,0,0
2019,"CANADA","CANADA","GATWICK","HALIFAX INT",36559,36559,0
2019,"CANADA","CANADA","GATWICK","MONTREAL (DORVAL)",28158,28158,0
2019,"CANADA","CANADA","GATWICK","OTTAWA INTERNATIONAL",0,0,0
2019,"CANADA","CANADA","GATWICK","ST JOHNS",0,0,0
2019,"CANADA","CANADA","GATWICK","TORONTO",436800,436800,0
2019,"CANADA","CANADA","GATWICK","VANCOUVER",154191,154191,0
2019,"CANADA","CANADA","GATWICK","WINNIPEG",5248,5248,0
2019,"CANADA","CANADA","HEATHROW","CALGARY",259720,259720,0
2019,"CANADA","CANADA","HEATHROW","HALIFAX INT",9884,9884,0
2019,"CANADA","CANADA","HEATHROW","MONTREAL (DORVAL)",320213,320213,0
2019,"CANADA","CANADA","HEATHROW","OTTAWA INTERNATIONAL",117614,117614,0
2019,"CANADA","CANADA","HEATHROW","ST JOHNS",3318,3318,0
2019,"CANADA","CANADA","HEATHROW","TORONTO",1151792,1151792,0
2019,"CANADA","CANADA","HEATHROW","VANCOUVER",542568,542568,0
2019,"CANADA","CANADA","STANSTED","HALIFAX INT",48,0,48
2019,"CANADA","CANADA","STANSTED","TORONTO",0,0,0
2019,"UNITED STATES OF AMERICA","USA","GATWICK","ATLANTA",175,175,0
2019,"UNITED STATES OF AMERICA","USA","GATWICK","AUSTIN (BERGSTROM)",62740,62740,0
2019,"UNITED STATES OF AMERICA","USA","GATWICK","BOSTON",221024,221024,0
2019,"UNITED STATES OF AMERICA","USA","GATWICK","CHICAGO (O'HARE)",98447,98447,0
2019,"UNITED STATES OF AMERICA","USA","GATWICK","CINCINNATI",154,0,154
2019,"UNITED STATES OF AMERICA","USA","GATWICK","DENVER INTERNATIONAL",71140,71140,0
2019,"UNITED STATES OF AMERICA","USA","GATWICK","FORT LAUDERDALE",97296,97296,0
2019,"UNITED STATES OF AMERICA","USA","GATWICK","LAS VEGAS",175567,175567,0
2019,"UNITED STATES OF AMERICA","USA","GATWICK","LOS ANGELES INTERNATIONAL",233689,233689,0
2019,"UNITED STATES OF AMERICA","USA","GATWICK","MIAMI INTERNATIONAL",143524,143524,0
2019,"UNITED STATES OF AMERICA","USA","GATWICK","NEW YORK (JF KENNEDY)",699766,699688,78
2019,"UNITED STATES OF AMERICA","USA","GATWICK","NEW YORK (NEWARK)",540,540,0
2019,"UNITED STATES OF AMERICA","USA","GATWICK","NEWBURGH/USA",0,0,0
2019,"UNITED STATES OF AMERICA","USA","GATWICK","OAKLAND",22609,22609,0
2019,"UNITED STATES OF AMERICA","USA","GATWICK","ORLANDO",973978,973204,774
2019,"UNITED STATES OF AMERICA","USA","GATWICK","PHILADELPHIA INTERNATIONAL",32,32,0
2019,"UNITED STATES OF AMERICA","USA","GATWICK","SAN FRANCISCO",116728,116551,177
2019,"UNITED STATES OF AMERICA","USA","GATWICK","SANFORD",36311,346,35965
2019,"UNITED STATES OF AMERICA","USA","GATWICK","SEATTLE (TACOMA)",72600,72600,0
2019,"UNITED STATES OF AMERICA","USA","GATWICK","TAMPA",234071,233636,435
2019,"UNITED STATES OF AMERICA","USA","GATWICK","TETERBORO",1,0,1
2019,"UNITED STATES OF AMERICA","USA","HEATHROW","ATLANTA",621852,621694,158
2019,"UNITED STATES OF AMERICA","USA","HEATHROW","AUSTIN (BERGSTROM)",188349,188349,0
2019,"UNITED STATES OF AMERICA","USA","HEATHROW","BALTIMORE",136538,136538,0
2019,"UNITED STATES OF AMERICA","USA","HEATHROW","BOSTON",970239,970239,0
2019,"UNITED STATES OF AMERICA","USA","HEATHROW","CHARLESTON",19503,19503,0
2019,"UNITED STATES OF AMERICA","USA","HEATHROW","CHARLOTTE",319493,319342,151
2019,"UNITED STATES OF AMERICA","USA","HEATHROW","CHICAGO (O'HARE)",1250426,1250019,407
2019,"UNITED STATES OF AMERICA","USA","HEATHROW","CINCINNATI",154,0,154
2019,"UNITED STATES OF AMERICA","USA","HEATHROW","CLEVELAND",0,0,0
2019,"UNITED STATES OF AMERICA","USA","HEATHROW","DALLAS/FORT WORTH",778797,778797,0
2019,"UNITED STATES OF AMERICA","USA","HEATHROW","DENVER INTERNATIONAL",306275,306275,0
2019,"UNITED STATES OF AMERICA","USA","HEATHROW","DETROIT",236225,236225,0
2019,"UNITED STATES OF AMERICA","USA","HEATHROW","HOUSTON",517011,516678,333
2019,"UNITED STATES OF AMERICA","USA","HEATHROW","INDIANAPOLIS",165,0,165
2019,"UNITED STATES OF AMERICA","USA","HEATHROW","JACKSONVILLE",412,0,412
2019,"UNITED STATES OF AMERICA","USA","HEATHROW","LAS VEGAS",352828,352828,0
2019,"UNITED STATES OF AMERICA","USA","HEATHROW","LOS ANGELES INTERNATIONAL",1602892,1602725,167
2019,"UNITED STATES OF AMERICA","USA","HEATHROW","MIAMI INTERNATIONAL",1069986,1069986,0
2019,"UNITED STATES OF AMERICA","USA","HEATHROW","MINNEAPOLIS-ST PAUL",136000,136000,0
2019,"UNITED STATES OF AMERICA","USA","HEATHROW","NASHVILLE METROPOLITAN",100918,100918,0
2019,"UNITED STATES OF AMERICA","USA","HEATHROW","NEW ORLEANS",86390,86390,0
2019,"UNITED STATES OF AMERICA","USA","HEATHROW","NEW YORK (JF KENNEDY)",3192195,3191631,564
2019,"UNITED STATES OF AMERICA","USA","HEATHROW","NEW YORK (NEWARK)",977730,977730,0
2019,"UNITED STATES OF AMERICA","USA","HEATHROW","OAKLAND",0,0,0
2019,"UNITED STATES OF AMERICA","USA","HEATHROW","ORLANDO",1107,775,332
2019,"UNITED STATES OF AMERICA","USA","HEATHROW","PHILADELPHIA INTERNATIONAL",480513,480513,0
2019,"UNITED STATES OF AMERICA","USA","HEATHROW","PHOENIX",312469,312469,0
2019,"UNITED STATES OF AMERICA","USA","HEATHROW","PITTSBURGH",51602,51602,0
2019,"UNITED STATES OF AMERICA","USA","HEATHROW","PORTLAND (OREGON)",57481,57481,0
2019,"UNITED STATES OF AMERICA","USA","HEATHROW","RALEIGH",143348,143348,0
2019,"UNITED STATES OF AMERICA","USA","HEATHROW","SALT LAKE CITY",80607,80607,0
2019,"UNITED STATES OF AMERICA","USA","HEATHROW","SAN DIEGO",173448,173448,0
2019,"UNITED STATES OF AMERICA","USA","HEATHROW","SAN FRANCISCO",1075554,1075554,0
2019,"UNITED STATES OF AMERICA","USA","HEATHROW","SAN JOSE",117896,117896,0
2019,"UNITED STATES OF AMERICA","USA","HEATHROW","SEATTLE (TACOMA)",426192,426192,0
2019,"UNITED STATES OF AMERICA","USA","HEATHROW","WASHINGTON (DULLES)",842269,841889,380
2019,"UNITED STATES OF AMERICA","USA","LONDON CITY","NEW YORK (JF KENNEDY)",10461,10461,0
2019,"UNITED STATES OF AMERICA","USA","LUTON","WASHINGTON (DULLES)",15,0,15
2019,"UNITED STATES OF AMERICA","USA","STANSTED","BOSTON",24,0,24
2019,"UNITED STATES OF AMERICA","USA","STANSTED","CHARLOTTE",79,0,79
2019,"UNITED STATES OF AMERICA","USA","STANSTED","COLUMBUS",756,0,756
2019,"UNITED STATES OF AMERICA","USA","STANSTED","COLUMBUS RICKENBACKER AFB",252,0,252
2019,"UNITED STATES OF AMERICA","USA","STANSTED","LAS VEGAS",0,0,0
2019,"UNITED STATES OF AMERICA","USA","STANSTED","NEW YORK (NEWARK)",329,329,0
2019,"UNITED STATES OF AMERICA","USA","STANSTED","ORLANDO",0,0,0
2019,"UNITED STATES OF AMERICA","USA","STANSTED","TAMPA",179,0,179
2019,"UNITED STATES OF AMERICA","USA","STANSTED","WASHINGTON (DULLES)",0,0,0
2019,"CENTRAL AMERICA","COSTA RICA","GATWICK","LIBERIA",30665,0,30665
2019,"CENTRAL AMERICA","COSTA RICA","GATWICK","SAN JOSE COST RICA",57189,57189,0
2019,"CENTRAL AMERICA","CUBA","GATWICK","CUNAGUA (CAYO COCO)",14044,14003,41
2019,"CENTRAL AMERICA","CUBA","GATWICK","HAVANA",49643,49643,0
2019,"CENTRAL AMERICA","CUBA","GATWICK","HOLGUIN (FRANK PAIS)",23371,23120,251
2019,"CENTRAL AMERICA","CUBA","GATWICK","VARADERO",0,0,0
2019,"CENTRAL AMERICA","CUBA","HEATHROW","HAVANA",0,0,0
2019,"CENTRAL AMERICA","DOMINICAN REPUBLIC","GATWICK","LA ROMANA",0,0,0
2019,"CENTRAL AMERICA","DOMINICAN REPUBLIC","GATWICK","PUERTO PLATA",0,0,0
2019,"CENTRAL AMERICA","DOMINICAN REPUBLIC","GATWICK","PUNTA CANA",182397,98825,83572
2019,"CENTRAL AMERICA","MEXICO","GATWICK","CANCUN",337866,336248,1618
2019,"CENTRAL AMERICA","MEXICO","GATWICK","LOS CABOS",4009,0,4009
2019,"CENTRAL AMERICA","MEXICO","GATWICK","MERIDA",0,0,0
2019,"CENTRAL AMERICA","MEXICO","GATWICK","PUERTO VALLARTA",25440,0,25440
2019,"CENTRAL AMERICA","MEXICO","HEATHROW","MEXICO CITY",261877,261877,0
2019,"CENTRAL AMERICA","MEXICO","HEATHROW","PUERTO VALLARTA",287,0,287
2019,"CENTRAL AMERICA","MEXICO","STANSTED","CANCUN",0,0,0
2019,"CENTRAL AMERICA","MEXICO","STANSTED","PUERTO VALLARTA",0,0,0
2019,"SOUTH AMERICA","ARGENTINA","GATWICK","BUENOS AIRES",187531,187531,0
2019,"SOUTH AMERICA","ARGENTINA","HEATHROW","BUENOS AIRES",173728,173728,0
2019,"SOUTH AMERICA","BRAZIL","GATWICK","MANAUS-EDUARDO GOMES",610,0,610
2019,"SOUTH AMERICA","BRAZIL","GATWICK","RIO DE JANEIRO (GALEAO)",85554,85554,0
2019,"SOUTH AMERICA","BRAZIL","HEATHROW","RIO DE JANEIRO (GALEAO)",137822,137822,0
2019,"SOUTH AMERICA","BRAZIL","HEATHROW","SAO PAULO (GUARULHOS)",450794,450794,0
2019,"SOUTH AMERICA","CHILE","HEATHROW","SANTIAGO DE CHILE",93407,93407,0
2019,"SOUTH AMERICA","COLOMBIA","HEATHROW","BOGOTA",161232,161232,0
2019,"SOUTH AMERICA","PERU","GATWICK","JORGE CHAVEZ INTERNATIONAL",43281,43281,0
2019,"CARIBBEAN AREA","ANTIGUA AND BARBUDA","GATWICK","ANTIGUA",193095,193095,0
2019,"CARIBBEAN AREA","ANTIGUA AND BARBUDA","HEATHROW","ANTIGUA",0,0,0
2019,"CARIBBEAN AREA","BAHAMAS","HEATHROW","NASSAU",57335,57335,0
2019,"CARIBBEAN AREA","BARBADOS","GATWICK","BRIDGETOWN",506291,411954,94337
2019,"CARIBBEAN AREA","BARBADOS","HEATHROW","BRIDGETOWN",7448,7143,305
2019,"CARIBBEAN AREA","BARBADOS","LUTON","BRIDGETOWN",0,0,0
2019,"CARIBBEAN AREA","BARBADOS","STANSTED","BRIDGETOWN",546,0,546
2019,"CARIBBEAN AREA","BERMUDA","GATWICK","BERMUDA",98469,98469,0
2019,"CARIBBEAN AREA","CAYMAN ISLANDS","HEATHROW","GRAND CAYMAN",38326,38326,0
2019,"CARIBBEAN AREA","GRENADA","GATWICK","GRENADA",35992,35992,0
2019,"CARIBBEAN AREA","GUADELOUPE","GATWICK","POINTE A PITRE GUADELOUPE",0,0,0
2019,"CARIBBEAN AREA","ISLE OF CURACAO NETH.ANTILLES","GATWICK","ARUBA",13762,0,13762
2019,"CARIBBEAN AREA","ISLE OF CURACAO NETH.ANTILLES","STANSTED","ARUBA",294,0,294
2019,"CARIBBEAN AREA","JAMAICA","GATWICK","KINGSTON",99935,99813,122
2019,"CARIBBEAN AREA","JAMAICA","GATWICK","MONTEGO BAY",209524,101409,108115
2019,"CARIBBEAN AREA","JAMAICA","HEATHROW","MONTEGO BAY",250,0,250
2019,"CARIBBEAN AREA","JAMAICA","STANSTED","KINGSTON",316,0,316
2019,"CARIBBEAN AREA","JAMAICA","STANSTED","MONTEGO BAY",1117,0,1117
2019,"CARIBBEAN AREA","SAINT KITTS AND NEVIS","GATWICK","ST KITTS",18191,18191,0
2019,"CARIBBEAN AREA","ST LUCIA","GATWICK","ST LUCIA (HEWANORRA)",199288,167606,31682
2019,"CARIBBEAN AREA","TRINIDAD AND TOBAGO","GATWICK","PORT OF SPAIN",66712,66712,0
2019,"CARIBBEAN AREA","TRINIDAD AND TOBAGO","GATWICK","TOBAGO",28918,28918,0
2019,"CARIBBEAN AREA","TURKS AND CAICOS ISLANDS","GATWICK","PROVIDENCIALES",12165,12165,0
2019,"INDIAN OCEAN ISLANDS","MALDIVE ISLANDS","GATWICK","MALE INTERNATIONAL",31893,31893,0
2019,"INDIAN OCEAN ISLANDS","MALDIVE ISLANDS","HEATHROW","MALE INTERNATIONAL",0,0,0
2019,"INDIAN OCEAN ISLANDS","MAURITIUS","GATWICK","MAURITIUS",132011,132011,0
2019,"INDIAN OCEAN ISLANDS","MAURITIUS","HEATHROW","MAURITIUS",86332,86332,0
2019,"INDIAN OCEAN ISLANDS","SEYCHELLES","HEATHROW","SEYCHELLES",38525,38525,0
2019,"ATLANTIC OCEAN ISLANDS","CAPE VERDE ISLANDS","GATWICK","BOA VISTA (RABIL)",88603,88603,0
2019,"ATLANTIC OCEAN ISLANDS","CAPE VERDE ISLANDS","GATWICK","ILHA DO SAL C.VERDE",75882,75882,0
2019,"ATLANTIC OCEAN ISLANDS","CAPE VERDE ISLANDS","LUTON","BOA VISTA (RABIL)",0,0,0
2019,"ATLANTIC OCEAN ISLANDS","CAPE VERDE ISLANDS","LUTON","ILHA DO SAL C.VERDE",0,0,0
2019,"ATLANTIC OCEAN ISLANDS","CAPE VERDE ISLANDS","STANSTED","ILHA DO SAL C.VERDE",0,0,0
2020,"WESTERN EUROPE-EU","AUSTRIA","GATWICK","INNSBRUCK",89209,73499,15710
2020,"WESTERN EUROPE-EU","AUSTRIA","GATWICK","KLAGENFURT",5021,5021,0
2020,"WESTERN EUROPE-EU","AUSTRIA","GATWICK","LINZ",180,180,0
2020,"WESTERN EUROPE-EU","AUSTRIA","GATWICK","SALZBURG",55958,48726,7232
2020,"WESTERN EUROPE-EU","AUSTRIA","GATWICK","VIENNA",30551,30551,0
2020,"WESTERN EUROPE-EU","AUSTRIA","HEATHROW","INNSBRUCK",15301,15301,0
2020,"WESTERN EUROPE-EU","AUSTRIA","HEATHROW","SALZBURG",11333,11333,0
2020,"WESTERN EUROPE-EU","AUSTRIA","HEATHROW","VIENNA",159500,159500,0
2020,"WESTERN EUROPE-EU","AUSTRIA","LUTON","GRAZ",129,0,129
2020,"WESTERN EUROPE-EU","AUSTRIA","LUTON","INNSBRUCK",8771,8771,0
2020,"WESTERN EUROPE-EU","AUSTRIA","LUTON","LINZ",0,0,0
2020,"WESTERN EUROPE-EU","AUSTRIA","LUTON","SALZBURG",6809,5104,1705
2020,"WESTERN EUROPE-EU","AUSTRIA","LUTON","VIENNA",19852,19852,0
2020,"WESTERN EUROPE-EU","AUSTRIA","STANSTED","GRAZ",0,0,0
2020,"WESTERN EUROPE-EU","AUSTRIA","STANSTED","INNSBRUCK",7031,987,6044
2020,"WESTERN EUROPE-EU","AUSTRIA","STANSTED","LINZ",0,0,0
2020,"WESTERN EUROPE-EU","AUSTRIA","STANSTED","SALZBURG",30345,27669,2676
2020,"WESTERN EUROPE-EU","AUSTRIA","STANSTED","VIENNA",59919,59834,85
2020,"WESTERN EUROPE-EU","BELGIUM","GATWICK","BRUSSELS",251,251,0
2020,"WESTERN EUROPE-EU","BELGIUM","HEATHROW","BRUSSELS",153830,153830,0
2020,"WESTERN EUROPE-EU","BELGIUM","LONDON CITY","ANTWERP",9163,9163,0
2020,"WESTERN EUROPE-EU","BELGIUM","LONDON CITY","BRUSSELS",26,26,0
2020,"WESTERN EUROPE-EU","BELGIUM","LUTON","LIEGE",0,0,0
2020,"WESTERN EUROPE-EU","BELGIUM","SOUTHEND","ANTWERP",0,0,0
2020,"WESTERN EUROPE-EU","BELGIUM","STANSTED","BRUSSELS",0,0,0
2020,"WESTERN EUROPE-EU","BELGIUM","STANSTED","CHARLEROI",128,128,0
2020,"WESTERN EUROPE-EU","CROATIA","GATWICK","DUBROVNIK",17928,17292,636
2020,"WESTERN EUROPE-EU","CROATIA","GATWICK","PULA",5229,5229,0
2020,"WESTERN EUROPE-EU","CROATIA","GATWICK","RIJEKA",0,0,0
2020,"WESTERN EUROPE-EU","CROATIA","GATWICK","SPLIT",21608,21459,149
2020,"WESTERN EUROPE-EU","CROATIA","GATWICK","ZADAR",2259,2259,0
2020,"WESTERN EUROPE-EU","CROATIA","GATWICK","ZAGREB",0,0,0
2020,"WESTERN EUROPE-EU","CROATIA","HEATHROW","DUBROVNIK",12395,12395,0
2020,"WESTERN EUROPE-EU","CROATIA","HEATHROW","PULA",2023,2023,0
2020,"WESTERN EUROPE-EU","CROATIA","HEATHROW","SPLIT",17742,17742,0
2020,"WESTERN EUROPE-EU","CROATIA","HEATHROW","ZAGREB",43011,42916,95
2020,"WESTERN EUROPE-EU","CROATIA","LONDON CITY","SPLIT",0,0,0
2020,"WESTERN EUROPE-EU","CROATIA","LUTON","DUBROVNIK",1804,1804,0
2020,"WESTERN EUROPE-EU","CROATIA","LUTON","PULA",2903,2903,0
2020,"WESTERN EUROPE-EU","CROATIA","LUTON","SPLIT",36711,36711,0
2020,"WESTERN EUROPE-EU","CROATIA","LUTON","ZADAR",3007,3007,0
2020,"WESTERN EUROPE-EU","CROATIA","SOUTHEND","DUBROVNIK",0,0,0
2020,"WESTERN EUROPE-EU","CROATIA","SOUTHEND","PULA",1782,1782,0
2020,"WESTERN EUROPE-EU","CROATIA","STANSTED","DUBROVNIK",3599,3599,0
2020,"WESTERN EUROPE-EU","CROATIA","STANSTED","PULA",5550,5550,0
2020,"WESTERN EUROPE-EU","CROATIA","STANSTED","RIJEKA",3222,3222,0
2020,"WESTERN EUROPE-EU","CROATIA","STANSTED","SPLIT",6079,6079,0
2020,"WESTERN EUROPE-EU","CROATIA","STANSTED","ZADAR",0,0,0
2020,"WESTERN EUROPE-EU","CYPRUS","GATWICK","LARNACA",40921,37484,3437
2020,"WESTERN EUROPE-EU","CYPRUS","GATWICK","PAPHOS",65254,51910,13344
2020,"WESTERN EUROPE-EU","CYPRUS","HEATHROW","LARNACA",110679,110302,377
2020,"WESTERN EUROPE-EU","CYPRUS","HEATHROW","PAPHOS",19000,19000,0
2020,"WESTERN EUROPE-EU","CYPRUS","LUTON","LARNACA",49367,49367,0
2020,"WESTERN EUROPE-EU","CYPRUS","LUTON","PAPHOS",27776,27255,521
2020,"WESTERN EUROPE-EU","CYPRUS","STANSTED","LARNACA",9484,9384,100
2020,"WESTERN EUROPE-EU","CYPRUS","STANSTED","PAPHOS",64492,63976,516
2020,"WESTERN EUROPE-EU","DENMARK","GATWICK","AARHUS (TIRSTRUP)",3913,3913,0
2020,"WESTERN EUROPE-EU","DENMARK","GATWICK","COPENHAGEN",150414,150414,0
2020,"WESTERN EUROPE-EU","DENMARK","HEATHROW","BILLUND",21729,21729,0
2020,"WESTERN EUROPE-EU","DENMARK","HEATHROW","COPENHAGEN",224022,224022,0
2020,"WESTERN EUROPE-EU","DENMARK","LONDON CITY","BILLUND",3758,3758,0
2020,"WESTERN EUROPE-EU","DENMARK","LUTON","COPENHAGEN",29315,29315,0
2020,"WESTERN EUROPE-EU","DENMARK","SOUTHEND","COPENHAGEN",0,0,0
2020,"WESTERN EUROPE-EU","DENMARK","SOUTHEND","KARUP",0,0,0
2020,"WESTERN EUROPE-EU","DENMARK","STANSTED","AALBORG",8866,8866,0
2020,"WESTERN EUROPE-EU","DENMARK","STANSTED","AARHUS (TIRSTRUP)",23180,23180,0
2020,"WESTERN EUROPE-EU","DENMARK","STANSTED","BILLUND",45104,45104,0
2020,"WESTERN EUROPE-EU","DENMARK","STANSTED","COPENHAGEN",106755,106245,510
2020,"WESTERN EUROPE-EU","DENMARK","STANSTED","KARUP",0,0,0
2020,"WESTERN EUROPE-EU","FINLAND","GATWICK","ENONTEKIO",656,394,262
2020,"WESTERN EUROPE-EU","FINLAND","GATWICK","HELSINKI",41358,41358,0
2020,"WESTERN EUROPE-EU","FINLAND","GATWICK","IVALO",4138,4138,0
2020,"WESTERN EUROPE-EU","FINLAND","GATWICK","KITTILA",6778,1847,4931
2020,"WESTERN EUROPE-EU","FINLAND","GATWICK","KUUSAMO",2269,0,2269
2020,"WESTERN EUROPE-EU","FINLAND","GATWICK","ROVANIEMI",15559,15404,155
2020,"WESTERN EUROPE-EU","FINLAND","HEATHROW","HELSINKI",220640,220640,0
2020,"WESTERN EUROPE-EU","FINLAND","LUTON","IVALO",0,0,0
2020,"WESTERN EUROPE-EU","FINLAND","LUTON","TURKU",0,0,0
2020,"WESTERN EUROPE-EU","FINLAND","STANSTED","ENONTEKIO",0,0,0
2020,"WESTERN EUROPE-EU","FINLAND","STANSTED","IVALO",0,0,0
2020,"WESTERN EUROPE-EU","FINLAND","STANSTED","KITTILA",0,0,0
2020,"WESTERN EUROPE-EU","FINLAND","STANSTED","ROVANIEMI",0,0,0
2020,"WESTERN EUROPE-EU","FRANCE","GATWICK","AJACCIO",0,0,0
2020,"WESTERN EUROPE-EU","FRANCE","GATWICK","BASTIA",0,0,0
2020,"WESTERN EUROPE-EU","FRANCE","GATWICK","BIARRITZ",1366,1366,0
2020,"WESTERN EUROPE-EU","FRANCE","GATWICK","BORDEAUX",54464,54399,65
2020,"WESTERN EUROPE-EU","FRANCE","GATWICK","CHAMBERY",29567,138,29429
2020,"WESTERN EUROPE-EU","FRANCE","GATWICK","CLERMONT FERRAND",100,0,100
2020,"WESTERN EUROPE-EU","FRANCE","GATWICK","FIGARI",1201,1201,0
2020,"WESTERN EUROPE-EU","FRANCE","GATWICK","GRENOBLE",55406,21436,33970
2020,"WESTERN EUROPE-EU","FRANCE","GATWICK","LA ROCHELLE",1919,1919,0
2020,"WESTERN EUROPE-EU","FRANCE","GATWICK","LILLE",0,0,0
2020,"WESTERN EUROPE-EU","FRANCE","GATWICK","LIMOGES",0,0,0
2020,"WESTERN EUROPE-EU","FRANCE","GATWICK","LYON",73496,55768,17728
2020,"WESTERN EUROPE-EU","FRANCE","GATWICK","MARSEILLE",31177,31177,0
2020,"WESTERN EUROPE-EU","FRANCE","GATWICK","MONTPELLIER",22696,22696,0
2020,"WESTERN EUROPE-EU","FRANCE","GATWICK","NANTES",33759,33759,0
2020,"WESTERN EUROPE-EU","FRANCE","GATWICK","NICE",103629,103629,0
2020,"WESTERN EUROPE-EU","FRANCE","GATWICK","PARIS (CHARLES DE GAULLE)",131258,131242,16
2020,"WESTERN EUROPE-EU","FRANCE","GATWICK","PARIS (ORLY)",5693,5693,0
2020,"WESTERN EUROPE-EU","FRANCE","GATWICK","PAU",83,0,83
2020,"WESTERN EUROPE-EU","FRANCE","GATWICK","RENNES",197,0,197
2020,"WESTERN EUROPE-EU","FRANCE","GATWICK","TOULON / HYERES",0,0,0
2020,"WESTERN EUROPE-EU","FRANCE","GATWICK","TOULOUSE (BLAGNAC)",56211,48427,7784
2020,"WESTERN EUROPE-EU","FRANCE","HEATHROW","BASTIA",1043,1043,0
2020,"WESTERN EUROPE-EU","FRANCE","HEATHROW","BORDEAUX",6256,6256,0
2020,"WESTERN EUROPE-EU","FRANCE","HEATHROW","CHATEAUROUX DEOLS",58,58,0
2020,"WESTERN EUROPE-EU","FRANCE","HEATHROW","FIGARI",842,842,0
2020,"WESTERN EUROPE-EU","FRANCE","HEATHROW","GRENOBLE",3985,3985,0
2020,"WESTERN EUROPE-EU","FRANCE","HEATHROW","LYON",66724,66650,74
2020,"WESTERN EUROPE-EU","FRANCE","HEATHROW","MARSEILLE",74557,74255,302
2020,"WESTERN EUROPE-EU","FRANCE","HEATHROW","MONTPELLIER",0,0,0
2020,"WESTERN EUROPE-EU","FRANCE","HEATHROW","NANTES",0,0,0
2020,"WESTERN EUROPE-EU","FRANCE","HEATHROW","NICE",161082,161082,0
2020,"WESTERN EUROPE-EU","FRANCE","HEATHROW","PARIS (CHARLES DE GAULLE)",375868,375777,91
2020,"WESTERN EUROPE-EU","FRANCE","HEATHROW","PARIS (LE BOURGET)",116,0,116
2020,"WESTERN EUROPE-EU","FRANCE","HEATHROW","PARIS (ORLY)",36,36,0
2020,"WESTERN EUROPE-EU","FRANCE","HEATHROW","TOULOUSE (BLAGNAC)",71521,71521,0
2020,"WESTERN EUROPE-EU","FRANCE","LONDON CITY","BERGERAC",1262,1262,0
2020,"WESTERN EUROPE-EU","FRANCE","LONDON CITY","CHAMBERY",2402,2402,0
2020,"WESTERN EUROPE-EU","FRANCE","LONDON CITY","DINARD",0,0,0
2020,"WESTERN EUROPE-EU","FRANCE","LONDON CITY","GRENOBLE",26,26,0
2020,"WESTERN EUROPE-EU","FRANCE","LONDON CITY","NICE",2823,2823,0
2020,"WESTERN EUROPE-EU","FRANCE","LONDON CITY","PARIS (ORLY)",0,0,0
2020,"WESTERN EUROPE-EU","FRANCE","LONDON CITY","QUIMPER",0,0,0
2020,"WESTERN EUROPE-EU","FRANCE","LONDON CITY","RENNES",0,0,0
2020,"WESTERN EUROPE-EU","FRANCE","LUTON","BEZIERS",9115,9115,0
2020,"WESTERN EUROPE-EU","FRANCE","LUTON","BIARRITZ",457,457,0
2020,"WESTERN EUROPE-EU","FRANCE","LUTON","BORDEAUX",13438,13438,0
2020,"WESTERN EUROPE-EU","FRANCE","LUTON","CHAMBERY",0,0,0
2020,"WESTERN EUROPE-EU","FRANCE","LUTON","GRENOBLE",10152,10152,0
2020,"WESTERN EUROPE-EU","FRANCE","LUTON","LA ROCHELLE",0,0,0
2020,"WESTERN EUROPE-EU","FRANCE","LUTON","LYON",26436,26436,0
2020,"WESTERN EUROPE-EU","FRANCE","LUTON","MARSEILLE",5940,5940,0
2020,"WESTERN EUROPE-EU","FRANCE","LUTON","MONTPELLIER",918,918,0
2020,"WESTERN EUROPE-EU","FRANCE","LUTON","NANTES",8325,8325,0
2020,"WESTERN EUROPE-EU","FRANCE","LUTON","NICE",20500,20500,0
2020,"WESTERN EUROPE-EU","FRANCE","LUTON","NIMES",1861,1861,0
2020,"WESTERN EUROPE-EU","FRANCE","LUTON","PARIS (CHARLES DE GAULLE)",74617,74617,0
2020,"WESTERN EUROPE-EU","FRANCE","LUTON","PARIS (ORLY)",0,0,0
2020,"WESTERN EUROPE-EU","FRANCE","LUTON","PAU",0,0,0
2020,"WESTERN EUROPE-EU","FRANCE","LUTON","RENNES",0,0,0
2020,"WESTERN EUROPE-EU","FRANCE","LUTON","TOULOUSE (BLAGNAC)",0,0,0
2020,"WESTERN EUROPE-EU","FRANCE","SOUTHEND","BERGERAC",978,978,0
2020,"WESTERN EUROPE-EU","FRANCE","SOUTHEND","BORDEAUX",0,0,0
2020,"WESTERN EUROPE-EU","FRANCE","SOUTHEND","BREST",5441,5441,0
2020,"WESTERN EUROPE-EU","FRANCE","SOUTHEND","CAEN",1361,1361,0
2020,"WESTERN EUROPE-EU","FRANCE","SOUTHEND","LYON",0,0,0
2020,"WESTERN EUROPE-EU","FRANCE","SOUTHEND","MARSEILLE",1401,1401,0
2020,"WESTERN EUROPE-EU","FRANCE","SOUTHEND","PARIS (CHARLES DE GAULLE)",8529,8529,0
2020,"WESTERN EUROPE-EU","FRANCE","SOUTHEND","RENNES",5490,5490,0
2020,"WESTERN EUROPE-EU","FRANCE","SOUTHEND","TARBES-LOURDES INTERNATIONAL",0,0,0
2020,"WESTERN EUROPE-EU","FRANCE","STANSTED","AJACCIO",0,0,0
2020,"WESTERN EUROPE-EU","FRANCE","STANSTED","BASTIA",0,0,0
2020,"WESTERN EUROPE-EU","FRANCE","STANSTED","BERGERAC",19694,19694,0
2020,"WESTERN EUROPE-EU","FRANCE","STANSTED","BEZIERS",3301,3301,0
2020,"WESTERN EUROPE-EU","FRANCE","STANSTED","BIARRITZ",21935,21935,0
2020,"WESTERN EUROPE-EU","FRANCE","STANSTED","BORDEAUX",28880,28880,0
2020,"WESTERN EUROPE-EU","FRANCE","STANSTED","BREST",0,0,0
2020,"WESTERN EUROPE-EU","FRANCE","STANSTED","BRIVE-LA-GAILLARDE",2782,2782,0
2020,"WESTERN EUROPE-EU","FRANCE","STANSTED","CALVI",0,0,0
2020,"WESTERN EUROPE-EU","FRANCE","STANSTED","CARCASSONNE",17277,17277,0
2020,"WESTERN EUROPE-EU","FRANCE","STANSTED","CHAMBERY",10487,3145,7342
2020,"WESTERN EUROPE-EU","FRANCE","STANSTED","CLERMONT FERRAND",0,0,0
2020,"WESTERN EUROPE-EU","FRANCE","STANSTED","DINARD",14816,14816,0
2020,"WESTERN EUROPE-EU","FRANCE","STANSTED","DOLE",1560,1560,0
2020,"WESTERN EUROPE-EU","FRANCE","STANSTED","FIGARI",0,0,0
2020,"WESTERN EUROPE-EU","FRANCE","STANSTED","GRENOBLE",27248,26424,824
2020,"WESTERN EUROPE-EU","FRANCE","STANSTED","LA ROCHELLE",10572,10572,0
2020,"WESTERN EUROPE-EU","FRANCE","STANSTED","LIMOGES",22499,22499,0
2020,"WESTERN EUROPE-EU","FRANCE","STANSTED","LYON",8179,8008,171
2020,"WESTERN EUROPE-EU","FRANCE","STANSTED","MARSEILLE",33290,33290,0
2020,"WESTERN EUROPE-EU","FRANCE","STANSTED","MONTPELLIER",0,0,0
2020,"WESTERN EUROPE-EU","FRANCE","STANSTED","NANTES",33448,33448,0
2020,"WESTERN EUROPE-EU","FRANCE","STANSTED","NICE",32099,32086,13
2020,"WESTERN EUROPE-EU","FRANCE","STANSTED","NIMES",6049,6049,0
2020,"WESTERN EUROPE-EU","FRANCE","STANSTED","PARIS (CHARLES DE GAULLE)",9693,9687,6
2020,"WESTERN EUROPE-EU","FRANCE","STANSTED","PARIS (ORLY)",0,0,0
2020,"WESTERN EUROPE-EU","FRANCE","STANSTED","PAU",0,0,0
2020,"WESTERN EUROPE-EU","FRANCE","STANSTED","PERPIGNAN",5455,5455,0
2020,"WESTERN EUROPE-EU","FRANCE","STANSTED","POITIERS",12539,12539,0
2020,"WESTERN EUROPE-EU","FRANCE","STANSTED","RENNES",0,0,0
2020,"WESTERN EUROPE-EU","FRANCE","STANSTED","RODEZ",0,0,0
2020,"WESTERN EUROPE-EU","FRANCE","STANSTED","STRASBOURG",0,0,0
2020,"WESTERN EUROPE-EU","FRANCE","STANSTED","TARBES-LOURDES INTERNATIONAL",11986,11986,0
2020,"WESTERN EUROPE-EU","FRANCE","STANSTED","TOULON / HYERES",0,0,0
2020,"WESTERN EUROPE-EU","FRANCE","STANSTED","TOULOUSE (BLAGNAC)",48147,48036,111
2020,"WESTERN EUROPE-EU","FRANCE","STANSTED","TOURS",9866,9866,0
2020,"WESTERN EUROPE-EU","GERMANY","GATWICK","BERLIN (TEGEL)",75616,75616,0
2020,"WESTERN EUROPE-EU","GERMANY","GATWICK","BERLIN BRANDENBURG",38638,38638,0
2020,"WESTERN EUROPE-EU","GERMANY","GATWICK","COLOGNE BONN",9218,8463,755
2020,"WESTERN EUROPE-EU","GERMANY","GATWICK","DUSSELDORF",36272,36272,0
2020,"WESTERN EUROPE-EU","GERMANY","GATWICK","FRANKFURT MAIN",100,0,100
2020,"WESTERN EUROPE-EU","GERMANY","GATWICK","FRIEDRICHSHAFEN",14622,6940,7682
2020,"WESTERN EUROPE-EU","GERMANY","GATWICK","HAMBURG",33445,33369,76
2020,"WESTERN EUROPE-EU","GERMANY","GATWICK","HANOVER",384,0,384
2020,"WESTERN EUROPE-EU","GERMANY","GATWICK","LEIPZIG",61,0,61
2020,"WESTERN EUROPE-EU","GERMANY","GATWICK","MUNICH",50403,50177,226
2020,"WESTERN EUROPE-EU","GERMANY","GATWICK","NUREMBERG",1091,1091,0
2020,"WESTERN EUROPE-EU","GERMANY","GATWICK","STUTTGART",19079,19079,0
2020,"WESTERN EUROPE-EU","GERMANY","HEATHROW","BERLIN (TEGEL)",201180,201180,0
2020,"WESTERN EUROPE-EU","GERMANY","HEATHROW","BERLIN BRANDENBURG",9721,9721,0
2020,"WESTERN EUROPE-EU","GERMANY","HEATHROW","COLOGNE BONN",44332,44332,0
2020,"WESTERN EUROPE-EU","GERMANY","HEATHROW","DUSSELDORF",193992,193992,0
2020,"WESTERN EUROPE-EU","GERMANY","HEATHROW","FRANKFURT MAIN",412506,412426,80
2020,"WESTERN EUROPE-EU","GERMANY","HEATHROW","FRIEDRICHSHAFEN",273,0,273
2020,"WESTERN EUROPE-EU","GERMANY","HEATHROW","HAMBURG",167148,167080,68
2020,"WESTERN EUROPE-EU","GERMANY","HEATHROW","HANOVER",37896,37896,0
2020,"WESTERN EUROPE-EU","GERMANY","HEATHROW","MUNICH",316687,316253,434
2020,"WESTERN EUROPE-EU","GERMANY","HEATHROW","STUTTGART",89367,89367,0
2020,"WESTERN EUROPE-EU","GERMANY","LONDON CITY","BERLIN (TEGEL)",32838,32838,0
2020,"WESTERN EUROPE-EU","GERMANY","LONDON CITY","DUSSELDORF",20069,20069,0
2020,"WESTERN EUROPE-EU","GERMANY","LONDON CITY","FRANKFURT MAIN",47026,47026,0
2020,"WESTERN EUROPE-EU","GERMANY","LONDON CITY","MUNICH",20450,20400,50
2020,"WESTERN EUROPE-EU","GERMANY","LUTON","BERLIN BRANDENBURG",29010,29010,0
2020,"WESTERN EUROPE-EU","GERMANY","LUTON","DORTMUND",18017,18017,0
2020,"WESTERN EUROPE-EU","GERMANY","LUTON","DRESDEN",0,0,0
2020,"WESTERN EUROPE-EU","GERMANY","LUTON","DUSSELDORF",0,0,0
2020,"WESTERN EUROPE-EU","GERMANY","LUTON","FRANKFURT MAIN",0,0,0
2020,"WESTERN EUROPE-EU","GERMANY","LUTON","MUNICH",11997,11997,0
2020,"WESTERN EUROPE-EU","GERMANY","SOUTHEND","COLOGNE BONN",0,0,0
2020,"WESTERN EUROPE-EU","GERMANY","SOUTHEND","DUSSELDORF",0,0,0
2020,"WESTERN EUROPE-EU","GERMANY","SOUTHEND","MUNICH",0,0,0
2020,"WESTERN EUROPE-EU","GERMANY","SOUTHEND","PADERBORN",0,0,0
2020,"WESTERN EUROPE-EU","GERMANY","STANSTED","BERLIN (TEGEL)",932,930,2
2020,"WESTERN EUROPE-EU","GERMANY","STANSTED","BERLIN BRANDENBURG",139325,139148,177
2020,"WESTERN EUROPE-EU","GERMANY","STANSTED","BREMEN",45176,45176,0
2020,"WESTERN EUROPE-EU","GERMANY","STANSTED","COLOGNE BONN",77504,77423,81
2020,"WESTERN EUROPE-EU","GERMANY","STANSTED","DORTMUND",36167,36167,0
2020,"WESTERN EUROPE-EU","GERMANY","STANSTED","DRESDEN",14338,14338,0
2020,"WESTERN EUROPE-EU","GERMANY","STANSTED","DUSSELDORF",8713,8713,0
2020,"WESTERN EUROPE-EU","GERMANY","STANSTED","FRANKFURT MAIN",87804,87804,0
2020,"WESTERN EUROPE-EU","GERMANY","STANSTED","FRIEDRICHSHAFEN",2022,2022,0
2020,"WESTERN EUROPE-EU","GERMANY","STANSTED","HAHN",0,0,0
2020,"WESTERN EUROPE-EU","GERMANY","STANSTED","HAMBURG",34409,34409,0
2020,"WESTERN EUROPE-EU","GERMANY","STANSTED","HANOVER",1002,0,1002
2020,"WESTERN EUROPE-EU","GERMANY","STANSTED","KARLSRUHE/BADEN BADEN",33799,33799,0
2020,"WESTERN EUROPE-EU","GERMANY","STANSTED","LEIPZIG",747,0,747
2020,"WESTERN EUROPE-EU","GERMANY","STANSTED","MEMMINGEN ALLGAU",25137,25137,0
2020,"WESTERN EUROPE-EU","GERMANY","STANSTED","MUNICH",12605,12499,106
2020,"WESTERN EUROPE-EU","GERMANY","STANSTED","MUNSTER-OSNABRUCK",0,0,0
2020,"WESTERN EUROPE-EU","GERMANY","STANSTED","NIEDERRHEIN",0,0,0
2020,"WESTERN EUROPE-EU","GERMANY","STANSTED","NUREMBERG",33622,33622,0
2020,"WESTERN EUROPE-EU","GERMANY","STANSTED","STUTTGART",0,0,0
2020,"WESTERN EUROPE-EU","GIBRALTAR","GATWICK","GIBRALTAR",45779,45779,0
2020,"WESTERN EUROPE-EU","GIBRALTAR","HEATHROW","GIBRALTAR",87632,87216,416
2020,"WESTERN EUROPE-EU","GIBRALTAR","LUTON","GIBRALTAR",6979,6979,0
2020,"WESTERN EUROPE-EU","GIBRALTAR","SOUTHEND","GIBRALTAR",70,70,0
2020,"WESTERN EUROPE-EU","GIBRALTAR","STANSTED","GIBRALTAR",69,0,69
2020,"WESTERN EUROPE-EU","GREECE","GATWICK","ATHENS",71482,71298,184
2020,"WESTERN EUROPE-EU","GREECE","GATWICK","CHANIA",24641,22923,1718
2020,"WESTERN EUROPE-EU","GREECE","GATWICK","CORFU",66369,53363,13006
2020,"WESTERN EUROPE-EU","GREECE","GATWICK","HERAKLION",42156,34183,7973
2020,"WESTERN EUROPE-EU","GREECE","GATWICK","KALAMATA",8868,8868,0
2020,"WESTERN EUROPE-EU","GREECE","GATWICK","KAVALA",0,0,0
2020,"WESTERN EUROPE-EU","GREECE","GATWICK","KEFALLINIA",33321,31236,2085
2020,"WESTERN EUROPE-EU","GREECE","GATWICK","KOS",38849,12818,26031
2020,"WESTERN EUROPE-EU","GREECE","GATWICK","LEMNOS",2677,568,2109
2020,"WESTERN EUROPE-EU","GREECE","GATWICK","MIKONOS",24901,24901,0
2020,"WESTERN EUROPE-EU","GREECE","GATWICK","MYTILINI",0,0,0
2020,"WESTERN EUROPE-EU","GREECE","GATWICK","NEA ANCHIALOS",1346,1346,0
2020,"WESTERN EUROPE-EU","GREECE","GATWICK","PREVEZA",21565,18201,3364
2020,"WESTERN EUROPE-EU","GREECE","GATWICK","RHODES",85078,52445,32633
2020,"WESTERN EUROPE-EU","GREECE","GATWICK","SALONIKA",45398,42260,3138
2020,"WESTERN EUROPE-EU","GREECE","GATWICK","SAMOS",0,0,0
2020,"WESTERN EUROPE-EU","GREECE","GATWICK","SKIATHOS",3890,0,3890
2020,"WESTERN EUROPE-EU","GREECE","GATWICK","THIRA (SANTORINI)",21912,20165,1747
2020,"WESTERN EUROPE-EU","GREECE","GATWICK","VOLOS NEA ANCHILOS",2310,2310,0
2020,"WESTERN EUROPE-EU","GREECE","GATWICK","ZAKINTHOS",26953,21672,5281
2020,"WESTERN EUROPE-EU","GREECE","HEATHROW","ATHENS",287138,286550,588
2020,"WESTERN EUROPE-EU","GREECE","HEATHROW","CHANIA",14944,14944,0
2020,"WESTERN EUROPE-EU","GREECE","HEATHROW","CORFU",48748,48748,0
2020,"WESTERN EUROPE-EU","GREECE","HEATHROW","HERAKLION",14178,14178,0
2020,"WESTERN EUROPE-EU","GREECE","HEATHROW","KALAMATA",7519,7519,0
2020,"WESTERN EUROPE-EU","GREECE","HEATHROW","KEFALLINIA",6921,6921,0
2020,"WESTERN EUROPE-EU","GREECE","HEATHROW","KOS",12066,12066,0
2020,"WESTERN EUROPE-EU","GREECE","HEATHROW","LEMNOS",0,0,0
2020,"WESTERN EUROPE-EU","GREECE","HEATHROW","MIKONOS",16929,16929,0
2020,"WESTERN EUROPE-EU","GREECE","HEATHROW","PREVEZA",13479,10542,2937
2020,"WESTERN EUROPE-EU","GREECE","HEATHROW","RHODES",15907,15907,0
2020,"WESTERN EUROPE-EU","GREECE","HEATHROW","SALONIKA",18494,18437,57
2020,"WESTERN EUROPE-EU","GREECE","HEATHROW","THIRA (SANTORINI)",18300,18300,0
2020,"WESTERN EUROPE-EU","GREECE","HEATHROW","ZAKINTHOS",4939,4939,0
2020,"WESTERN EUROPE-EU","GREECE","LONDON CITY","MIKONOS",0,0,0
2020,"WESTERN EUROPE-EU","GREECE","LONDON CITY","SKIATHOS",0,0,0
2020,"WESTERN EUROPE-EU","GREECE","LONDON CITY","THIRA (SANTORINI)",0,0,0
2020,"WESTERN EUROPE-EU","GREECE","LUTON","ATHENS",85034,85034,0
2020,"WESTERN EUROPE-EU","GREECE","LUTON","CORFU",33854,33854,0
2020,"WESTERN EUROPE-EU","GREECE","LUTON","HERAKLION",20911,20911,0
2020,"WESTERN EUROPE-EU","GREECE","LUTON","MIKONOS",4038,4038,0
2020,"WESTERN EUROPE-EU","GREECE","LUTON","RHODES",18651,18651,0
2020,"WESTERN EUROPE-EU","GREECE","LUTON","SALONIKA",21954,21951,3
2020,"WESTERN EUROPE-EU","GREECE","LUTON","SKIATHOS",0,0,0
2020,"WESTERN EUROPE-EU","GREECE","LUTON","THIRA (SANTORINI)",16584,16584,0
2020,"WESTERN EUROPE-EU","GREECE","LUTON","ZAKINTHOS",7591,7591,0
2020,"WESTERN EUROPE-EU","GREECE","SOUTHEND","CORFU",6334,6334,0
2020,"WESTERN EUROPE-EU","GREECE","STANSTED","ATHENS",52337,51315,1022
2020,"WESTERN EUROPE-EU","GREECE","STANSTED","CHANIA",9528,9528,0
2020,"WESTERN EUROPE-EU","GREECE","STANSTED","CORFU",22690,19765,2925
2020,"WESTERN EUROPE-EU","GREECE","STANSTED","HERAKLION",12902,11129,1773
2020,"WESTERN EUROPE-EU","GREECE","STANSTED","KALAMATA",2221,2221,0
2020,"WESTERN EUROPE-EU","GREECE","STANSTED","KEFALLINIA",12070,12033,37
2020,"WESTERN EUROPE-EU","GREECE","STANSTED","KOS",15413,15413,0
2020,"WESTERN EUROPE-EU","GREECE","STANSTED","MIKONOS",0,0,0
2020,"WESTERN EUROPE-EU","GREECE","STANSTED","MYTILINI",0,0,0
2020,"WESTERN EUROPE-EU","GREECE","STANSTED","PREVEZA",0,0,0
2020,"WESTERN EUROPE-EU","GREECE","STANSTED","RHODES",24569,17515,7054
2020,"WESTERN EUROPE-EU","GREECE","STANSTED","SALONIKA",40861,40861,0
2020,"WESTERN EUROPE-EU","GREECE","STANSTED","SKIATHOS",5443,5443,0
2020,"WESTERN EUROPE-EU","GREECE","STANSTED","THIRA (SANTORINI)",461,461,0
2020,"WESTERN EUROPE-EU","GREECE","STANSTED","ZAKINTHOS",9719,9719,0
2020,"WESTERN EUROPE-EU","IRISH REPUBLIC","GATWICK","CORK",34456,34456,0
2020,"WESTERN EUROPE-EU","IRISH REPUBLIC","GATWICK","DUBLIN",342170,342170,0
2020,"WESTERN EUROPE-EU","IRISH REPUBLIC","GATWICK","IRELAND WEST(KNOCK)",13228,13228,0
2020,"WESTERN EUROPE-EU","IRISH REPUBLIC","GATWICK","SHANNON",30494,30388,106
2020,"WESTERN EUROPE-EU","IRISH REPUBLIC","HEATHROW","CORK",90972,90972,0
2020,"WESTERN EUROPE-EU","IRISH REPUBLIC","HEATHROW","DUBLIN",445222,444904,318
2020,"WESTERN EUROPE-EU","IRISH REPUBLIC","HEATHROW","SHANNON",45007,45007,0
2020,"WESTERN EUROPE-EU","IRISH REPUBLIC","LONDON CITY","DUBLIN",83321,83250,71
2020,"WESTERN EUROPE-EU","IRISH REPUBLIC","LUTON","CORK",19422,19422,0
2020,"WESTERN EUROPE-EU","IRISH REPUBLIC","LUTON","DUBLIN",93827,93801,26
2020,"WESTERN EUROPE-EU","IRISH REPUBLIC","LUTON","IRELAND WEST(KNOCK)",31012,31012,0
2020,"WESTERN EUROPE-EU","IRISH REPUBLIC","LUTON","KERRY COUNTY",26499,26499,0
2020,"WESTERN EUROPE-EU","IRISH REPUBLIC","LUTON","SHANNON",122,122,0
2020,"WESTERN EUROPE-EU","IRISH REPUBLIC","SOUTHEND","DUBLIN",18868,18868,0
2020,"WESTERN EUROPE-EU","IRISH REPUBLIC","SOUTHEND","SHANNON",0,0,0
2020,"WESTERN EUROPE-EU","IRISH REPUBLIC","STANSTED","CORK",84135,84135,0
2020,"WESTERN EUROPE-EU","IRISH REPUBLIC","STANSTED","DUBLIN",257548,257543,5
2020,"WESTERN EUROPE-EU","IRISH REPUBLIC","STANSTED","IRELAND WEST(KNOCK)",39091,39091,0
2020,"WESTERN EUROPE-EU","IRISH REPUBLIC","STANSTED","KERRY COUNTY",20629,20629,0
2020,"WESTERN EUROPE-EU","IRISH REPUBLIC","STANSTED","SHANNON",49428,49428,0
2020,"WESTERN EUROPE-EU","ITALY","GATWICK","ALGHERO (FERTILIA)",0,0,0
2020,"WESTERN EUROPE-EU","ITALY","GATWICK","ANCONA",3724,3724,0
2020,"WESTERN EUROPE-EU","ITALY","GATWICK","BARI (PALESE)",12883,12883,0
2020,"WESTERN EUROPE-EU","ITALY","GATWICK","BERGAMO",10695,10695,0
2020,"WESTERN EUROPE-EU","ITALY","GATWICK","BOLOGNA",11766,11766,0
2020,"WESTERN EUROPE-EU","ITALY","GATWICK","BRINDISI",0,0,0
2020,"WESTERN EUROPE-EU","ITALY","GATWICK","CAGLIARI (ELMAS)",0,0,0
2020,"WESTERN EUROPE-EU","ITALY","GATWICK","CATANIA (FONTANAROSSA)",35455,35455,0
2020,"WESTERN EUROPE-EU","ITALY","GATWICK","FLORENCE",26380,26380,0
2020,"WESTERN EUROPE-EU","ITALY","GATWICK","GENOA",7262,7262,0
2020,"WESTERN EUROPE-EU","ITALY","GATWICK","LAMETIA-TERME",0,0,0
2020,"WESTERN EUROPE-EU","ITALY","GATWICK","MILAN (LINATE)",51505,51505,0
2020,"WESTERN EUROPE-EU","ITALY","GATWICK","MILAN (MALPENSA)",111380,111061,319
2020,"WESTERN EUROPE-EU","ITALY","GATWICK","NAPLES",60128,57960,2168
2020,"WESTERN EUROPE-EU","ITALY","GATWICK","OLBIA",15197,15197,0
2020,"WESTERN EUROPE-EU","ITALY","GATWICK","PALERMO",18837,18837,0
2020,"WESTERN EUROPE-EU","ITALY","GATWICK","PISA",33542,33542,0
2020,"WESTERN EUROPE-EU","ITALY","GATWICK","ROME (FIUMICINO)",159284,159116,168
2020,"WESTERN EUROPE-EU","ITALY","GATWICK","TURIN",67029,56860,10169
2020,"WESTERN EUROPE-EU","ITALY","GATWICK","VENICE",106409,106409,0
2020,"WESTERN EUROPE-EU","ITALY","GATWICK","VERONA VILLAFRANCA",36050,32600,3450
2020,"WESTERN EUROPE-EU","ITALY","HEATHROW","BARI (PALESE)",14289,14289,0
2020,"WESTERN EUROPE-EU","ITALY","HEATHROW","BOLOGNA",73953,73875,78
2020,"WESTERN EUROPE-EU","ITALY","HEATHROW","BRINDISI",12389,12389,0
2020,"WESTERN EUROPE-EU","ITALY","HEATHROW","CAGLIARI (ELMAS)",11067,11067,0
2020,"WESTERN EUROPE-EU","ITALY","HEATHROW","CATANIA (FONTANAROSSA)",19360,19360,0
2020,"WESTERN EUROPE-EU","ITALY","HEATHROW","GENOA",910,910,0
2020,"WESTERN EUROPE-EU","ITALY","HEATHROW","LAMETIA-TERME",0,0,0
2020,"WESTERN EUROPE-EU","ITALY","HEATHROW","MILAN (LINATE)",145055,145055,0
2020,"WESTERN EUROPE-EU","ITALY","HEATHROW","MILAN (MALPENSA)",76775,76775,0
2020,"WESTERN EUROPE-EU","ITALY","HEATHROW","NAPLES",47050,47050,0
2020,"WESTERN EUROPE-EU","ITALY","HEATHROW","OLBIA",11393,11393,0
2020,"WESTERN EUROPE-EU","ITALY","HEATHROW","PALERMO",20092,20092,0
2020,"WESTERN EUROPE-EU","ITALY","HEATHROW","PISA",56375,56375,0
2020,"WESTERN EUROPE-EU","ITALY","HEATHROW","RIMINI",104,104,0
2020,"WESTERN EUROPE-EU","ITALY","HEATHROW","ROME (FIUMICINO)",305724,305626,98
2020,"WESTERN EUROPE-EU","ITALY","HEATHROW","TURIN",13363,13363,0
2020,"WESTERN EUROPE-EU","ITALY","HEATHROW","VENICE",74151,74151,0
2020,"WESTERN EUROPE-EU","ITALY","HEATHROW","VERONA VILLAFRANCA",17859,17859,0
2020,"WESTERN EUROPE-EU","ITALY","LONDON CITY","BOLOGNA",98,98,0
2020,"WESTERN EUROPE-EU","ITALY","LONDON CITY","FLORENCE",31736,31616,120
2020,"WESTERN EUROPE-EU","ITALY","LONDON CITY","MILAN (LINATE)",53274,53205,69
2020,"WESTERN EUROPE-EU","ITALY","LONDON CITY","MILAN (MALPENSA)",0,0,0
2020,"WESTERN EUROPE-EU","ITALY","LONDON CITY","PISA",58,58,0
2020,"WESTERN EUROPE-EU","ITALY","LONDON CITY","ROME (FIUMICINO)",6011,6011,0
2020,"WESTERN EUROPE-EU","ITALY","LONDON CITY","TREVISO",0,0,0
2020,"WESTERN EUROPE-EU","ITALY","LONDON CITY","VENICE",0,0,0
2020,"WESTERN EUROPE-EU","ITALY","LUTON","ALGHERO (FERTILIA)",7287,7287,0
2020,"WESTERN EUROPE-EU","ITALY","LUTON","BARI (PALESE)",0,0,0
2020,"WESTERN EUROPE-EU","ITALY","LUTON","BOLOGNA",29142,29142,0
2020,"WESTERN EUROPE-EU","ITALY","LUTON","CATANIA (FONTANAROSSA)",21386,21386,0
2020,"WESTERN EUROPE-EU","ITALY","LUTON","FLORENCE",2029,2029,0
2020,"WESTERN EUROPE-EU","ITALY","LUTON","GENOA",0,0,0
2020,"WESTERN EUROPE-EU","ITALY","LUTON","MILAN (MALPENSA)",108728,108728,0
2020,"WESTERN EUROPE-EU","ITALY","LUTON","NAPLES",23282,23282,0
2020,"WESTERN EUROPE-EU","ITALY","LUTON","OLBIA",5225,5225,0
2020,"WESTERN EUROPE-EU","ITALY","LUTON","PALERMO",7429,7429,0
2020,"WESTERN EUROPE-EU","ITALY","LUTON","PISA",6542,6542,0
2020,"WESTERN EUROPE-EU","ITALY","LUTON","ROME (FIUMICINO)",12049,12049,0
2020,"WESTERN EUROPE-EU","ITALY","LUTON","TURIN",2766,2766,0
2020,"WESTERN EUROPE-EU","ITALY","LUTON","VENICE",18097,18097,0
2020,"WESTERN EUROPE-EU","ITALY","LUTON","VERONA VILLAFRANCA",0,0,0
2020,"WESTERN EUROPE-EU","ITALY","SOUTHEND","BERGAMO",5595,5595,0
2020,"WESTERN EUROPE-EU","ITALY","SOUTHEND","CATANIA (FONTANAROSSA)",0,0,0
2020,"WESTERN EUROPE-EU","ITALY","SOUTHEND","TREVISO",6732,6732,0
2020,"WESTERN EUROPE-EU","ITALY","SOUTHEND","TURIN",301,301,0
2020,"WESTERN EUROPE-EU","ITALY","SOUTHEND","VENICE",1920,1920,0
2020,"WESTERN EUROPE-EU","ITALY","SOUTHEND","VERONA VILLAFRANCA",259,259,0
2020,"WESTERN EUROPE-EU","ITALY","STANSTED","ALGHERO (FERTILIA)",7113,7113,0
2020,"WESTERN EUROPE-EU","ITALY","STANSTED","ANCONA",30056,30056,0
2020,"WESTERN EUROPE-EU","ITALY","STANSTED","BARI (PALESE)",38871,38871,0
2020,"WESTERN EUROPE-EU","ITALY","STANSTED","BERGAMO",125102,125093,9
2020,"WESTERN EUROPE-EU","ITALY","STANSTED","BOLOGNA",58842,58842,0
2020,"WESTERN EUROPE-EU","ITALY","STANSTED","BRINDISI",28799,28799,0
2020,"WESTERN EUROPE-EU","ITALY","STANSTED","CAGLIARI (ELMAS)",40184,40184,0
2020,"WESTERN EUROPE-EU","ITALY","STANSTED","CATANIA (FONTANAROSSA)",0,0,0
2020,"WESTERN EUROPE-EU","ITALY","STANSTED","COMISO",0,0,0
2020,"WESTERN EUROPE-EU","ITALY","STANSTED","FLORENCE",0,0,0
2020,"WESTERN EUROPE-EU","ITALY","STANSTED","GENOA",22141,22141,0
2020,"WESTERN EUROPE-EU","ITALY","STANSTED","LAMETIA-TERME",19601,19601,0
2020,"WESTERN EUROPE-EU","ITALY","STANSTED","MILAN (MALPENSA)",73680,73680,0
2020,"WESTERN EUROPE-EU","ITALY","STANSTED","NAPLES",69535,69535,0
2020,"WESTERN EUROPE-EU","ITALY","STANSTED","PALERMO",42308,42308,0
2020,"WESTERN EUROPE-EU","ITALY","STANSTED","PERUGIA",27189,27189,0
2020,"WESTERN EUROPE-EU","ITALY","STANSTED","PESCARA",29638,29638,0
2020,"WESTERN EUROPE-EU","ITALY","STANSTED","PISA",82582,82582,0
2020,"WESTERN EUROPE-EU","ITALY","STANSTED","RIMINI",5152,5152,0
2020,"WESTERN EUROPE-EU","ITALY","STANSTED","ROME (CIAMPINO)",155550,155550,0
2020,"WESTERN EUROPE-EU","ITALY","STANSTED","ROME (FIUMICINO)",75,0,75
2020,"WESTERN EUROPE-EU","ITALY","STANSTED","TREVISO",243,243,0
2020,"WESTERN EUROPE-EU","ITALY","STANSTED","TRIESTE (RONCHI DEI LEGIONARI)",19416,19416,0
2020,"WESTERN EUROPE-EU","ITALY","STANSTED","TURIN",42408,39008,3400
2020,"WESTERN EUROPE-EU","ITALY","STANSTED","VENICE",84483,84483,0
2020,"WESTERN EUROPE-EU","ITALY","STANSTED","VERONA VILLAFRANCA",17463,16849,614
2020,"WESTERN EUROPE-EU","LUXEMBOURG","GATWICK","LUXEMBOURG",13438,13438,0
2020,"WESTERN EUROPE-EU","LUXEMBOURG","HEATHROW","LUXEMBOURG",37108,37108,0
2020,"WESTERN EUROPE-EU","LUXEMBOURG","LONDON CITY","LUXEMBOURG",31565,31565,0
2020,"WESTERN EUROPE-EU","LUXEMBOURG","LUTON","LUXEMBOURG",64,64,0
2020,"WESTERN EUROPE-EU","LUXEMBOURG","SOUTHEND","LUXEMBOURG",0,0,0
2020,"WESTERN EUROPE-EU","LUXEMBOURG","STANSTED","LUXEMBOURG",29111,28988,123
2020,"WESTERN EUROPE-EU","MALTA","GATWICK","MALTA",68649,68649,0
2020,"WESTERN EUROPE-EU","MALTA","HEATHROW","MALTA",61262,61262,0
2020,"WESTERN EUROPE-EU","MALTA","LUTON","MALTA",25560,25560,0
2020,"WESTERN EUROPE-EU","MALTA","SOUTHEND","MALTA",6329,6329,0
2020,"WESTERN EUROPE-EU","MALTA","STANSTED","MALTA",25337,25285,52
2020,"WESTERN EUROPE-EU","NETHERLANDS","GATWICK","AMSTERDAM",262583,262486,97
2020,"WESTERN EUROPE-EU","NETHERLANDS","HEATHROW","AMSTERDAM",525790,525790,0
2020,"WESTERN EUROPE-EU","NETHERLANDS","LONDON CITY","AMSTERDAM",134649,134579,70
2020,"WESTERN EUROPE-EU","NETHERLANDS","LONDON CITY","ROTTERDAM",27458,27458,0
2020,"WESTERN EUROPE-EU","NETHERLANDS","LUTON","AMSTERDAM",201383,201383,0
2020,"WESTERN EUROPE-EU","NETHERLANDS","LUTON","EINDHOVEN",0,0,0
2020,"WESTERN EUROPE-EU","NETHERLANDS","LUTON","ROTTERDAM",0,0,0
2020,"WESTERN EUROPE-EU","NETHERLANDS","SOUTHEND","AMSTERDAM",35250,35250,0
2020,"WESTERN EUROPE-EU","NETHERLANDS","SOUTHEND","GRONINGEN",3616,3616,0
2020,"WESTERN EUROPE-EU","NETHERLANDS","STANSTED","AMSTERDAM",85838,85838,0
2020,"WESTERN EUROPE-EU","NETHERLANDS","STANSTED","EINDHOVEN",75263,75263,0
2020,"WESTERN EUROPE-EU","NETHERLANDS","STANSTED","ROTTERDAM",0,0,0
2020,"WESTERN EUROPE-EU","PORTUGAL(EXCLUDING MADEIRA)","GATWICK","AZORES PONTA DELGADA",281,0,281
2020,"WESTERN EUROPE-EU","PORTUGAL(EXCLUDING MADEIRA)","GATWICK","FARO",122008,120802,1206
2020,"WESTERN EUROPE-EU","PORTUGAL(EXCLUDING MADEIRA)","GATWICK","LISBON",89239,89189,50
2020,"WESTERN EUROPE-EU","PORTUGAL(EXCLUDING MADEIRA)","GATWICK","OPORTO (PORTUGAL)",78794,78794,0
2020,"WESTERN EUROPE-EU","PORTUGAL(EXCLUDING MADEIRA)","HEATHROW","FARO",58327,57959,368
2020,"WESTERN EUROPE-EU","PORTUGAL(EXCLUDING MADEIRA)","HEATHROW","LISBON",300400,300106,294
2020,"WESTERN EUROPE-EU","PORTUGAL(EXCLUDING MADEIRA)","HEATHROW","OPORTO (PORTUGAL)",22425,22425,0
2020,"WESTERN EUROPE-EU","PORTUGAL(EXCLUDING MADEIRA)","LONDON CITY","FARO",1299,1299,0
2020,"WESTERN EUROPE-EU","PORTUGAL(EXCLUDING MADEIRA)","LONDON CITY","LISBON",0,0,0
2020,"WESTERN EUROPE-EU","PORTUGAL(EXCLUDING MADEIRA)","LONDON CITY","OPORTO (PORTUGAL)",0,0,0
2020,"WESTERN EUROPE-EU","PORTUGAL(EXCLUDING MADEIRA)","LUTON","FARO",75315,75315,0
2020,"WESTERN EUROPE-EU","PORTUGAL(EXCLUDING MADEIRA)","LUTON","LISBON",137139,137139,0
2020,"WESTERN EUROPE-EU","PORTUGAL(EXCLUDING MADEIRA)","LUTON","OPORTO (PORTUGAL)",36475,36475,0
2020,"WESTERN EUROPE-EU","PORTUGAL(EXCLUDING MADEIRA)","SOUTHEND","FARO",16717,16717,0
2020,"WESTERN EUROPE-EU","PORTUGAL(EXCLUDING MADEIRA)","SOUTHEND","OPORTO (PORTUGAL)",0,0,0
2020,"WESTERN EUROPE-EU","PORTUGAL(EXCLUDING MADEIRA)","STANSTED","AZORES LAJES TERCEIRA ISLAND",317,317,0
2020,"WESTERN EUROPE-EU","PORTUGAL(EXCLUDING MADEIRA)","STANSTED","AZORES PONTA DELGADA",4961,4961,0
2020,"WESTERN EUROPE-EU","PORTUGAL(EXCLUDING MADEIRA)","STANSTED","FARO",83054,82978,76
2020,"WESTERN EUROPE-EU","PORTUGAL(EXCLUDING MADEIRA)","STANSTED","LISBON",178049,177369,680
2020,"WESTERN EUROPE-EU","PORTUGAL(EXCLUDING MADEIRA)","STANSTED","OPORTO (PORTUGAL)",118645,118458,187
2020,"WESTERN EUROPE-EU","PORTUGAL(MADEIRA)","GATWICK","FUNCHAL",85425,79778,5647
2020,"WESTERN EUROPE-EU","PORTUGAL(MADEIRA)","GATWICK","PORTO SANTO",0,0,0
2020,"WESTERN EUROPE-EU","PORTUGAL(MADEIRA)","HEATHROW","FUNCHAL",21497,21497,0
2020,"WESTERN EUROPE-EU","PORTUGAL(MADEIRA)","LUTON","FUNCHAL",538,538,0
2020,"WESTERN EUROPE-EU","PORTUGAL(MADEIRA)","STANSTED","FUNCHAL",14057,14057,0
2020,"WESTERN EUROPE-EU","SLOVENIA","GATWICK","LJUBLJANA",13171,13107,64
2020,"WESTERN EUROPE-EU","SLOVENIA","HEATHROW","LJUBLJANA",0,0,0
2020,"WESTERN EUROPE-EU","SLOVENIA","LUTON","LJUBLJANA",133,133,0
2020,"WESTERN EUROPE-EU","SLOVENIA","SOUTHEND","LJUBLJANA",72,72,0
2020,"WESTERN EUROPE-EU","SLOVENIA","STANSTED","LJUBLJANA",15997,15997,0
2020,"WESTERN EUROPE-EU","SPAIN","GATWICK","ALICANTE",165617,165035,582
2020,"WESTERN EUROPE-EU","SPAIN","GATWICK","ALMERIA",19441,19441,0
2020,"WESTERN EUROPE-EU","SPAIN","GATWICK","ASTURIAS",10822,10822,0
2020,"WESTERN EUROPE-EU","SPAIN","GATWICK","BARCELONA",284627,284627,0
2020,"WESTERN EUROPE-EU","SPAIN","GATWICK","BILBAO",44560,44560,0
2020,"WESTERN EUROPE-EU","SPAIN","GATWICK","GIRONA",0,0,0
2020,"WESTERN EUROPE-EU","SPAIN","GATWICK","GRANADA",5130,5130,0
2020,"WESTERN EUROPE-EU","SPAIN","GATWICK","IBIZA",8608,6801,1807
2020,"WESTERN EUROPE-EU","SPAIN","GATWICK","JEREZ",0,0,0
2020,"WESTERN EUROPE-EU","SPAIN","GATWICK","LIEIDA",0,0,0
2020,"WESTERN EUROPE-EU","SPAIN","GATWICK","MADRID",212507,212335,172
2020,"WESTERN EUROPE-EU","SPAIN","GATWICK","MAHON",15773,15478,295
2020,"WESTERN EUROPE-EU","SPAIN","GATWICK","MALAGA",179210,175242,3968
2020,"WESTERN EUROPE-EU","SPAIN","GATWICK","MURCIA INTERNATIONAL",32354,32354,0
2020,"WESTERN EUROPE-EU","SPAIN","GATWICK","MURCIA SAN JAVIER",0,0,0
2020,"WESTERN EUROPE-EU","SPAIN","GATWICK","PALMA DE MALLORCA",67710,65321,2389
2020,"WESTERN EUROPE-EU","SPAIN","GATWICK","REUS",431,0,431
2020,"WESTERN EUROPE-EU","SPAIN","GATWICK","SANTIAGO DE COMPOSTELA (SPAIN)",0,0,0
2020,"WESTERN EUROPE-EU","SPAIN","GATWICK","SEVILLE",49908,49733,175
2020,"WESTERN EUROPE-EU","SPAIN","GATWICK","VALENCIA",53951,53951,0
2020,"WESTERN EUROPE-EU","SPAIN","GATWICK","VITORIA",0,0,0
2020,"WESTERN EUROPE-EU","SPAIN","HEATHROW","A CORUNA",20910,20910,0
2020,"WESTERN EUROPE-EU","SPAIN","HEATHROW","ALICANTE",22027,22027,0
2020,"WESTERN EUROPE-EU","SPAIN","HEATHROW","BARCELONA",188738,188738,0
2020,"WESTERN EUROPE-EU","SPAIN","HEATHROW","BILBAO",3318,3318,0
2020,"WESTERN EUROPE-EU","SPAIN","HEATHROW","IBIZA",29729,29729,0
2020,"WESTERN EUROPE-EU","SPAIN","HEATHROW","MADRID",454761,454499,262
2020,"WESTERN EUROPE-EU","SPAIN","HEATHROW","MAHON",4125,4125,0
2020,"WESTERN EUROPE-EU","SPAIN","HEATHROW","MALAGA",63101,63084,17
2020,"WESTERN EUROPE-EU","SPAIN","HEATHROW","PALMA DE MALLORCA",32942,32587,355
2020,"WESTERN EUROPE-EU","SPAIN","HEATHROW","SANTIAGO DE COMPOSTELA (SPAIN)",0,0,0
2020,"WESTERN EUROPE-EU","SPAIN","HEATHROW","SEVILLE",4709,4592,117
2020,"WESTERN EUROPE-EU","SPAIN","HEATHROW","VALENCIA",25624,25624,0
2020,"WESTERN EUROPE-EU","SPAIN","LONDON CITY","GRANADA",0,0,0
2020,"WESTERN EUROPE-EU","SPAIN","LONDON CITY","IBIZA",16090,16090,0
2020,"WESTERN EUROPE-EU","SPAIN","LONDON CITY","MAHON",58,58,0
2020,"WESTERN EUROPE-EU","SPAIN","LONDON CITY","MALAGA",6841,6841,0
2020,"WESTERN EUROPE-EU","SPAIN","LONDON CITY","PALMA DE MALLORCA",6307,6307,0
2020,"WESTERN EUROPE-EU","SPAIN","LUTON","ALICANTE",68457,68457,0
2020,"WESTERN EUROPE-EU","SPAIN","LUTON","BARCELONA",102065,102065,0
2020,"WESTERN EUROPE-EU","SPAIN","LUTON","CASTELLON COSTA AZAHAR",7479,7479,0
2020,"WESTERN EUROPE-EU","SPAIN","LUTON","CASTELLON DE LA PLANA AIRPORT",333,333,0
2020,"WESTERN EUROPE-EU","SPAIN","LUTON","GIRONA",284,284,0
2020,"WESTERN EUROPE-EU","SPAIN","LUTON","IBIZA",4029,4029,0
2020,"WESTERN EUROPE-EU","SPAIN","LUTON","MADRID",20051,20051,0
2020,"WESTERN EUROPE-EU","SPAIN","LUTON","MAHON",5356,5356,0
2020,"WESTERN EUROPE-EU","SPAIN","LUTON","MALAGA",98900,98193,707
2020,"WESTERN EUROPE-EU","SPAIN","LUTON","MURCIA INTERNATIONAL",725,725,0
2020,"WESTERN EUROPE-EU","SPAIN","LUTON","MURCIA SAN JAVIER",0,0,0
2020,"WESTERN EUROPE-EU","SPAIN","LUTON","PALMA DE MALLORCA",33174,33174,0
2020,"WESTERN EUROPE-EU","SPAIN","LUTON","REUS",787,787,0
2020,"WESTERN EUROPE-EU","SPAIN","LUTON","SEVILLE",21601,21601,0
2020,"WESTERN EUROPE-EU","SPAIN","LUTON","VALENCIA",7378,7378,0
2020,"WESTERN EUROPE-EU","SPAIN","LUTON","VITORIA",0,0,0
2020,"WESTERN EUROPE-EU","SPAIN","SOUTHEND","ALICANTE",43096,43096,0
2020,"WESTERN EUROPE-EU","SPAIN","SOUTHEND","BARCELONA",5434,5434,0
2020,"WESTERN EUROPE-EU","SPAIN","SOUTHEND","BILBAO",11397,11397,0
2020,"WESTERN EUROPE-EU","SPAIN","SOUTHEND","GIRONA",212,212,0
2020,"WESTERN EUROPE-EU","SPAIN","SOUTHEND","IBIZA",462,462,0
2020,"WESTERN EUROPE-EU","SPAIN","SOUTHEND","MAHON",449,449,0
2020,"WESTERN EUROPE-EU","SPAIN","SOUTHEND","MALAGA",38006,38006,0
2020,"WESTERN EUROPE-EU","SPAIN","SOUTHEND","MURCIA INTERNATIONAL",6717,6717,0
2020,"WESTERN EUROPE-EU","SPAIN","SOUTHEND","MURCIA SAN JAVIER",0,0,0
2020,"WESTERN EUROPE-EU","SPAIN","SOUTHEND","PALMA DE MALLORCA",7574,7574,0
2020,"WESTERN EUROPE-EU","SPAIN","SOUTHEND","REUS",990,990,0
2020,"WESTERN EUROPE-EU","SPAIN","STANSTED","ALICANTE",86984,86975,9
2020,"WESTERN EUROPE-EU","SPAIN","STANSTED","ALMERIA",4681,4681,0
2020,"WESTERN EUROPE-EU","SPAIN","STANSTED","BARCELONA",138523,138523,0
2020,"WESTERN EUROPE-EU","SPAIN","STANSTED","BILBAO",6075,5890,185
2020,"WESTERN EUROPE-EU","SPAIN","STANSTED","CASTELLON COSTA AZAHAR",8800,8800,0
2020,"WESTERN EUROPE-EU","SPAIN","STANSTED","CASTELLON DE LA PLANA AIRPORT",0,0,0
2020,"WESTERN EUROPE-EU","SPAIN","STANSTED","GIRONA",4279,4279,0
2020,"WESTERN EUROPE-EU","SPAIN","STANSTED","IBIZA",17448,17448,0
2020,"WESTERN EUROPE-EU","SPAIN","STANSTED","JEREZ",12051,12051,0
2020,"WESTERN EUROPE-EU","SPAIN","STANSTED","LIEIDA",0,0,0
2020,"WESTERN EUROPE-EU","SPAIN","STANSTED","MADRID",131922,131704,218
2020,"WESTERN EUROPE-EU","SPAIN","STANSTED","MAHON",1668,1668,0
2020,"WESTERN EUROPE-EU","SPAIN","STANSTED","MALAGA",108069,107920,149
2020,"WESTERN EUROPE-EU","SPAIN","STANSTED","MURCIA INTERNATIONAL",27148,27148,0
2020,"WESTERN EUROPE-EU","SPAIN","STANSTED","MURCIA SAN JAVIER",0,0,0
2020,"WESTERN EUROPE-EU","SPAIN","STANSTED","PALMA DE MALLORCA",50753,50699,54
2020,"WESTERN EUROPE-EU","SPAIN","STANSTED","REUS",8195,8195,0
2020,"WESTERN EUROPE-EU","SPAIN","STANSTED","SANTANDER",27088,27088,0
2020,"WESTERN EUROPE-EU","SPAIN","STANSTED","SANTIAGO DE COMPOSTELA (SPAIN)",25088,25012,76
2020,"WESTERN EUROPE-EU","SPAIN","STANSTED","SEVILLE",41717,41717,0
2020,"WESTERN EUROPE-EU","SPAIN","STANSTED","VALENCIA",49226,49140,86
2020,"WESTERN EUROPE-EU","SPAIN","STANSTED","VIGO",0,0,0
2020,"WESTERN EUROPE-EU","SPAIN","STANSTED","ZARAGOZA",25800,25800,0
2020,"WESTERN EUROPE-EU","SPAIN(CANARY ISLANDS)","GATWICK","ARRECIFE",90702,75835,14867
2020,"WESTERN EUROPE-EU","SPAIN(CANARY ISLANDS)","GATWICK","FUERTEVENTURA",47519,36951,10568
2020,"WESTERN EUROPE-EU","SPAIN(CANARY ISLANDS)","GATWICK","LAS PALMAS",67548,50833,16715
2020,"WESTERN EUROPE-EU","SPAIN(CANARY ISLANDS)","GATWICK","SANTA CRUZ DE LA PALMA",11241,7354,3887
2020,"WESTERN EUROPE-EU","SPAIN(CANARY ISLANDS)","GATWICK","TENERIFE (NORTE LOS RODEOS)",0,0,0
2020,"WESTERN EUROPE-EU","SPAIN(CANARY ISLANDS)","GATWICK","TENERIFE (SURREINA SOFIA)",173219,146771,26448
2020,"WESTERN EUROPE-EU","SPAIN(CANARY ISLANDS)","HEATHROW","ARRECIFE",5568,5568,0
2020,"WESTERN EUROPE-EU","SPAIN(CANARY ISLANDS)","HEATHROW","LAS PALMAS",4249,3380,869
2020,"WESTERN EUROPE-EU","SPAIN(CANARY ISLANDS)","HEATHROW","TENERIFE (SURREINA SOFIA)",20453,20453,0
2020,"WESTERN EUROPE-EU","SPAIN(CANARY ISLANDS)","LUTON","ARRECIFE",25182,23180,2002
2020,"WESTERN EUROPE-EU","SPAIN(CANARY ISLANDS)","LUTON","FUERTEVENTURA",7570,7570,0
2020,"WESTERN EUROPE-EU","SPAIN(CANARY ISLANDS)","LUTON","LAS PALMAS",12464,12271,193
2020,"WESTERN EUROPE-EU","SPAIN(CANARY ISLANDS)","LUTON","TENERIFE (SURREINA SOFIA)",62768,58618,4150
2020,"WESTERN EUROPE-EU","SPAIN(CANARY ISLANDS)","SOUTHEND","ARRECIFE",7300,7300,0
2020,"WESTERN EUROPE-EU","SPAIN(CANARY ISLANDS)","SOUTHEND","TENERIFE (SURREINA SOFIA)",6460,6460,0
2020,"WESTERN EUROPE-EU","SPAIN(CANARY ISLANDS)","STANSTED","ARRECIFE",68767,67090,1677
2020,"WESTERN EUROPE-EU","SPAIN(CANARY ISLANDS)","STANSTED","FUERTEVENTURA",48559,48559,0
2020,"WESTERN EUROPE-EU","SPAIN(CANARY ISLANDS)","STANSTED","LAS PALMAS",57111,52642,4469
2020,"WESTERN EUROPE-EU","SPAIN(CANARY ISLANDS)","STANSTED","TENERIFE (SURREINA SOFIA)",105751,99417,6334
2020,"WESTERN EUROPE-EU","SWEDEN","GATWICK","GOTEBORG (LANDVETTER)",24791,24791,0
2020,"WESTERN EUROPE-EU","SWEDEN","GATWICK","MALMO",0,0,0
2020,"WESTERN EUROPE-EU","SWEDEN","GATWICK","OSTERSUND / FROSON",5744,5744,0
2020,"WESTERN EUROPE-EU","SWEDEN","GATWICK","PAJALA YLLAS",0,0,0
2020,"WESTERN EUROPE-EU","SWEDEN","GATWICK","STOCKHOLM (ARLANDA)",86018,85933,85
2020,"WESTERN EUROPE-EU","SWEDEN","HEATHROW","GOTEBORG (LANDVETTER)",63840,63840,0
2020,"WESTERN EUROPE-EU","SWEDEN","HEATHROW","KIRUNA",1248,0,1248
2020,"WESTERN EUROPE-EU","SWEDEN","HEATHROW","SCANDINAVIAN MOUNTAINS AIRPORT",553,553,0
2020,"WESTERN EUROPE-EU","SWEDEN","HEATHROW","STOCKHOLM (ARLANDA)",261011,261011,0
2020,"WESTERN EUROPE-EU","SWEDEN","LUTON","HALMSTAD",0,0,0
2020,"WESTERN EUROPE-EU","SWEDEN","LUTON","MALMO",0,0,0
2020,"WESTERN EUROPE-EU","SWEDEN","LUTON","STOCKHOLM (ARLANDA)",0,0,0
2020,"WESTERN EUROPE-EU","SWEDEN","STANSTED","GOTEBORG (LANDVETTER)",46001,46001,0
2020,"WESTERN EUROPE-EU","SWEDEN","STANSTED","HALMSTAD",346,0,346
2020,"WESTERN EUROPE-EU","SWEDEN","STANSTED","STOCKHOLM (ARLANDA)",0,0,0
2020,"WESTERN EUROPE-EU","SWEDEN","STANSTED","STOCKHOLM (SKAVSTA)",48158,48158,0
2020,"WESTERN EUROPE-EU","SWEDEN","STANSTED","VASTERAS",20031,20031,0
2020,"WESTERN EUROPE-OTHER","BOSNIA-HERZEGOVINA","HEATHROW","SARAJEVO",193,0,193
2020,"WESTERN EUROPE-OTHER","BOSNIA-HERZEGOVINA","LUTON","SARAJEVO",1097,1097,0
2020,"WESTERN EUROPE-OTHER","ICELAND","GATWICK","KEFLAVIK",55532,49563,5969
2020,"WESTERN EUROPE-OTHER","ICELAND","HEATHROW","KEFLAVIK",87484,87458,26
2020,"WESTERN EUROPE-OTHER","ICELAND","HEATHROW","REYKJAVIK",20,0,20
2020,"WESTERN EUROPE-OTHER","ICELAND","LONDON CITY","KEFLAVIK",0,0,0
2020,"WESTERN EUROPE-OTHER","ICELAND","LUTON","KEFLAVIK",81270,81270,0
2020,"WESTERN EUROPE-OTHER","ICELAND","SOUTHEND","AKUREYRI",0,0,0
2020,"WESTERN EUROPE-OTHER","ICELAND","STANSTED","KEFLAVIK",189,0,189
2020,"WESTERN EUROPE-OTHER","KOSOVO","GATWICK","PRISTINA",110,0,110
2020,"WESTERN EUROPE-OTHER","KOSOVO","HEATHROW","PRISTINA",2139,2139,0
2020,"WESTERN EUROPE-OTHER","KOSOVO","LUTON","PRISTINA",36685,36685,0
2020,"WESTERN EUROPE-OTHER","KOSOVO","STANSTED","PRISTINA",112,0,112
2020,"WESTERN EUROPE-OTHER","MACEDONIA","LUTON","OHRID",8821,8821,0
2020,"WESTERN EUROPE-OTHER","MACEDONIA","LUTON","SKOPJE",18765,18575,190
2020,"WESTERN EUROPE-OTHER","NORWAY","GATWICK","BERGEN",35853,34581,1272
2020,"WESTERN EUROPE-OTHER","NORWAY","GATWICK","MOLDE",0,0,0
2020,"WESTERN EUROPE-OTHER","NORWAY","GATWICK","OSLO (GARDERMOEN)",92689,92689,0
2020,"WESTERN EUROPE-OTHER","NORWAY","GATWICK","STAVANGER",13709,13709,0
2020,"WESTERN EUROPE-OTHER","NORWAY","GATWICK","TROMSOE",14335,14335,0
2020,"WESTERN EUROPE-OTHER","NORWAY","GATWICK","TRONDHEIM (VAERNES)",8040,8040,0
2020,"WESTERN EUROPE-OTHER","NORWAY","HEATHROW","OSLO (GARDERMOEN)",161096,161096,0
2020,"WESTERN EUROPE-OTHER","NORWAY","HEATHROW","STAVANGER",11311,11311,0
2020,"WESTERN EUROPE-OTHER","NORWAY","LUTON","BERGEN",10381,10381,0
2020,"WESTERN EUROPE-OTHER","NORWAY","LUTON","OSLO (GARDERMOEN)",15290,15290,0
2020,"WESTERN EUROPE-OTHER","NORWAY","LUTON","STAVANGER",5177,5177,0
2020,"WESTERN EUROPE-OTHER","NORWAY","LUTON","TROMSOE",7962,7962,0
2020,"WESTERN EUROPE-OTHER","NORWAY","SOUTHEND","BERGEN",47,47,0
2020,"WESTERN EUROPE-OTHER","NORWAY","STANSTED","KRISTIANSAND (KJEVIK)",3579,3579,0
2020,"WESTERN EUROPE-OTHER","NORWAY","STANSTED","KRISTIANSUND (KUERNBERGET)",0,0,0
2020,"WESTERN EUROPE-OTHER","NORWAY","STANSTED","OSLO (GARDERMOEN)",74091,74091,0
2020,"WESTERN EUROPE-OTHER","NORWAY","STANSTED","SANDEFJORD(TORP)",11786,11786,0
2020,"WESTERN EUROPE-OTHER","REPUBLIC OF MONTENEGRO","GATWICK","PODGORICA",111,0,111
2020,"WESTERN EUROPE-OTHER","REPUBLIC OF MONTENEGRO","GATWICK","TIVAT",3479,3479,0
2020,"WESTERN EUROPE-OTHER","REPUBLIC OF MONTENEGRO","STANSTED","PODGORICA",12893,12893,0
2020,"WESTERN EUROPE-OTHER","REPUBLIC OF SERBIA","HEATHROW","BELGRADE",27808,27515,293
2020,"WESTERN EUROPE-OTHER","REPUBLIC OF SERBIA","LUTON","BELGRADE",29558,29558,0
2020,"WESTERN EUROPE-OTHER","REPUBLIC OF SERBIA","STANSTED","BELGRADE",0,0,0
2020,"WESTERN EUROPE-OTHER","SWITZERLAND","GATWICK","BALE MULHOUSE",67026,67026,0
2020,"WESTERN EUROPE-OTHER","SWITZERLAND","GATWICK","GENEVA",306483,302615,3868
2020,"WESTERN EUROPE-OTHER","SWITZERLAND","GATWICK","ZURICH",35290,35290,0
2020,"WESTERN EUROPE-OTHER","SWITZERLAND","HEATHROW","BALE MULHOUSE",56410,56410,0
2020,"WESTERN EUROPE-OTHER","SWITZERLAND","HEATHROW","GENEVA",338486,338486,0
2020,"WESTERN EUROPE-OTHER","SWITZERLAND","HEATHROW","SION",551,551,0
2020,"WESTERN EUROPE-OTHER","SWITZERLAND","HEATHROW","ZURICH",345888,345007,881
2020,"WESTERN EUROPE-OTHER","SWITZERLAND","LONDON CITY","ALTENRHEIN",62,0,62
2020,"WESTERN EUROPE-OTHER","SWITZERLAND","LONDON CITY","GENEVA",35475,35450,25
2020,"WESTERN EUROPE-OTHER","SWITZERLAND","LONDON CITY","SION",93,93,0
2020,"WESTERN EUROPE-OTHER","SWITZERLAND","LONDON CITY","ZURICH",76513,76513,0
2020,"WESTERN EUROPE-OTHER","SWITZERLAND","LUTON","BALE MULHOUSE",11225,11225,0
2020,"WESTERN EUROPE-OTHER","SWITZERLAND","LUTON","GENEVA",119124,119124,0
2020,"WESTERN EUROPE-OTHER","SWITZERLAND","LUTON","ZURICH",33236,33236,0
2020,"WESTERN EUROPE-OTHER","SWITZERLAND","SOUTHEND","GENEVA",17027,17027,0
2020,"WESTERN EUROPE-OTHER","SWITZERLAND","SOUTHEND","ZURICH",0,0,0
2020,"WESTERN EUROPE-OTHER","SWITZERLAND","STANSTED","BALE MULHOUSE",189,0,189
2020,"WESTERN EUROPE-OTHER","SWITZERLAND","STANSTED","GENEVA",59857,59857,0
2020,"WESTERN EUROPE-OTHER","SWITZERLAND","STANSTED","ZURICH",204,120,84
2020,"WESTERN EUROPE-OTHER","TURKEY","GATWICK","ANKARA (ESENBOGA)",2848,2848,0
2020,"WESTERN EUROPE-OTHER","TURKEY","GATWICK","ANTALYA",105185,81212,23973
2020,"WESTERN EUROPE-OTHER","TURKEY","GATWICK","BODRUM (MILAS)",33872,30375,3497
2020,"WESTERN EUROPE-OTHER","TURKEY","GATWICK","DALAMAN",111489,80355,31134
2020,"WESTERN EUROPE-OTHER","TURKEY","GATWICK","ISTANBUL",65786,65449,337
2020,"WESTERN EUROPE-OTHER","TURKEY","GATWICK","ISTANBUL (SABIHA GOKCEN)",12176,12176,0
2020,"WESTERN EUROPE-OTHER","TURKEY","GATWICK","ISTANBUL ATATURK",0,0,0
2020,"WESTERN EUROPE-OTHER","TURKEY","GATWICK","IZMIR (ADNAN MENDERES)",14146,10823,3323
2020,"WESTERN EUROPE-OTHER","TURKEY","HEATHROW","ANKARA (ESENBOGA)",679,679,0
2020,"WESTERN EUROPE-OTHER","TURKEY","HEATHROW","ANTALYA",0,0,0
2020,"WESTERN EUROPE-OTHER","TURKEY","HEATHROW","BODRUM (MILAS)",3954,3954,0
2020,"WESTERN EUROPE-OTHER","TURKEY","HEATHROW","DALAMAN",25165,25165,0
2020,"WESTERN EUROPE-OTHER","TURKEY","HEATHROW","ISTANBUL",420854,420780,74
2020,"WESTERN EUROPE-OTHER","TURKEY","HEATHROW","ISTANBUL ATATURK",0,0,0
2020,"WESTERN EUROPE-OTHER","TURKEY","HEATHROW","IZMIR (ADNAN MENDERES)",0,0,0
2020,"WESTERN EUROPE-OTHER","TURKEY","LUTON","ANKARA (ESENBOGA)",3277,3277,0
2020,"WESTERN EUROPE-OTHER","TURKEY","LUTON","ANTALYA",10471,10471,0
2020,"WESTERN EUROPE-OTHER","TURKEY","LUTON","BODRUM (MILAS)",7137,7137,0
2020,"WESTERN EUROPE-OTHER","TURKEY","LUTON","DALAMAN",7008,7008,0
2020,"WESTERN EUROPE-OTHER","TURKEY","LUTON","GAZIANTEP",3349,3349,0
2020,"WESTERN EUROPE-OTHER","TURKEY","LUTON","ISTANBUL ATATURK",0,0,0
2020,"WESTERN EUROPE-OTHER","TURKEY","LUTON","IZMIR (ADNAN MENDERES)",5727,5727,0
2020,"WESTERN EUROPE-OTHER","TURKEY","STANSTED","ADANA",189,189,0
2020,"WESTERN EUROPE-OTHER","TURKEY","STANSTED","ANKARA (ESENBOGA)",773,600,173
2020,"WESTERN EUROPE-OTHER","TURKEY","STANSTED","ANTALYA",69981,62838,7143
2020,"WESTERN EUROPE-OTHER","TURKEY","STANSTED","BODRUM (MILAS)",11016,11016,0
2020,"WESTERN EUROPE-OTHER","TURKEY","STANSTED","DALAMAN",38948,33015,5933
2020,"WESTERN EUROPE-OTHER","TURKEY","STANSTED","GAZIANTEP",1475,515,960
2020,"WESTERN EUROPE-OTHER","TURKEY","STANSTED","ISTANBUL",1596,1247,349
2020,"WESTERN EUROPE-OTHER","TURKEY","STANSTED","ISTANBUL (SABIHA GOKCEN)",291148,290907,241
2020,"WESTERN EUROPE-OTHER","TURKEY","STANSTED","IZMIR (ADNAN MENDERES)",41683,41206,477
2020,"WESTERN EUROPE-OTHER","TURKEY","STANSTED","KAHRAMANMARAS",116,0,116
2020,"WESTERN EUROPE-OTHER","TURKEY","STANSTED","KAYSERI  ERKILET",160,0,160
2020,"EASTERN EUROPE-EU","BULGARIA","GATWICK","BURGAS",0,0,0
2020,"EASTERN EUROPE-EU","BULGARIA","GATWICK","SOFIA",91313,83881,7432
2020,"EASTERN EUROPE-EU","BULGARIA","GATWICK","VARNA",3715,3715,0
2020,"EASTERN EUROPE-EU","BULGARIA","HEATHROW","SOFIA",79023,78616,407
2020,"EASTERN EUROPE-EU","BULGARIA","LUTON","BURGAS",46319,46319,0
2020,"EASTERN EUROPE-EU","BULGARIA","LUTON","SOFIA",206346,206129,217
2020,"EASTERN EUROPE-EU","BULGARIA","LUTON","VARNA",73016,73016,0
2020,"EASTERN EUROPE-EU","BULGARIA","SOUTHEND","SOFIA",5831,5831,0
2020,"EASTERN EUROPE-EU","BULGARIA","STANSTED","BURGAS",0,0,0
2020,"EASTERN EUROPE-EU","BULGARIA","STANSTED","PLOVDIV",27925,27925,0
2020,"EASTERN EUROPE-EU","BULGARIA","STANSTED","SOFIA",125347,125168,179
2020,"EASTERN EUROPE-EU","CZECH REPUBLIC","GATWICK","PRAGUE",45131,45131,0
2020,"EASTERN EUROPE-EU","CZECH REPUBLIC","HEATHROW","PRAGUE",112458,112458,0
2020,"EASTERN EUROPE-EU","CZECH REPUBLIC","LONDON CITY","PRAGUE",7216,7216,0
2020,"EASTERN EUROPE-EU","CZECH REPUBLIC","LUTON","PRAGUE",33195,33195,0
2020,"EASTERN EUROPE-EU","CZECH REPUBLIC","SOUTHEND","PRAGUE",5576,5576,0
2020,"EASTERN EUROPE-EU","CZECH REPUBLIC","STANSTED","BRNO (TURANY)",27679,27679,0
2020,"EASTERN EUROPE-EU","CZECH REPUBLIC","STANSTED","OSTRAVA",16261,16261,0
2020,"EASTERN EUROPE-EU","CZECH REPUBLIC","STANSTED","PARDUBICE",0,0,0
2020,"EASTERN EUROPE-EU","CZECH REPUBLIC","STANSTED","PRAGUE",108097,108097,0
2020,"EASTERN EUROPE-EU","ESTONIA","GATWICK","TALLIN",24950,24817,133
2020,"EASTERN EUROPE-EU","ESTONIA","HEATHROW","TALLIN",245,0,245
2020,"EASTERN EUROPE-EU","ESTONIA","LUTON","TALLIN",0,0,0
2020,"EASTERN EUROPE-EU","ESTONIA","STANSTED","TALLIN",28389,28389,0
2020,"EASTERN EUROPE-EU","HUNGARY","GATWICK","BUDAPEST",93157,93085,72
2020,"EASTERN EUROPE-EU","HUNGARY","HEATHROW","BUDAPEST",61585,61585,0
2020,"EASTERN EUROPE-EU","HUNGARY","LONDON CITY","BUDAPEST",8434,8434,0
2020,"EASTERN EUROPE-EU","HUNGARY","LUTON","BUDAPEST",161935,161762,173
2020,"EASTERN EUROPE-EU","HUNGARY","LUTON","DEBRECEN",43232,43232,0
2020,"EASTERN EUROPE-EU","HUNGARY","SOUTHEND","BUDAPEST",5448,5448,0
2020,"EASTERN EUROPE-EU","HUNGARY","STANSTED","BUDAPEST",124845,124845,0
2020,"EASTERN EUROPE-EU","LATVIA","GATWICK","RIGA",45913,45913,0
2020,"EASTERN EUROPE-EU","LATVIA","LUTON","RIGA",53234,53230,4
2020,"EASTERN EUROPE-EU","LATVIA","STANSTED","RIGA",87595,87595,0
2020,"EASTERN EUROPE-EU","LITHUANIA","GATWICK","VILNIUS",5313,4975,338
2020,"EASTERN EUROPE-EU","LITHUANIA","HEATHROW","VILNIUS",49,49,0
2020,"EASTERN EUROPE-EU","LITHUANIA","LONDON CITY","VILNIUS",15207,15207,0
2020,"EASTERN EUROPE-EU","LITHUANIA","LUTON","KAUNAS",91248,91248,0
2020,"EASTERN EUROPE-EU","LITHUANIA","LUTON","PALANGA",18543,18543,0
2020,"EASTERN EUROPE-EU","LITHUANIA","LUTON","VILNIUS",80465,80465,0
2020,"EASTERN EUROPE-EU","LITHUANIA","SOUTHEND","VILNIUS",24600,24600,0
2020,"EASTERN EUROPE-EU","LITHUANIA","STANSTED","KAUNAS",32890,32890,0
2020,"EASTERN EUROPE-EU","LITHUANIA","STANSTED","PALANGA",14679,14679,0
2020,"EASTERN EUROPE-EU","LITHUANIA","STANSTED","VILNIUS",43817,42735,1082
2020,"EASTERN EUROPE-EU","POLAND","GATWICK","GDANSK",44335,44335,0
2020,"EASTERN EUROPE-EU","POLAND","GATWICK","KRAKOW",83924,83143,781
2020,"EASTERN EUROPE-EU","POLAND","GATWICK","LODZ LUBLINEK",0,0,0
2020,"EASTERN EUROPE-EU","POLAND","GATWICK","WARSAW (CHOPIN)",245,0,245
2020,"EASTERN EUROPE-EU","POLAND","GATWICK","WROCLAW",20,0,20
2020,"EASTERN EUROPE-EU","POLAND","HEATHROW","KATOWICE",40,40,0
2020,"EASTERN EUROPE-EU","POLAND","HEATHROW","KRAKOW",31955,31955,0
2020,"EASTERN EUROPE-EU","POLAND","HEATHROW","WARSAW (CHOPIN)",160785,141690,19095
2020,"EASTERN EUROPE-EU","POLAND","LONDON CITY","WARSAW (CHOPIN)",18190,15241,2949
2020,"EASTERN EUROPE-EU","POLAND","LUTON","BYDGOSZCZ",15892,15892,0
2020,"EASTERN EUROPE-EU","POLAND","LUTON","GDANSK",85585,85585,0
2020,"EASTERN EUROPE-EU","POLAND","LUTON","KATOWICE",90500,90500,0
2020,"EASTERN EUROPE-EU","POLAND","LUTON","KRAKOW",131864,131864,0
2020,"EASTERN EUROPE-EU","POLAND","LUTON","LUBLIN (PORT LOTNICZY)",55572,55572,0
2020,"EASTERN EUROPE-EU","POLAND","LUTON","POZNAN",51596,51596,0
2020,"EASTERN EUROPE-EU","POLAND","LUTON","RZESZOW",20056,20056,0
2020,"EASTERN EUROPE-EU","POLAND","LUTON","SZYMANY (MAZURY)",18153,18153,0
2020,"EASTERN EUROPE-EU","POLAND","LUTON","WARSAW (CHOPIN)",179993,179993,0
2020,"EASTERN EUROPE-EU","POLAND","LUTON","WROCLAW",52036,52036,0
2020,"EASTERN EUROPE-EU","POLAND","STANSTED","BYDGOSZCZ",39966,39966,0
2020,"EASTERN EUROPE-EU","POLAND","STANSTED","GDANSK",59777,59777,0
2020,"EASTERN EUROPE-EU","POLAND","STANSTED","KATOWICE",53434,53434,0
2020,"EASTERN EUROPE-EU","POLAND","STANSTED","KRAKOW",120518,120334,184
2020,"EASTERN EUROPE-EU","POLAND","STANSTED","LODZ LUBLINEK",40485,40485,0
2020,"EASTERN EUROPE-EU","POLAND","STANSTED","LUBLIN (PORT LOTNICZY)",0,0,0
2020,"EASTERN EUROPE-EU","POLAND","STANSTED","POZNAN",53891,53891,0
2020,"EASTERN EUROPE-EU","POLAND","STANSTED","RZESZOW",39400,39400,0
2020,"EASTERN EUROPE-EU","POLAND","STANSTED","SZCZECIN (GOLENOW)",33567,33567,0
2020,"EASTERN EUROPE-EU","POLAND","STANSTED","SZYMANY (MAZURY)",14479,14479,0
2020,"EASTERN EUROPE-EU","POLAND","STANSTED","WARSAW (CHOPIN)",0,0,0
2020,"EASTERN EUROPE-EU","POLAND","STANSTED","WARSAW (MODLIN MASOVIA)",123882,123806,76
2020,"EASTERN EUROPE-EU","POLAND","STANSTED","WROCLAW",72774,72726,48
2020,"EASTERN EUROPE-EU","ROMANIA","GATWICK","BUCHAREST (OTOPENI)",48085,47708,377
2020,"EASTERN EUROPE-EU","ROMANIA","GATWICK","CLUJ NAPOCA",19855,19855,0
2020,"EASTERN EUROPE-EU","ROMANIA","HEATHROW","BUCHAREST (OTOPENI)",82608,79836,2772
2020,"EASTERN EUROPE-EU","ROMANIA","LUTON","BACAU",42384,42384,0
2020,"EASTERN EUROPE-EU","ROMANIA","LUTON","BUCHAREST (OTOPENI)",254593,252652,1941
2020,"EASTERN EUROPE-EU","ROMANIA","LUTON","CLUJ NAPOCA",92817,92817,0
2020,"EASTERN EUROPE-EU","ROMANIA","LUTON","CONSTANTA",24254,24254,0
2020,"EASTERN EUROPE-EU","ROMANIA","LUTON","CRAIOVA",63485,63485,0
2020,"EASTERN EUROPE-EU","ROMANIA","LUTON","IASI",97753,97753,0
2020,"EASTERN EUROPE-EU","ROMANIA","LUTON","SATU MARE",18152,18152,0
2020,"EASTERN EUROPE-EU","ROMANIA","LUTON","SIBIU",19465,19465,0
2020,"EASTERN EUROPE-EU","ROMANIA","LUTON","SUCEAVA",78540,78540,0
2020,"EASTERN EUROPE-EU","ROMANIA","LUTON","TIMISOARA",52929,52929,0
2020,"EASTERN EUROPE-EU","ROMANIA","LUTON","TIRGU MURES",17293,17293,0
2020,"EASTERN EUROPE-EU","ROMANIA","SOUTHEND","BUCHAREST (OTOPENI)",49398,49398,0
2020,"EASTERN EUROPE-EU","ROMANIA","SOUTHEND","CLUJ NAPOCA",0,0,0
2020,"EASTERN EUROPE-EU","ROMANIA","SOUTHEND","SIBIU",19520,19520,0
2020,"EASTERN EUROPE-EU","ROMANIA","STANSTED","BUCHAREST (OTOPENI)",103620,103186,434
2020,"EASTERN EUROPE-EU","ROMANIA","STANSTED","CLUJ NAPOCA",5306,5306,0
2020,"EASTERN EUROPE-EU","ROMANIA","STANSTED","IASI",651,0,651
2020,"EASTERN EUROPE-EU","SLOVAK REPUBLIC","GATWICK","BRATISLAVA",26,0,26
2020,"EASTERN EUROPE-EU","SLOVAK REPUBLIC","LUTON","BRATISLAVA",28281,28281,0
2020,"EASTERN EUROPE-EU","SLOVAK REPUBLIC","LUTON","KOSICE",44371,44371,0
2020,"EASTERN EUROPE-EU","SLOVAK REPUBLIC","LUTON","TATRY-POPRAD",16548,16548,0
2020,"EASTERN EUROPE-EU","SLOVAK REPUBLIC","SOUTHEND","KOSICE",0,0,0
2020,"EASTERN EUROPE-EU","SLOVAK REPUBLIC","STANSTED","BRATISLAVA",52874,52192,682
2020,"EASTERN EUROPE-EU","SLOVAK REPUBLIC","STANSTED","KOSICE",6579,6579,0
2020,"EASTERN EUROPE -OTHER","ALBANIA","GATWICK","TIRANA",32979,32626,353
2020,"EASTERN EUROPE -OTHER","ALBANIA","HEATHROW","TIRANA",20406,20406,0
2020,"EASTERN EUROPE -OTHER","ALBANIA","LUTON","TIRANA",76603,74489,2114
2020,"EASTERN EUROPE -OTHER","ALBANIA","STANSTED","TIRANA",3035,3035,0
2020,"EASTERN EUROPE -OTHER","AZERBAIJAN","GATWICK","BAKU (HEYDER ALIYEV INT'L)",0,0,0
2020,"EASTERN EUROPE -OTHER","AZERBAIJAN","HEATHROW","BAKU (HEYDER ALIYEV INT'L)",10959,9349,1610
2020,"EASTERN EUROPE -OTHER","AZERBAIJAN","LUTON","BAKU (HEYDER ALIYEV INT'L)",0,0,0
2020,"EASTERN EUROPE -OTHER","AZERBAIJAN","STANSTED","BAKU (HEYDER ALIYEV INT'L)",0,0,0
2020,"EASTERN EUROPE -OTHER","BELARUS","GATWICK","MINSK INT'L ",25648,25648,0
2020,"EASTERN EUROPE -OTHER","BELARUS","LUTON","MINSK INT'L ",0,0,0
2020,"EASTERN EUROPE -OTHER","GEORGIA","GATWICK","TBILISI",1136,1136,0
2020,"EASTERN EUROPE -OTHER","GEORGIA","LUTON","KUTAISI",5702,5702,0
2020,"EASTERN EUROPE -OTHER","KAZAKHSTAN","GATWICK","NURSULTAN NAZERBAYEV INTERNATIONAL",1,0,1
2020,"EASTERN EUROPE -OTHER","KAZAKHSTAN","HEATHROW","NURSULTAN NAZERBAYEV INTERNATIONAL",6260,6206,54
2020,"EASTERN EUROPE -OTHER","KAZAKHSTAN","HEATHROW","PETROPAVLOSVK",95,0,95
2020,"EASTERN EUROPE -OTHER","REPUBLIC OF MOLDOVA","LUTON","CHISINAU (KISHINEV)",92973,91843,1130
2020,"EASTERN EUROPE -OTHER","REPUBLIC OF MOLDOVA","STANSTED","CHISINAU (KISHINEV)",32353,28138,4215
2020,"EASTERN EUROPE -OTHER","RUSSIA","GATWICK","KRASNODAR",58,0,58
2020,"EASTERN EUROPE -OTHER","RUSSIA","GATWICK","MOSCOW (SHEREMETYEVO)",0,0,0
2020,"EASTERN EUROPE -OTHER","RUSSIA","GATWICK","MOSCOW (VNUKOVO)",9,0,9
2020,"EASTERN EUROPE -OTHER","RUSSIA","GATWICK","ST PETERSBURG",13012,13012,0
2020,"EASTERN EUROPE -OTHER","RUSSIA","HEATHROW","ADLER / SOCHI",622,0,622
2020,"EASTERN EUROPE -OTHER","RUSSIA","HEATHROW","MOSCOW (DOMODEDOVO)",41350,41350,0
2020,"EASTERN EUROPE -OTHER","RUSSIA","HEATHROW","MOSCOW (SHEREMETYEVO)",167890,166597,1293
2020,"EASTERN EUROPE -OTHER","RUSSIA","HEATHROW","ST PETERSBURG",60,0,60
2020,"EASTERN EUROPE -OTHER","RUSSIA","LUTON","ADLER / SOCHI",0,0,0
2020,"EASTERN EUROPE -OTHER","RUSSIA","LUTON","MOSCOW (VNUKOVO)",39660,39660,0
2020,"EASTERN EUROPE -OTHER","RUSSIA","LUTON","ST PETERSBURG",34023,34023,0
2020,"EASTERN EUROPE -OTHER","RUSSIA","SOUTHEND","ST PETERSBURG",92,92,0
2020,"EASTERN EUROPE -OTHER","RUSSIA","STANSTED","ADLER / SOCHI",1,0,1
2020,"EASTERN EUROPE -OTHER","RUSSIA","STANSTED","KAZAN",0,0,0
2020,"EASTERN EUROPE -OTHER","RUSSIA","STANSTED","MOSCOW (DOMODEDOVO)",6821,6821,0
2020,"EASTERN EUROPE -OTHER","RUSSIA","STANSTED","ST PETERSBURG",0,0,0
2020,"EASTERN EUROPE -OTHER","TURKMENISTAN","HEATHROW","ASHKHABAD",0,0,0
2020,"EASTERN EUROPE -OTHER","UKRAINE","GATWICK","KIEV (BORISPOL)",37210,36301,909
2020,"EASTERN EUROPE -OTHER","UKRAINE","HEATHROW","KIEV (BORISPOL)",1875,753,1122
2020,"EASTERN EUROPE -OTHER","UKRAINE","LUTON","KHARKOV OSNOVA INTL",0,0,0
2020,"EASTERN EUROPE -OTHER","UKRAINE","LUTON","KIEV (BORISPOL)",0,0,0
2020,"EASTERN EUROPE -OTHER","UKRAINE","LUTON","KIEV (ZHULYANY)",31393,31393,0
2020,"EASTERN EUROPE -OTHER","UKRAINE","LUTON","LVOV",18112,18112,0
2020,"EASTERN EUROPE -OTHER","UKRAINE","SOUTHEND","KIEV (BORISPOL)",121,121,0
2020,"EASTERN EUROPE -OTHER","UKRAINE","STANSTED","KIEV (BORISPOL)",26235,26091,144
2020,"EASTERN EUROPE -OTHER","UKRAINE","STANSTED","LVOV",20276,20276,0
2020,"EASTERN EUROPE -OTHER","UZBEKISTAN","HEATHROW","TASHKENT",5868,5518,350
2020,"NEAR EAST","ISRAEL","GATWICK","TEL AVIV",9064,9064,0
2020,"NEAR EAST","ISRAEL","HEATHROW","TEL AVIV",161561,161536,25
2020,"NEAR EAST","ISRAEL","LUTON","OVDA",0,0,0
2020,"NEAR EAST","ISRAEL","LUTON","RAMON",0,0,0
2020,"NEAR EAST","ISRAEL","LUTON","TEL AVIV",94041,94041,0
2020,"NEAR EAST","ISRAEL","STANSTED","TEL AVIV",7117,6436,681
2020,"NEAR EAST","JORDAN","GATWICK","AMMAN",6,0,6
2020,"NEAR EAST","JORDAN","GATWICK","AQABA",6424,6424,0
2020,"NEAR EAST","JORDAN","HEATHROW","AMMAN",46863,46863,0
2020,"NEAR EAST","JORDAN","LUTON","AMMAN",0,0,0
2020,"NEAR EAST","LEBANON","HEATHROW","BEIRUT",76253,74232,2021
2020,"NORTH AFRICA","ALGERIA","GATWICK","ALGIERS",15224,14678,546
2020,"NORTH AFRICA","ALGERIA","HEATHROW","ALGIERS",14128,12891,1237
2020,"NORTH AFRICA","ALGERIA","HEATHROW","HASSI MESSAOUD",66,0,66
2020,"NORTH AFRICA","EGYPT","GATWICK","ALEXANDRIA (BORG EL ARAB)",323,0,323
2020,"NORTH AFRICA","EGYPT","GATWICK","CAIRO",1765,0,1765
2020,"NORTH AFRICA","EGYPT","GATWICK","HURGHADA",41693,41017,676
2020,"NORTH AFRICA","EGYPT","GATWICK","MARSA ALAM",4138,3984,154
2020,"NORTH AFRICA","EGYPT","GATWICK","SHARM EL SHEIKH (OPHIRA)",7143,6219,924
2020,"NORTH AFRICA","EGYPT","HEATHROW","ALEXANDRIA (BORG EL ARAB)",232,0,232
2020,"NORTH AFRICA","EGYPT","HEATHROW","CAIRO",147026,145563,1463
2020,"NORTH AFRICA","EGYPT","HEATHROW","LUXOR",2295,2295,0
2020,"NORTH AFRICA","EGYPT","HEATHROW","MARSA ALAM",487,320,167
2020,"NORTH AFRICA","EGYPT","STANSTED","HURGHADA",7444,7444,0
2020,"NORTH AFRICA","MOROCCO","GATWICK","AGADIR (AL MASSIRA)",24308,24019,289
2020,"NORTH AFRICA","MOROCCO","GATWICK","CASABLANCA MOHAMED V",15167,15137,30
2020,"NORTH AFRICA","MOROCCO","GATWICK","ERRACHIDIA",0,0,0
2020,"NORTH AFRICA","MOROCCO","GATWICK","FEZ",3205,3205,0
2020,"NORTH AFRICA","MOROCCO","GATWICK","MARRAKESH",86681,86347,334
2020,"NORTH AFRICA","MOROCCO","GATWICK","OUARZAZATE",0,0,0
2020,"NORTH AFRICA","MOROCCO","GATWICK","RABAT",0,0,0
2020,"NORTH AFRICA","MOROCCO","GATWICK","TANGIERS (IBN BATUTA)",13109,13109,0
2020,"NORTH AFRICA","MOROCCO","HEATHROW","CASABLANCA MOHAMED V",31695,31435,260
2020,"NORTH AFRICA","MOROCCO","HEATHROW","ERRACHIDIA",24,0,24
2020,"NORTH AFRICA","MOROCCO","HEATHROW","MARRAKESH",13113,11883,1230
2020,"NORTH AFRICA","MOROCCO","HEATHROW","RABAT",2779,2779,0
2020,"NORTH AFRICA","MOROCCO","LUTON","CASABLANCA MOHAMED V",254,0,254
2020,"NORTH AFRICA","MOROCCO","LUTON","MARRAKESH",7290,7290,0
2020,"NORTH AFRICA","MOROCCO","SOUTHEND","CASABLANCA MOHAMED V",56,56,0
2020,"NORTH AFRICA","MOROCCO","STANSTED","AGADIR (AL MASSIRA)",7313,7096,217
2020,"NORTH AFRICA","MOROCCO","STANSTED","CASABLANCA MOHAMED V",533,0,533
2020,"NORTH AFRICA","MOROCCO","STANSTED","ESSAOUIRA",7026,6975,51
2020,"NORTH AFRICA","MOROCCO","STANSTED","FEZ",7651,7651,0
2020,"NORTH AFRICA","MOROCCO","STANSTED","MARRAKESH",33439,32430,1009
2020,"NORTH AFRICA","MOROCCO","STANSTED","RABAT",11928,11928,0
2020,"NORTH AFRICA","TUNISIA","GATWICK","ENFIDHA - HAMMAMET INTL",4060,0,4060
2020,"NORTH AFRICA","TUNISIA","GATWICK","TUNIS",9331,9071,260
2020,"NORTH AFRICA","TUNISIA","HEATHROW","TUNIS",12911,12840,71
2020,"NORTH AFRICA","TUNISIA","LUTON","ENFIDHA - HAMMAMET INTL",0,0,0
2020,"NORTH AFRICA","TUNISIA","STANSTED","ENFIDHA - HAMMAMET INTL",0,0,0
2020,"EAST AFRICA","ETHIOPIA","HEATHROW","ADDIS ABABA",125797,125739,58
2020,"EAST AFRICA","KENYA","HEATHROW","NAIROBI",100096,98794,1302
2020,"EAST AFRICA","RWANDA","GATWICK","KIGALI",6252,6252,0
2020,"EAST AFRICA","RWANDA","HEATHROW","KIGALI",1406,1406,0
2020,"EAST AFRICA","SUDAN","HEATHROW","KHARTOUM",259,0,259
2020,"EAST AFRICA","TANZANIA","HEATHROW","DAR-ES-SALAAM",200,0,200
2020,"EAST AFRICA","UGANDA","HEATHROW","ENTEBBE",273,0,273
2020,"WEST AFRICA","BENIN","STANSTED","COTONOU",231,0,231
2020,"WEST AFRICA","BURKINO FASO","HEATHROW","OUAGADOUGOU",36,0,36
2020,"WEST AFRICA","CAMEROON","STANSTED","DOUALA",85,0,85
2020,"WEST AFRICA","EQUATORIAL GUINEA","HEATHROW","MALABO",185,0,185
2020,"WEST AFRICA","EQUATORIAL GUINEA","STANSTED","MALABO",61,0,61
2020,"WEST AFRICA","GAMBIA","GATWICK","BANJUL",10119,169,9950
2020,"WEST AFRICA","GAMBIA","STANSTED","BANJUL",150,0,150
2020,"WEST AFRICA","GHANA","GATWICK","ACCRA",0,0,0
2020,"WEST AFRICA","GHANA","HEATHROW","ACCRA",80899,80464,435
2020,"WEST AFRICA","GHANA","STANSTED","ACCRA",1413,0,1413
2020,"WEST AFRICA","NIGERIA","GATWICK","ABUJA",1138,0,1138
2020,"WEST AFRICA","NIGERIA","GATWICK","LAGOS",807,0,807
2020,"WEST AFRICA","NIGERIA","HEATHROW","ABUJA",53200,52767,433
2020,"WEST AFRICA","NIGERIA","HEATHROW","KANO",24,0,24
2020,"WEST AFRICA","NIGERIA","HEATHROW","LAGOS",153154,149792,3362
2020,"WEST AFRICA","NIGERIA","STANSTED","LAGOS",615,0,615
2020,"WEST AFRICA","SIERRA LEONE","GATWICK","FREETOWN",21,0,21
2020,"CENTRAL AFRICA","ANGOLA","GATWICK","LUANDA",114,0,114
2020,"CENTRAL AFRICA","ANGOLA","HEATHROW","LUANDA",234,0,234
2020,"CENTRAL AFRICA","ANGOLA","STANSTED","LUANDA",25,0,25
2020,"SOUTHERN AFRICA","NAMIBIA","HEATHROW","WINDHOEK",127,0,127
2020,"SOUTHERN AFRICA","REPUBLIC OF SOUTH AFRICA","GATWICK","CAPE TOWN",22253,22151,102
2020,"SOUTHERN AFRICA","REPUBLIC OF SOUTH AFRICA","HEATHROW","CAPE TOWN",122303,117985,4318
2020,"SOUTHERN AFRICA","REPUBLIC OF SOUTH AFRICA","HEATHROW","DURBAN",13323,13323,0
2020,"SOUTHERN AFRICA","REPUBLIC OF SOUTH AFRICA","HEATHROW","JOHANNESBURG",240755,238248,2507
2020,"MIDDLE EAST","BAHRAIN","HEATHROW","BAHRAIN",136131,134666,1465
2020,"MIDDLE EAST","IRAN","HEATHROW","TEHRAN IMAM KHOMEINI",33992,33992,0
2020,"MIDDLE EAST","IRAQ","GATWICK","BAGHDAD (GECA)",0,0,0
2020,"MIDDLE EAST","IRAQ","GATWICK","SULAYMANIYAH INT",0,0,0
2020,"MIDDLE EAST","IRAQ","STANSTED","ERBIL INTERNATIONAL",171,0,171
2020,"MIDDLE EAST","KUWAIT","GATWICK","KUWAIT",12630,12338,292
2020,"MIDDLE EAST","KUWAIT","HEATHROW","KUWAIT",101686,98004,3682
2020,"MIDDLE EAST","OMAN","GATWICK","MUSCAT",0,0,0
2020,"MIDDLE EAST","OMAN","HEATHROW","MUSCAT",98680,91391,7289
2020,"MIDDLE EAST","QATAR","GATWICK","DOHA HAMAD",82923,82923,0
2020,"MIDDLE EAST","QATAR","HEATHROW","DOHA HAMAD",486850,480993,5857
2020,"MIDDLE EAST","SAUDI ARABIA","HEATHROW","DAMMAM",6158,5625,533
2020,"MIDDLE EAST","SAUDI ARABIA","HEATHROW","JEDDAH",70694,70648,46
2020,"MIDDLE EAST","SAUDI ARABIA","HEATHROW","MEDINA",0,0,0
2020,"MIDDLE EAST","SAUDI ARABIA","HEATHROW","RIYADH",85369,85369,0
2020,"MIDDLE EAST","SAUDI ARABIA","HEATHROW","TABUK",126,126,0
2020,"MIDDLE EAST","SAUDI ARABIA","LUTON","NEOM BAY",0,0,0
2020,"MIDDLE EAST","SAUDI ARABIA","LUTON","RIYADH",0,0,0
2020,"MIDDLE EAST","SAUDI ARABIA","STANSTED","JEDDAH",40,0,40
2020,"MIDDLE EAST","SAUDI ARABIA","STANSTED","RIYADH",30,0,30
2020,"MIDDLE EAST","UNITED ARAB EMIRATES","GATWICK","DUBAI",207005,207005,0
2020,"MIDDLE EAST","UNITED ARAB EMIRATES","GATWICK","DUBAI (WORLD CENTRAL)",0,0,0
2020,"MIDDLE EAST","UNITED ARAB EMIRATES","HEATHROW","ABU DHABI INTERNATIONAL",289310,289105,205
2020,"MIDDLE EAST","UNITED ARAB EMIRATES","HEATHROW","DUBAI",863667,863667,0
2020,"MIDDLE EAST","UNITED ARAB EMIRATES","STANSTED","DUBAI",97289,97289,0
2020,"INDIAN SUB-CONTINENT","AFGHANISTAN","HEATHROW","BAGRAM",266,0,266
2020,"INDIAN SUB-CONTINENT","BANGLADESH","HEATHROW","DHAKHA",30715,27516,3199
2020,"INDIAN SUB-CONTINENT","BANGLADESH","HEATHROW","SYLHET",18325,18325,0
2020,"INDIAN SUB-CONTINENT","INDIA","GATWICK","COCHIN",0,0,0
2020,"INDIAN SUB-CONTINENT","INDIA","GATWICK","GOA",13223,0,13223
2020,"INDIAN SUB-CONTINENT","INDIA","GATWICK","MUMBAI",297,0,297
2020,"INDIAN SUB-CONTINENT","INDIA","HEATHROW","AHMEDABAD",36510,21462,15048
2020,"INDIAN SUB-CONTINENT","INDIA","HEATHROW","AMRITSAR",13507,0,13507
2020,"INDIAN SUB-CONTINENT","INDIA","HEATHROW","BANGALORE (BENGALURU)",81017,69675,11342
2020,"INDIAN SUB-CONTINENT","INDIA","HEATHROW","BIJU PATNAIK INTERNATIONAL",67,0,67
2020,"INDIAN SUB-CONTINENT","INDIA","HEATHROW","CHENNAI",43020,40334,2686
2020,"INDIAN SUB-CONTINENT","INDIA","HEATHROW","COCHIN",15770,0,15770
2020,"INDIAN SUB-CONTINENT","INDIA","HEATHROW","DELHI",293018,234380,58638
2020,"INDIAN SUB-CONTINENT","INDIA","HEATHROW","GOA",11010,0,11010
2020,"INDIAN SUB-CONTINENT","INDIA","HEATHROW","HYDERABAD ( RAJIV GHANDI )",47356,45527,1829
2020,"INDIAN SUB-CONTINENT","INDIA","HEATHROW","KOLKATA",3675,0,3675
2020,"INDIAN SUB-CONTINENT","INDIA","HEATHROW","MUMBAI",226350,188311,38039
2020,"INDIAN SUB-CONTINENT","INDIA","HEATHROW","VIJAYAWADA",136,0,136
2020,"INDIAN SUB-CONTINENT","INDIA","HEATHROW","VISHAKHPATNAM",287,0,287
2020,"INDIAN SUB-CONTINENT","INDIA","STANSTED","AMRITSAR",13513,13513,0
2020,"INDIAN SUB-CONTINENT","INDIA","STANSTED","GOA",932,0,932
2020,"INDIAN SUB-CONTINENT","INDIA","STANSTED","MUMBAI",4553,4553,0
2020,"INDIAN SUB-CONTINENT","NEPAL","STANSTED","KATHMANDU",754,0,754
2020,"INDIAN SUB-CONTINENT","PAKISTAN","GATWICK","BENAZIR BHUTTO INTERNATIONAL AIRPORT",100,0,100
2020,"INDIAN SUB-CONTINENT","PAKISTAN","HEATHROW","BENAZIR BHUTTO INTERNATIONAL AIRPORT",0,0,0
2020,"INDIAN SUB-CONTINENT","PAKISTAN","HEATHROW","ISLAMABAD INTERNATIONAL AIRPORT",107872,107057,815
2020,"INDIAN SUB-CONTINENT","PAKISTAN","HEATHROW","KARACHI",7680,7334,346
2020,"INDIAN SUB-CONTINENT","PAKISTAN","HEATHROW","LAHORE",44248,43822,426
2020,"INDIAN SUB-CONTINENT","PAKISTAN","HEATHROW","SIALKOT",4545,4545,0
2020,"INDIAN SUB-CONTINENT","SRI LANKA","GATWICK","COLOMBO",248,0,248
2020,"INDIAN SUB-CONTINENT","SRI LANKA","HEATHROW","COLOMBO",70392,70392,0
2020,"INDIAN SUB-CONTINENT","SRI LANKA","HEATHROW","MATTALA RAJAPAKSA",57,0,57
2020,"INDIAN SUB-CONTINENT","SRI LANKA","STANSTED","COLOMBO",585,0,585
2020,"FAR EAST","BRUNEI","HEATHROW","BANDAR SERI BEGAWAN",28616,28616,0
2020,"FAR EAST","CHINA","GATWICK","CHENGDU",85,0,85
2020,"FAR EAST","CHINA","GATWICK","SHANGHAI (PU DONG)",24173,24173,0
2020,"FAR EAST","CHINA","HEATHROW","BEIJING",53437,53437,0
2020,"FAR EAST","CHINA","HEATHROW","BEIJING DAXING INTERNATIONAL AIRPORT",9564,9564,0
2020,"FAR EAST","CHINA","HEATHROW","CHANGSHA HUANGHUA INTERNATIONAL AIRPORT",4294,3768,526
2020,"FAR EAST","CHINA","HEATHROW","CHENGDU",6158,5667,491
2020,"FAR EAST","CHINA","HEATHROW","CHONGQING JIANGBEI INTERNATIONAL",2569,2057,512
2020,"FAR EAST","CHINA","HEATHROW","GUANGZHOU BAIYUN INTERNATIONAL",40220,40216,4
2020,"FAR EAST","CHINA","HEATHROW","HAIKOU",271,0,271
2020,"FAR EAST","CHINA","HEATHROW","HANGZHOU",140,0,140
2020,"FAR EAST","CHINA","HEATHROW","HEFEI",253,0,253
2020,"FAR EAST","CHINA","HEATHROW","JINAN YAOQIANG INTERNATIONAL",385,181,204
2020,"FAR EAST","CHINA","HEATHROW","NANJING LUKOU INTERNATIONAL",369,0,369
2020,"FAR EAST","CHINA","HEATHROW","QINGDAO",13718,13222,496
2020,"FAR EAST","CHINA","HEATHROW","SANYA PHOENIX INTERNATIONAL",2254,2254,0
2020,"FAR EAST","CHINA","HEATHROW","SHANGHAI (PU DONG)",104273,104213,60
2020,"FAR EAST","CHINA","HEATHROW","SHENZHEN (HUANGTIAN)",7249,6465,784
2020,"FAR EAST","CHINA","HEATHROW","TIANJIN",1404,1171,233
2020,"FAR EAST","CHINA","HEATHROW","WUHAN TIANHE INTERNATIONAL",4252,3999,253
2020,"FAR EAST","CHINA","HEATHROW","XIAN XIANYANG",5907,5418,489
2020,"FAR EAST","CHINA","HEATHROW","ZHENGZHOU XINZHENG",4060,3275,785
2020,"FAR EAST","HONG KONG","GATWICK","HONG KONG (CHEK LAP KOK)",17259,17259,0
2020,"FAR EAST","HONG KONG","HEATHROW","HONG KONG (CHEK LAP KOK)",352214,351490,724
2020,"FAR EAST","INDONESIA","HEATHROW","BALI INTERNATIONAL",1383,957,426
2020,"FAR EAST","INDONESIA","HEATHROW","JAKARTA (SOEKARNO-HATTA INTNL)",0,0,0
2020,"FAR EAST","INDONESIA","HEATHROW","KUALANAMU INTERNATIONAL AIRPORT",3201,3201,0
2020,"FAR EAST","JAPAN","HEATHROW","OSAKA (KANSAI)",11133,11133,0
2020,"FAR EAST","JAPAN","HEATHROW","TOKYO (HANEDA)",142681,142681,0
2020,"FAR EAST","JAPAN","HEATHROW","TOKYO (NARITA)",26369,26369,0
2020,"FAR EAST","MALAYSIA","GATWICK","LANGKAWI",2598,0,2598
2020,"FAR EAST","MALAYSIA","HEATHROW","KUALA LUMPUR (SEPANG)",114054,114054,0
2020,"FAR EAST","PHILIPPINES","GATWICK","CLARK INTERNATIONAL",426,0,426
2020,"FAR EAST","PHILIPPINES","GATWICK","MANILA",1114,0,1114
2020,"FAR EAST","PHILIPPINES","HEATHROW","CEBU",447,447,0
2020,"FAR EAST","PHILIPPINES","HEATHROW","CLARK INTERNATIONAL",671,671,0
2020,"FAR EAST","PHILIPPINES","HEATHROW","MANILA",34431,31883,2548
2020,"FAR EAST","REPUBLIC OF KOREA","HEATHROW","SEOUL (INCHEON)",106712,106712,0
2020,"FAR EAST","SINGAPORE","GATWICK","SINGAPORE",0,0,0
2020,"FAR EAST","SINGAPORE","HEATHROW","SINGAPORE",349219,349147,72
2020,"FAR EAST","TAIWAN","GATWICK","TAIPEI",21951,21951,0
2020,"FAR EAST","TAIWAN","HEATHROW","TAIPEI",13590,13590,0
2020,"FAR EAST","THAILAND","GATWICK","PHUKET",6911,0,6911
2020,"FAR EAST","THAILAND","GATWICK","U-TAPAO",2695,0,2695
2020,"FAR EAST","THAILAND","HEATHROW","BANGKOK SUVARNABHUMI ",216277,209288,6989
2020,"FAR EAST","VIETNAM","GATWICK","PHU QUOC INTERNATIONAL",5413,0,5413
2020,"FAR EAST","VIETNAM","HEATHROW","HANOI",22870,22870,0
2020,"FAR EAST","VIETNAM","HEATHROW","HO CHI MINH CITY",16209,16209,0
2020,"FAR EAST","VIETNAM","STANSTED","HO CHI MINH CITY",63,0,63
2020,"AUSTRALASIA","AUSTRALIA","HEATHROW","DARWIN",2470,2470,0
2020,"AUSTRALASIA","AUSTRALIA","HEATHROW","MELBOURNE",4635,4635,0
2020,"AUSTRALASIA","AUSTRALIA","HEATHROW","PERTH (AUSTRALIA)",32130,32130,0
2020,"AUSTRALASIA","AUSTRALIA","HEATHROW","SYDNEY",44854,44854,0
2020,"AUSTRALASIA","NEW ZEALAND","HEATHROW","AUCKLAND INTERNATIONAL",4995,4995,0
2020,"CANADA","CANADA","GATWICK","CALGARY",30345,30345,0
2020,"CANADA","CANADA","GATWICK","EDMONTON",0,0,0
2020,"CANADA","CANADA","GATWICK","HALIFAX INT",0,0,0
2020,"CANADA","CANADA","GATWICK","MONTREAL (DORVAL)",0,0,0
2020,"CANADA","CANADA","GATWICK","TORONTO",85434,85434,0
2020,"CANADA","CANADA","GATWICK","VANCOUVER",0,0,0
2020,"CANADA","CANADA","GATWICK","WINNIPEG",0,0,0
2020,"CANADA","CANADA","HEATHROW","CALGARY",36986,36986,0
2020,"CANADA","CANADA","HEATHROW","HALIFAX INT",0,0,0
2020,"CANADA","CANADA","HEATHROW","MONTREAL (DORVAL)",73749,73749,0
2020,"CANADA","CANADA","HEATHROW","OTTAWA INTERNATIONAL",18601,18601,0
2020,"CANADA","CANADA","HEATHROW","ST JOHNS",0,0,0
2020,"CANADA","CANADA","HEATHROW","TORONTO",292973,292973,0
2020,"CANADA","CANADA","HEATHROW","VANCOUVER",127505,127505,0
2020,"CANADA","CANADA","STANSTED","HALIFAX INT",0,0,0
2020,"UNITED STATES OF AMERICA","USA","GATWICK","ATLANTA",0,0,0
2020,"UNITED STATES OF AMERICA","USA","GATWICK","AUSTIN (BERGSTROM)",3494,3494,0
2020,"UNITED STATES OF AMERICA","USA","GATWICK","BOSTON",32945,32945,0
2020,"UNITED STATES OF AMERICA","USA","GATWICK","CHICAGO (O'HARE)",0,0,0
2020,"UNITED STATES OF AMERICA","USA","GATWICK","CINCINNATI",0,0,0
2020,"UNITED STATES OF AMERICA","USA","GATWICK","DENVER INTERNATIONAL",0,0,0
2020,"UNITED STATES OF AMERICA","USA","GATWICK","FORT LAUDERDALE",0,0,0
2020,"UNITED STATES OF AMERICA","USA","GATWICK","HONOLULU",237,0,237
2020,"UNITED STATES OF AMERICA","USA","GATWICK","LAS VEGAS",16725,16725,0
2020,"UNITED STATES OF AMERICA","USA","GATWICK","LOS ANGELES INTERNATIONAL",39200,39200,0
2020,"UNITED STATES OF AMERICA","USA","GATWICK","MIAMI INTERNATIONAL",35934,35934,0
2020,"UNITED STATES OF AMERICA","USA","GATWICK","NEW YORK (JF KENNEDY)",114745,114745,0
2020,"UNITED STATES OF AMERICA","USA","GATWICK","NEW YORK (NEWARK)",0,0,0
2020,"UNITED STATES OF AMERICA","USA","GATWICK","OAKLAND",0,0,0
2020,"UNITED STATES OF AMERICA","USA","GATWICK","ORLANDO",133715,133715,0
2020,"UNITED STATES OF AMERICA","USA","GATWICK","PHILADELPHIA INTERNATIONAL",0,0,0
2020,"UNITED STATES OF AMERICA","USA","GATWICK","SAN FRANCISCO",22230,22230,0
2020,"UNITED STATES OF AMERICA","USA","GATWICK","SANFORD",0,0,0
2020,"UNITED STATES OF AMERICA","USA","GATWICK","SEATTLE (TACOMA)",0,0,0
2020,"UNITED STATES OF AMERICA","USA","GATWICK","TAMPA",41457,41457,0
2020,"UNITED STATES OF AMERICA","USA","GATWICK","TETERBORO",0,0,0
2020,"UNITED STATES OF AMERICA","USA","HEATHROW","ATLANTA",140492,140492,0
2020,"UNITED STATES OF AMERICA","USA","HEATHROW","AUSTIN (BERGSTROM)",29216,29216,0
2020,"UNITED STATES OF AMERICA","USA","HEATHROW","BALTIMORE",22377,22377,0
2020,"UNITED STATES OF AMERICA","USA","HEATHROW","BOSTON",181294,181294,0
2020,"UNITED STATES OF AMERICA","USA","HEATHROW","CHARLESTON",0,0,0
2020,"UNITED STATES OF AMERICA","USA","HEATHROW","CHARLOTTE",56536,56536,0
2020,"UNITED STATES OF AMERICA","USA","HEATHROW","CHICAGO (O'HARE)",238020,238020,0
2020,"UNITED STATES OF AMERICA","USA","HEATHROW","CINCINNATI",0,0,0
2020,"UNITED STATES OF AMERICA","USA","HEATHROW","DALLAS/FORT WORTH",210470,210470,0
2020,"UNITED STATES OF AMERICA","USA","HEATHROW","DENVER INTERNATIONAL",52596,52596,0
2020,"UNITED STATES OF AMERICA","USA","HEATHROW","DETROIT",23602,23602,0
2020,"UNITED STATES OF AMERICA","USA","HEATHROW","FORT LAUDERDALE",225,0,225
2020,"UNITED STATES OF AMERICA","USA","HEATHROW","HOUSTON",83269,83151,118
2020,"UNITED STATES OF AMERICA","USA","HEATHROW","INDIANAPOLIS",0,0,0
2020,"UNITED STATES OF AMERICA","USA","HEATHROW","JACKSONVILLE",0,0,0
2020,"UNITED STATES OF AMERICA","USA","HEATHROW","LAS VEGAS",77426,77426,0
2020,"UNITED STATES OF AMERICA","USA","HEATHROW","LOS ANGELES INTERNATIONAL",370164,369620,544
2020,"UNITED STATES OF AMERICA","USA","HEATHROW","MIAMI INTERNATIONAL",288335,287287,1048
2020,"UNITED STATES OF AMERICA","USA","HEATHROW","MINNEAPOLIS-ST PAUL",20384,20384,0
2020,"UNITED STATES OF AMERICA","USA","HEATHROW","NASHVILLE METROPOLITAN",15100,15100,0
2020,"UNITED STATES OF AMERICA","USA","HEATHROW","NEW ORLEANS",17586,17586,0
2020,"UNITED STATES OF AMERICA","USA","HEATHROW","NEW YORK (JF KENNEDY)",659182,659182,0
2020,"UNITED STATES OF AMERICA","USA","HEATHROW","NEW YORK (NEWARK)",196464,196464,0
2020,"UNITED STATES OF AMERICA","USA","HEATHROW","ORLANDO",0,0,0
2020,"UNITED STATES OF AMERICA","USA","HEATHROW","PHILADELPHIA INTERNATIONAL",69052,69052,0
2020,"UNITED STATES OF AMERICA","USA","HEATHROW","PHOENIX",52122,52122,0
2020,"UNITED STATES OF AMERICA","USA","HEATHROW","PITTSBURGH",9923,9923,0
2020,"UNITED STATES OF AMERICA","USA","HEATHROW","PORTLAND (OREGON)",0,0,0
2020,"UNITED STATES OF AMERICA","USA","HEATHROW","RALEIGH",21239,21239,0
2020,"UNITED STATES OF AMERICA","USA","HEATHROW","SALT LAKE CITY",18478,18478,0
2020,"UNITED STATES OF AMERICA","USA","HEATHROW","SAN DIEGO",34195,34195,0
2020,"UNITED STATES OF AMERICA","USA","HEATHROW","SAN FRANCISCO",194126,194126,0
2020,"UNITED STATES OF AMERICA","USA","HEATHROW","SAN JOSE",17675,17675,0
2020,"UNITED STATES OF AMERICA","USA","HEATHROW","SEATTLE (TACOMA)",75783,75783,0
2020,"UNITED STATES OF AMERICA","USA","HEATHROW","WASHINGTON (DULLES)",177565,177299,266
2020,"UNITED STATES OF AMERICA","USA","LONDON CITY","NEW YORK (JF KENNEDY)",2040,2040,0
2020,"UNITED STATES OF AMERICA","USA","LUTON","WASHINGTON (DULLES)",0,0,0
2020,"UNITED STATES OF AMERICA","USA","STANSTED","BOSTON",0,0,0
2020,"UNITED STATES OF AMERICA","USA","STANSTED","CHARLOTTE",0,0,0
2020,"UNITED STATES OF AMERICA","USA","STANSTED","COLUMBUS",0,0,0
2020,"UNITED STATES OF AMERICA","USA","STANSTED","COLUMBUS RICKENBACKER AFB",0,0,0
2020,"UNITED STATES OF AMERICA","USA","STANSTED","NEW YORK (NEWARK)",0,0,0
2020,"UNITED STATES OF AMERICA","USA","STANSTED","TAMPA",0,0,0
2020,"CENTRAL AMERICA","COSTA RICA","GATWICK","LIBERIA",7077,0,7077
2020,"CENTRAL AMERICA","COSTA RICA","GATWICK","SAN JOSE COST RICA",19767,19767,0
2020,"CENTRAL AMERICA","COSTA RICA","HEATHROW","SAN JOSE COST RICA",172,0,172
2020,"CENTRAL AMERICA","CUBA","GATWICK","CUNAGUA (CAYO COCO)",0,0,0
2020,"CENTRAL AMERICA","CUBA","GATWICK","HAVANA",11104,11104,0
2020,"CENTRAL AMERICA","CUBA","GATWICK","HOLGUIN (FRANK PAIS)",0,0,0
2020,"CENTRAL AMERICA","CUBA","GATWICK","VARADERO",2661,0,2661
2020,"CENTRAL AMERICA","CUBA","HEATHROW","HAVANA",996,342,654
2020,"CENTRAL AMERICA","DOMINICAN REPUBLIC","GATWICK","PUNTA CANA",48382,32073,16309
2020,"CENTRAL AMERICA","DOMINICAN REPUBLIC","HEATHROW","PUNTA CANA",162,0,162
2020,"CENTRAL AMERICA","HONDURAS","HEATHROW","SAN PEDRO SULA",285,0,285
2020,"CENTRAL AMERICA","MEXICO","GATWICK","CANCUN",65786,65786,0
2020,"CENTRAL AMERICA","MEXICO","GATWICK","LOS CABOS",6162,0,6162
2020,"CENTRAL AMERICA","MEXICO","GATWICK","MEXICO CITY",141,0,141
2020,"CENTRAL AMERICA","MEXICO","GATWICK","PUERTO VALLARTA",0,0,0
2020,"CENTRAL AMERICA","MEXICO","HEATHROW","MEXICO CITY",60549,60549,0
2020,"CENTRAL AMERICA","MEXICO","HEATHROW","PUERTO VALLARTA",0,0,0
2020,"SOUTH AMERICA","ARGENTINA","GATWICK","BUENOS AIRES",32579,32251,328
2020,"SOUTH AMERICA","ARGENTINA","HEATHROW","BUENOS AIRES",41390,41137,253
2020,"SOUTH AMERICA","BRAZIL","GATWICK","MANAUS-EDUARDO GOMES",0,0,0
2020,"SOUTH AMERICA","BRAZIL","GATWICK","RIO DE JANEIRO (GALEAO)",22968,22968,0
2020,"SOUTH AMERICA","BRAZIL","HEATHROW","RECIFE",172,0,172
2020,"SOUTH AMERICA","BRAZIL","HEATHROW","RIO DE JANEIRO (GALEAO)",31554,31554,0
2020,"SOUTH AMERICA","BRAZIL","HEATHROW","SAO PAULO (GUARULHOS)",164708,164061,647
2020,"SOUTH AMERICA","CHILE","HEATHROW","SANTIAGO DE CHILE",24514,24332,182
2020,"SOUTH AMERICA","COLOMBIA","HEATHROW","BOGOTA",38222,38044,178
2020,"SOUTH AMERICA","COLOMBIA","HEATHROW","CARTAGENA",204,0,204
2020,"SOUTH AMERICA","ECUADOR","GATWICK","GUAYAQUIL",155,0,155
2020,"SOUTH AMERICA","ECUADOR","HEATHROW","GUAYAQUIL",175,0,175
2020,"SOUTH AMERICA","ECUADOR","HEATHROW","MARISCAL SUCRE INTERNATIONAL",77,0,77
2020,"SOUTH AMERICA","GUYANA","HEATHROW","GEORGETOWN (GUYANA)",949,0,949
2020,"SOUTH AMERICA","GUYANA","STANSTED","GEORGETOWN (GUYANA)",92,0,92
2020,"SOUTH AMERICA","PERU","GATWICK","JORGE CHAVEZ INTERNATIONAL",577,0,577
2020,"SOUTH AMERICA","PERU","HEATHROW","JORGE CHAVEZ INTERNATIONAL",1203,0,1203
2020,"CARIBBEAN AREA","ANTIGUA AND BARBUDA","GATWICK","ANTIGUA",72050,72050,0
2020,"CARIBBEAN AREA","ANTIGUA AND BARBUDA","HEATHROW","ANTIGUA",4041,3809,232
2020,"CARIBBEAN AREA","BAHAMAS","HEATHROW","FREEPORT",117,0,117
2020,"CARIBBEAN AREA","BAHAMAS","HEATHROW","NASSAU",13324,12971,353
2020,"CARIBBEAN AREA","BARBADOS","GATWICK","BRIDGETOWN",179585,133193,46392
2020,"CARIBBEAN AREA","BARBADOS","HEATHROW","BRIDGETOWN",27965,24087,3878
2020,"CARIBBEAN AREA","BARBADOS","STANSTED","BRIDGETOWN",294,0,294
2020,"CARIBBEAN AREA","BERMUDA","GATWICK","BERMUDA",32440,32440,0
2020,"CARIBBEAN AREA","BERMUDA","HEATHROW","BERMUDA",298,0,298
2020,"CARIBBEAN AREA","CAYMAN ISLANDS","GATWICK","GRAND CAYMAN",498,0,498
2020,"CARIBBEAN AREA","CAYMAN ISLANDS","HEATHROW","GRAND CAYMAN",12752,11325,1427
2020,"CARIBBEAN AREA","GRENADA","GATWICK","GRENADA",14815,14815,0
2020,"CARIBBEAN AREA","GRENADA","HEATHROW","GRENADA",293,293,0
2020,"CARIBBEAN AREA","GUADELOUPE","HEATHROW","POINTE A PITRE GUADELOUPE",166,0,166
2020,"CARIBBEAN AREA","ISLE OF CURACAO NETH.ANTILLES","GATWICK","ARUBA",1123,0,1123
2020,"CARIBBEAN AREA","ISLE OF CURACAO NETH.ANTILLES","HEATHROW","CURACAO",225,0,225
2020,"CARIBBEAN AREA","ISLE OF CURACAO NETH.ANTILLES","STANSTED","ARUBA",0,0,0
2020,"CARIBBEAN AREA","ISLE OF CURACAO NETH.ANTILLES","STANSTED","CURACAO",19,19,0
2020,"CARIBBEAN AREA","JAMAICA","GATWICK","KINGSTON",44145,43789,356
2020,"CARIBBEAN AREA","JAMAICA","GATWICK","MONTEGO BAY",51756,27065,24691
2020,"CARIBBEAN AREA","JAMAICA","HEATHROW","KINGSTON",167,0,167
2020,"CARIBBEAN AREA","JAMAICA","HEATHROW","MONTEGO BAY",5564,5564,0
2020,"CARIBBEAN AREA","JAMAICA","STANSTED","KINGSTON",0,0,0
2020,"CARIBBEAN AREA","JAMAICA","STANSTED","MONTEGO BAY",0,0,0
2020,"CARIBBEAN AREA","SAINT KITTS AND NEVIS","GATWICK","ST KITTS",4334,4334,0
2020,"CARIBBEAN AREA","ST LUCIA","GATWICK","ST LUCIA (HEWANORRA)",64435,58693,5742
2020,"CARIBBEAN AREA","ST LUCIA","HEATHROW","ST LUCIA (HEWANORRA)",29,29,0
2020,"CARIBBEAN AREA","TRINIDAD AND TOBAGO","GATWICK","PORT OF SPAIN",15152,15152,0
2020,"CARIBBEAN AREA","TRINIDAD AND TOBAGO","GATWICK","TOBAGO",8961,8961,0
2020,"CARIBBEAN AREA","TURKS AND CAICOS ISLANDS","GATWICK","PROVIDENCIALES",2710,2710,0
2020,"CARIBBEAN AREA","TURKS AND CAICOS ISLANDS","HEATHROW","PROVIDENCIALES",338,0,338
2020,"INDIAN OCEAN ISLANDS","MALDIVE ISLANDS","GATWICK","MALE INTERNATIONAL",20929,20929,0
2020,"INDIAN OCEAN ISLANDS","MALDIVE ISLANDS","HEATHROW","MALE INTERNATIONAL",12692,12692,0
2020,"INDIAN OCEAN ISLANDS","MAURITIUS","GATWICK","MAURITIUS",35488,35488,0
2020,"INDIAN OCEAN ISLANDS","MAURITIUS","HEATHROW","MAURITIUS",19338,19034,304
2020,"INDIAN OCEAN ISLANDS","SEYCHELLES","HEATHROW","SEYCHELLES",9995,9995,0
2020,"ATLANTIC OCEAN ISLANDS","ASCENSION ISLAND","STANSTED","SAINT HELENA",107,0,107
2020,"ATLANTIC OCEAN ISLANDS","CAPE VERDE ISLANDS","GATWICK","BOA VISTA (RABIL)",20097,19466,631
2020,"ATLANTIC OCEAN ISLANDS","CAPE VERDE ISLANDS","GATWICK","ILHA DO SAL C.VERDE",15354,14729,625
2020,"ATLANTIC OCEAN ISLANDS","CAPE VERDE ISLANDS","STANSTED","ILHA DO SAL C.VERDE",217,0,217
2021,"WESTERN EUROPE-EU","AUSTRIA","GATWICK","INNSBRUCK",9300,8230,1070
2021,"WESTERN EUROPE-EU","AUSTRIA","GATWICK","KLAGENFURT",0,0,0
2021,"WESTERN EUROPE-EU","AUSTRIA","GATWICK","LINZ",0,0,0
2021,"WESTERN EUROPE-EU","AUSTRIA","GATWICK","SALZBURG",1858,1544,314
2021,"WESTERN EUROPE-EU","AUSTRIA","GATWICK","VIENNA",106,106,0
2021,"WESTERN EUROPE-EU","AUSTRIA","HEATHROW","INNSBRUCK",2541,2541,0
2021,"WESTERN EUROPE-EU","AUSTRIA","HEATHROW","SALZBURG",2419,2419,0
2021,"WESTERN EUROPE-EU","AUSTRIA","HEATHROW","VIENNA",135223,135223,0
2021,"WESTERN EUROPE-EU","AUSTRIA","LUTON","GRAZ",0,0,0
2021,"WESTERN EUROPE-EU","AUSTRIA","LUTON","INNSBRUCK",679,307,372
2021,"WESTERN EUROPE-EU","AUSTRIA","LUTON","SALZBURG",492,492,0
2021,"WESTERN EUROPE-EU","AUSTRIA","LUTON","VIENNA",19345,19345,0
2021,"WESTERN EUROPE-EU","AUSTRIA","STANSTED","INNSBRUCK",563,295,268
2021,"WESTERN EUROPE-EU","AUSTRIA","STANSTED","SALZBURG",4867,4797,70
2021,"WESTERN EUROPE-EU","AUSTRIA","STANSTED","VIENNA",69573,68593,980
2021,"WESTERN EUROPE-EU","BELGIUM","GATWICK","BRUSSELS",0,0,0
2021,"WESTERN EUROPE-EU","BELGIUM","HEATHROW","BRUSSELS",118397,118397,0
2021,"WESTERN EUROPE-EU","BELGIUM","LONDON CITY","ANTWERP",0,0,0
2021,"WESTERN EUROPE-EU","BELGIUM","LONDON CITY","BRUSSELS",0,0,0
2021,"WESTERN EUROPE-EU","BELGIUM","LUTON","LIEGE",309,0,309
2021,"WESTERN EUROPE-EU","BELGIUM","STANSTED","BRUSSELS",161,161,0
2021,"WESTERN EUROPE-EU","BELGIUM","STANSTED","CHARLEROI",52,0,52
2021,"WESTERN EUROPE-EU","CROATIA","GATWICK","DUBROVNIK",26476,26476,0
2021,"WESTERN EUROPE-EU","CROATIA","GATWICK","PULA",10297,5344,4953
2021,"WESTERN EUROPE-EU","CROATIA","GATWICK","SPLIT",38424,35227,3197
2021,"WESTERN EUROPE-EU","CROATIA","GATWICK","ZADAR",4831,2304,2527
2021,"WESTERN EUROPE-EU","CROATIA","HEATHROW","DUBROVNIK",48453,48453,0
2021,"WESTERN EUROPE-EU","CROATIA","HEATHROW","PULA",3781,3781,0
2021,"WESTERN EUROPE-EU","CROATIA","HEATHROW","SPLIT",35733,35733,0
2021,"WESTERN EUROPE-EU","CROATIA","HEATHROW","ZAGREB",40000,39968,32
2021,"WESTERN EUROPE-EU","CROATIA","LONDON CITY","SPLIT",3234,3234,0
2021,"WESTERN EUROPE-EU","CROATIA","LUTON","DUBROVNIK",0,0,0
2021,"WESTERN EUROPE-EU","CROATIA","LUTON","PULA",1100,966,134
2021,"WESTERN EUROPE-EU","CROATIA","LUTON","SPLIT",30123,30123,0
2021,"WESTERN EUROPE-EU","CROATIA","LUTON","ZADAR",0,0,0
2021,"WESTERN EUROPE-EU","CROATIA","SOUTHEND","PULA",0,0,0
2021,"WESTERN EUROPE-EU","CROATIA","STANSTED","DUBROVNIK",12782,12782,0
2021,"WESTERN EUROPE-EU","CROATIA","STANSTED","PULA",14368,14337,31
2021,"WESTERN EUROPE-EU","CROATIA","STANSTED","RIJEKA",0,0,0
2021,"WESTERN EUROPE-EU","CROATIA","STANSTED","SPLIT",7280,7280,0
2021,"WESTERN EUROPE-EU","CROATIA","STANSTED","ZADAR",18060,18060,0
2021,"WESTERN EUROPE-EU","CROATIA","STANSTED","ZAGREB",30330,29964,366
2021,"WESTERN EUROPE-EU","CYPRUS","GATWICK","LARNACA",50461,39016,11445
2021,"WESTERN EUROPE-EU","CYPRUS","GATWICK","PAPHOS",77575,55143,22432
2021,"WESTERN EUROPE-EU","CYPRUS","HEATHROW","LARNACA",181107,181002,105
2021,"WESTERN EUROPE-EU","CYPRUS","HEATHROW","PAPHOS",32767,32767,0
2021,"WESTERN EUROPE-EU","CYPRUS","LUTON","LARNACA",41985,41985,0
2021,"WESTERN EUROPE-EU","CYPRUS","LUTON","PAPHOS",20544,20544,0
2021,"WESTERN EUROPE-EU","CYPRUS","STANSTED","LARNACA",23531,19397,4134
2021,"WESTERN EUROPE-EU","CYPRUS","STANSTED","PAPHOS",87947,78958,8989
2021,"WESTERN EUROPE-EU","DENMARK","GATWICK","AARHUS (TIRSTRUP)",0,0,0
2021,"WESTERN EUROPE-EU","DENMARK","GATWICK","COPENHAGEN",51967,51967,0
2021,"WESTERN EUROPE-EU","DENMARK","GATWICK","ROSKILDE",119,0,119
2021,"WESTERN EUROPE-EU","DENMARK","HEATHROW","BILLUND",0,0,0
2021,"WESTERN EUROPE-EU","DENMARK","HEATHROW","COPENHAGEN",215517,215517,0
2021,"WESTERN EUROPE-EU","DENMARK","LONDON CITY","BILLUND",0,0,0
2021,"WESTERN EUROPE-EU","DENMARK","LUTON","COPENHAGEN",354,0,354
2021,"WESTERN EUROPE-EU","DENMARK","STANSTED","AALBORG",8026,8026,0
2021,"WESTERN EUROPE-EU","DENMARK","STANSTED","AARHUS (TIRSTRUP)",16316,16316,0
2021,"WESTERN EUROPE-EU","DENMARK","STANSTED","BILLUND",47023,47023,0
2021,"WESTERN EUROPE-EU","DENMARK","STANSTED","COPENHAGEN",79524,79484,40
2021,"WESTERN EUROPE-EU","FINLAND","GATWICK","ENONTEKIO",2988,0,2988
2021,"WESTERN EUROPE-EU","FINLAND","GATWICK","HELSINKI",6275,6275,0
2021,"WESTERN EUROPE-EU","FINLAND","GATWICK","IVALO",6423,0,6423
2021,"WESTERN EUROPE-EU","FINLAND","GATWICK","KITTILA",10576,407,10169
2021,"WESTERN EUROPE-EU","FINLAND","GATWICK","KUUSAMO",4000,0,4000
2021,"WESTERN EUROPE-EU","FINLAND","GATWICK","ROVANIEMI",16893,6118,10775
2021,"WESTERN EUROPE-EU","FINLAND","HEATHROW","HELSINKI",141684,141684,0
2021,"WESTERN EUROPE-EU","FINLAND","HEATHROW","KITTILA",2007,0,2007
2021,"WESTERN EUROPE-EU","FINLAND","LUTON","IVALO",803,0,803
2021,"WESTERN EUROPE-EU","FINLAND","STANSTED","ENONTEKIO",1926,0,1926
2021,"WESTERN EUROPE-EU","FINLAND","STANSTED","HELSINKI",15326,15326,0
2021,"WESTERN EUROPE-EU","FINLAND","STANSTED","IVALO",2160,0,2160
2021,"WESTERN EUROPE-EU","FINLAND","STANSTED","KITTILA",240,0,240
2021,"WESTERN EUROPE-EU","FINLAND","STANSTED","KUUSAMO",2397,0,2397
2021,"WESTERN EUROPE-EU","FINLAND","STANSTED","ROVANIEMI",166,0,166
2021,"WESTERN EUROPE-EU","FINLAND","STANSTED","TAMPERE",2317,2317,0
2021,"WESTERN EUROPE-EU","FRANCE","GATWICK","BIARRITZ",0,0,0
2021,"WESTERN EUROPE-EU","FRANCE","GATWICK","BORDEAUX",25799,25799,0
2021,"WESTERN EUROPE-EU","FRANCE","GATWICK","CHAMBERY",1102,0,1102
2021,"WESTERN EUROPE-EU","FRANCE","GATWICK","CLERMONT FERRAND",0,0,0
2021,"WESTERN EUROPE-EU","FRANCE","GATWICK","FIGARI",1204,1204,0
2021,"WESTERN EUROPE-EU","FRANCE","GATWICK","GRENOBLE",1726,1308,418
2021,"WESTERN EUROPE-EU","FRANCE","GATWICK","LA ROCHELLE",0,0,0
2021,"WESTERN EUROPE-EU","FRANCE","GATWICK","LYON",24234,23890,344
2021,"WESTERN EUROPE-EU","FRANCE","GATWICK","LYON(BRON)",8,0,8
2021,"WESTERN EUROPE-EU","FRANCE","GATWICK","MARSEILLE",16632,16632,0
2021,"WESTERN EUROPE-EU","FRANCE","GATWICK","MONTPELLIER",17788,17788,0
2021,"WESTERN EUROPE-EU","FRANCE","GATWICK","NANTES",23635,23635,0
2021,"WESTERN EUROPE-EU","FRANCE","GATWICK","NICE",60569,60565,4
2021,"WESTERN EUROPE-EU","FRANCE","GATWICK","PARIS (CHARLES DE GAULLE)",40486,40486,0
2021,"WESTERN EUROPE-EU","FRANCE","GATWICK","PARIS (LE BOURGET)",2,0,2
2021,"WESTERN EUROPE-EU","FRANCE","GATWICK","PARIS (ORLY)",10468,10468,0
2021,"WESTERN EUROPE-EU","FRANCE","GATWICK","PAU",92,0,92
2021,"WESTERN EUROPE-EU","FRANCE","GATWICK","RENNES",0,0,0
2021,"WESTERN EUROPE-EU","FRANCE","GATWICK","TOULOUSE (BLAGNAC)",15731,15491,240
2021,"WESTERN EUROPE-EU","FRANCE","HEATHROW","BASTIA",183,183,0
2021,"WESTERN EUROPE-EU","FRANCE","HEATHROW","BORDEAUX",14475,14475,0
2021,"WESTERN EUROPE-EU","FRANCE","HEATHROW","CHATEAUROUX DEOLS",0,0,0
2021,"WESTERN EUROPE-EU","FRANCE","HEATHROW","FIGARI",2721,2721,0
2021,"WESTERN EUROPE-EU","FRANCE","HEATHROW","GRENOBLE",1138,1138,0
2021,"WESTERN EUROPE-EU","FRANCE","HEATHROW","LYON",37022,37022,0
2021,"WESTERN EUROPE-EU","FRANCE","HEATHROW","MARSEILLE",51798,51798,0
2021,"WESTERN EUROPE-EU","FRANCE","HEATHROW","MONTPELLIER",124,124,0
2021,"WESTERN EUROPE-EU","FRANCE","HEATHROW","NICE",197925,197403,522
2021,"WESTERN EUROPE-EU","FRANCE","HEATHROW","PARIS (CHARLES DE GAULLE)",342089,341998,91
2021,"WESTERN EUROPE-EU","FRANCE","HEATHROW","PARIS (LE BOURGET)",0,0,0
2021,"WESTERN EUROPE-EU","FRANCE","HEATHROW","PARIS (ORLY)",0,0,0
2021,"WESTERN EUROPE-EU","FRANCE","HEATHROW","TOULOUSE (BLAGNAC)",38750,38750,0
2021,"WESTERN EUROPE-EU","FRANCE","LONDON CITY","BERGERAC",2617,2617,0
2021,"WESTERN EUROPE-EU","FRANCE","LONDON CITY","CHAMBERY",0,0,0
2021,"WESTERN EUROPE-EU","FRANCE","LONDON CITY","GRENOBLE",0,0,0
2021,"WESTERN EUROPE-EU","FRANCE","LONDON CITY","NICE",15457,15457,0
2021,"WESTERN EUROPE-EU","FRANCE","LUTON","BEZIERS",7720,7720,0
2021,"WESTERN EUROPE-EU","FRANCE","LUTON","BIARRITZ",0,0,0
2021,"WESTERN EUROPE-EU","FRANCE","LUTON","BORDEAUX",631,631,0
2021,"WESTERN EUROPE-EU","FRANCE","LUTON","GRENOBLE",1215,1215,0
2021,"WESTERN EUROPE-EU","FRANCE","LUTON","LYON",4731,4731,0
2021,"WESTERN EUROPE-EU","FRANCE","LUTON","MARSEILLE",64,64,0
2021,"WESTERN EUROPE-EU","FRANCE","LUTON","MONTPELLIER",859,859,0
2021,"WESTERN EUROPE-EU","FRANCE","LUTON","NANTES",0,0,0
2021,"WESTERN EUROPE-EU","FRANCE","LUTON","NICE",8596,8596,0
2021,"WESTERN EUROPE-EU","FRANCE","LUTON","NIMES",0,0,0
2021,"WESTERN EUROPE-EU","FRANCE","LUTON","PARIS (CHARLES DE GAULLE)",21425,21425,0
2021,"WESTERN EUROPE-EU","FRANCE","LUTON","TOULOUSE (BLAGNAC)",160,0,160
2021,"WESTERN EUROPE-EU","FRANCE","SOUTHEND","BERGERAC",0,0,0
2021,"WESTERN EUROPE-EU","FRANCE","SOUTHEND","BREST",3979,3979,0
2021,"WESTERN EUROPE-EU","FRANCE","SOUTHEND","CAEN",0,0,0
2021,"WESTERN EUROPE-EU","FRANCE","SOUTHEND","MARSEILLE",0,0,0
2021,"WESTERN EUROPE-EU","FRANCE","SOUTHEND","PARIS (CHARLES DE GAULLE)",0,0,0
2021,"WESTERN EUROPE-EU","FRANCE","SOUTHEND","RENNES",0,0,0
2021,"WESTERN EUROPE-EU","FRANCE","STANSTED","BERGERAC",18668,18668,0
2021,"WESTERN EUROPE-EU","FRANCE","STANSTED","BEZIERS",4980,4980,0
2021,"WESTERN EUROPE-EU","FRANCE","STANSTED","BIARRITZ",28375,28375,0
2021,"WESTERN EUROPE-EU","FRANCE","STANSTED","BORDEAUX",26971,26935,36
2021,"WESTERN EUROPE-EU","FRANCE","STANSTED","BRIVE-LA-GAILLARDE",3814,3814,0
2021,"WESTERN EUROPE-EU","FRANCE","STANSTED","CARCASSONNE",13232,13232,0
2021,"WESTERN EUROPE-EU","FRANCE","STANSTED","CHAMBERY",193,0,193
2021,"WESTERN EUROPE-EU","FRANCE","STANSTED","DINARD",0,0,0
2021,"WESTERN EUROPE-EU","FRANCE","STANSTED","DOLE",93,93,0
2021,"WESTERN EUROPE-EU","FRANCE","STANSTED","GRENOBLE",643,643,0
2021,"WESTERN EUROPE-EU","FRANCE","STANSTED","LA ROCHELLE",11081,11081,0
2021,"WESTERN EUROPE-EU","FRANCE","STANSTED","LIMOGES",21381,21381,0
2021,"WESTERN EUROPE-EU","FRANCE","STANSTED","LYON",112,0,112
2021,"WESTERN EUROPE-EU","FRANCE","STANSTED","MARSEILLE",54236,54236,0
2021,"WESTERN EUROPE-EU","FRANCE","STANSTED","NANTES",11851,11851,0
2021,"WESTERN EUROPE-EU","FRANCE","STANSTED","NICE",3634,3634,0
2021,"WESTERN EUROPE-EU","FRANCE","STANSTED","NIMES",6185,6185,0
2021,"WESTERN EUROPE-EU","FRANCE","STANSTED","PARIS (CHARLES DE GAULLE)",0,0,0
2021,"WESTERN EUROPE-EU","FRANCE","STANSTED","PERPIGNAN",6254,6254,0
2021,"WESTERN EUROPE-EU","FRANCE","STANSTED","POITIERS",11226,11226,0
2021,"WESTERN EUROPE-EU","FRANCE","STANSTED","RODEZ",1708,1708,0
2021,"WESTERN EUROPE-EU","FRANCE","STANSTED","TARBES-LOURDES INTERNATIONAL",8111,8111,0
2021,"WESTERN EUROPE-EU","FRANCE","STANSTED","TOULOUSE (BLAGNAC)",37072,37072,0
2021,"WESTERN EUROPE-EU","FRANCE","STANSTED","TOURS",2820,2820,0
2021,"WESTERN EUROPE-EU","GERMANY","GATWICK","BERLIN (TEGEL)",0,0,0
2021,"WESTERN EUROPE-EU","GERMANY","GATWICK","BERLIN BRANDENBURG",55992,55992,0
2021,"WESTERN EUROPE-EU","GERMANY","GATWICK","BRAUNSCHWEIG",83,0,83
2021,"WESTERN EUROPE-EU","GERMANY","GATWICK","COLOGNE BONN",0,0,0
2021,"WESTERN EUROPE-EU","GERMANY","GATWICK","DUSSELDORF",0,0,0
2021,"WESTERN EUROPE-EU","GERMANY","GATWICK","FRANKFURT MAIN",573,0,573
2021,"WESTERN EUROPE-EU","GERMANY","GATWICK","FRIEDRICHSHAFEN",161,161,0
2021,"WESTERN EUROPE-EU","GERMANY","GATWICK","HAMBURG",6979,6979,0
2021,"WESTERN EUROPE-EU","GERMANY","GATWICK","HANOVER",0,0,0
2021,"WESTERN EUROPE-EU","GERMANY","GATWICK","LEIPZIG",0,0,0
2021,"WESTERN EUROPE-EU","GERMANY","GATWICK","MUNICH",16927,16882,45
2021,"WESTERN EUROPE-EU","GERMANY","GATWICK","NUREMBERG",0,0,0
2021,"WESTERN EUROPE-EU","GERMANY","GATWICK","STUTTGART",0,0,0
2021,"WESTERN EUROPE-EU","GERMANY","HEATHROW","BERLIN (TEGEL)",0,0,0
2021,"WESTERN EUROPE-EU","GERMANY","HEATHROW","BERLIN BRANDENBURG",115625,115258,367
2021,"WESTERN EUROPE-EU","GERMANY","HEATHROW","COLOGNE BONN",13264,13264,0
2021,"WESTERN EUROPE-EU","GERMANY","HEATHROW","DUSSELDORF",85072,85072,0
2021,"WESTERN EUROPE-EU","GERMANY","HEATHROW","FRANKFURT MAIN",314745,314647,98
2021,"WESTERN EUROPE-EU","GERMANY","HEATHROW","FRIEDRICHSHAFEN",0,0,0
2021,"WESTERN EUROPE-EU","GERMANY","HEATHROW","HAMBURG",75620,75602,18
2021,"WESTERN EUROPE-EU","GERMANY","HEATHROW","HANOVER",9208,9208,0
2021,"WESTERN EUROPE-EU","GERMANY","HEATHROW","MUNICH",201723,201654,69
2021,"WESTERN EUROPE-EU","GERMANY","HEATHROW","STUTTGART",36557,36557,0
2021,"WESTERN EUROPE-EU","GERMANY","LONDON CITY","BERLIN (TEGEL)",0,0,0
2021,"WESTERN EUROPE-EU","GERMANY","LONDON CITY","BERLIN BRANDENBURG",25771,25771,0
2021,"WESTERN EUROPE-EU","GERMANY","LONDON CITY","DUSSELDORF",22385,22385,0
2021,"WESTERN EUROPE-EU","GERMANY","LONDON CITY","FRANKFURT MAIN",39643,39643,0
2021,"WESTERN EUROPE-EU","GERMANY","LONDON CITY","MUNICH",0,0,0
2021,"WESTERN EUROPE-EU","GERMANY","LUTON","BERLIN BRANDENBURG",7140,7140,0
2021,"WESTERN EUROPE-EU","GERMANY","LUTON","DORTMUND",0,0,0
2021,"WESTERN EUROPE-EU","GERMANY","LUTON","MUNICH",0,0,0
2021,"WESTERN EUROPE-EU","GERMANY","LUTON","NIEDERRHEIN",119,0,119
2021,"WESTERN EUROPE-EU","GERMANY","LUTON","NUREMBERG",245,245,0
2021,"WESTERN EUROPE-EU","GERMANY","LUTON","STUTTGART",97,97,0
2021,"WESTERN EUROPE-EU","GERMANY","STANSTED","BERLIN (TEGEL)",0,0,0
2021,"WESTERN EUROPE-EU","GERMANY","STANSTED","BERLIN BRANDENBURG",100741,100741,0
2021,"WESTERN EUROPE-EU","GERMANY","STANSTED","BREMEN",13253,13253,0
2021,"WESTERN EUROPE-EU","GERMANY","STANSTED","COLOGNE BONN",71380,71380,0
2021,"WESTERN EUROPE-EU","GERMANY","STANSTED","DORTMUND",6979,6979,0
2021,"WESTERN EUROPE-EU","GERMANY","STANSTED","DRESDEN",949,949,0
2021,"WESTERN EUROPE-EU","GERMANY","STANSTED","DUSSELDORF",0,0,0
2021,"WESTERN EUROPE-EU","GERMANY","STANSTED","FRANKFURT MAIN",58155,58155,0
2021,"WESTERN EUROPE-EU","GERMANY","STANSTED","FRIEDRICHSHAFEN",0,0,0
2021,"WESTERN EUROPE-EU","GERMANY","STANSTED","HAMBURG",43650,43650,0
2021,"WESTERN EUROPE-EU","GERMANY","STANSTED","HANOVER",0,0,0
2021,"WESTERN EUROPE-EU","GERMANY","STANSTED","KARLSRUHE/BADEN BADEN",14785,14785,0
2021,"WESTERN EUROPE-EU","GERMANY","STANSTED","LEIPZIG",0,0,0
2021,"WESTERN EUROPE-EU","GERMANY","STANSTED","MEMMINGEN ALLGAU",15974,15974,0
2021,"WESTERN EUROPE-EU","GERMANY","STANSTED","MUNICH",0,0,0
2021,"WESTERN EUROPE-EU","GERMANY","STANSTED","NUREMBERG",11250,11250,0
2021,"WESTERN EUROPE-EU","GIBRALTAR","GATWICK","GIBRALTAR",73207,73207,0
2021,"WESTERN EUROPE-EU","GIBRALTAR","HEATHROW","GIBRALTAR",102770,102770,0
2021,"WESTERN EUROPE-EU","GIBRALTAR","LONDON CITY","GIBRALTAR",3078,3078,0
2021,"WESTERN EUROPE-EU","GIBRALTAR","LUTON","GIBRALTAR",11255,11255,0
2021,"WESTERN EUROPE-EU","GIBRALTAR","SOUTHEND","GIBRALTAR",0,0,0
2021,"WESTERN EUROPE-EU","GIBRALTAR","STANSTED","GIBRALTAR",149,0,149
2021,"WESTERN EUROPE-EU","GREECE","GATWICK","ATHENS",54955,54955,0
2021,"WESTERN EUROPE-EU","GREECE","GATWICK","CHANIA",35984,28476,7508
2021,"WESTERN EUROPE-EU","GREECE","GATWICK","CORFU",63193,48751,14442
2021,"WESTERN EUROPE-EU","GREECE","GATWICK","HERAKLION",61598,39804,21794
2021,"WESTERN EUROPE-EU","GREECE","GATWICK","KALAMATA",13061,8789,4272
2021,"WESTERN EUROPE-EU","GREECE","GATWICK","KAVALA",1591,0,1591
2021,"WESTERN EUROPE-EU","GREECE","GATWICK","KEFALLINIA",31098,26787,4311
2021,"WESTERN EUROPE-EU","GREECE","GATWICK","KOS",37017,11469,25548
2021,"WESTERN EUROPE-EU","GREECE","GATWICK","LEMNOS",1908,0,1908
2021,"WESTERN EUROPE-EU","GREECE","GATWICK","MIKONOS",23721,23721,0
2021,"WESTERN EUROPE-EU","GREECE","GATWICK","NEA ANCHIALOS",3104,3104,0
2021,"WESTERN EUROPE-EU","GREECE","GATWICK","PREVEZA",27770,18630,9140
2021,"WESTERN EUROPE-EU","GREECE","GATWICK","RHODES",67837,37939,29898
2021,"WESTERN EUROPE-EU","GREECE","GATWICK","SALONIKA",29939,27427,2512
2021,"WESTERN EUROPE-EU","GREECE","GATWICK","SAMOS",1452,0,1452
2021,"WESTERN EUROPE-EU","GREECE","GATWICK","SKIATHOS",7736,0,7736
2021,"WESTERN EUROPE-EU","GREECE","GATWICK","THIRA (SANTORINI)",25739,23524,2215
2021,"WESTERN EUROPE-EU","GREECE","GATWICK","VOLOS NEA ANCHILOS",0,0,0
2021,"WESTERN EUROPE-EU","GREECE","GATWICK","ZAKINTHOS",34065,19957,14108
2021,"WESTERN EUROPE-EU","GREECE","HEATHROW","ATHENS",369812,369717,95
2021,"WESTERN EUROPE-EU","GREECE","HEATHROW","CHANIA",28938,28938,0
2021,"WESTERN EUROPE-EU","GREECE","HEATHROW","CORFU",66134,66134,0
2021,"WESTERN EUROPE-EU","GREECE","HEATHROW","HERAKLION",36239,36239,0
2021,"WESTERN EUROPE-EU","GREECE","HEATHROW","KALAMATA",14715,14715,0
2021,"WESTERN EUROPE-EU","GREECE","HEATHROW","KEFALLINIA",12855,12855,0
2021,"WESTERN EUROPE-EU","GREECE","HEATHROW","KOS",17827,17827,0
2021,"WESTERN EUROPE-EU","GREECE","HEATHROW","MIKONOS",43499,43499,0
2021,"WESTERN EUROPE-EU","GREECE","HEATHROW","PREVEZA",21061,18413,2648
2021,"WESTERN EUROPE-EU","GREECE","HEATHROW","RHODES",22834,22834,0
2021,"WESTERN EUROPE-EU","GREECE","HEATHROW","SALONIKA",48107,48107,0
2021,"WESTERN EUROPE-EU","GREECE","HEATHROW","THIRA (SANTORINI)",40531,40531,0
2021,"WESTERN EUROPE-EU","GREECE","HEATHROW","ZAKINTHOS",7387,7387,0
2021,"WESTERN EUROPE-EU","GREECE","LONDON CITY","MIKONOS",9047,9047,0
2021,"WESTERN EUROPE-EU","GREECE","LONDON CITY","SKIATHOS",3844,3844,0
2021,"WESTERN EUROPE-EU","GREECE","LUTON","ATHENS",61182,61182,0
2021,"WESTERN EUROPE-EU","GREECE","LUTON","CORFU",21790,21790,0
2021,"WESTERN EUROPE-EU","GREECE","LUTON","HERAKLION",18926,18926,0
2021,"WESTERN EUROPE-EU","GREECE","LUTON","MIKONOS",5871,5871,0
2021,"WESTERN EUROPE-EU","GREECE","LUTON","RHODES",17734,10283,7451
2021,"WESTERN EUROPE-EU","GREECE","LUTON","SALONIKA",15356,15356,0
2021,"WESTERN EUROPE-EU","GREECE","LUTON","THIRA (SANTORINI)",7627,7627,0
2021,"WESTERN EUROPE-EU","GREECE","LUTON","ZAKINTHOS",10282,10282,0
2021,"WESTERN EUROPE-EU","GREECE","SOUTHEND","CORFU",11009,11009,0
2021,"WESTERN EUROPE-EU","GREECE","SOUTHEND","KAVALA",42,42,0
2021,"WESTERN EUROPE-EU","GREECE","STANSTED","ATHENS",70981,70981,0
2021,"WESTERN EUROPE-EU","GREECE","STANSTED","CHANIA",28056,28056,0
2021,"WESTERN EUROPE-EU","GREECE","STANSTED","CORFU",23513,23513,0
2021,"WESTERN EUROPE-EU","GREECE","STANSTED","HERAKLION",22732,16584,6148
2021,"WESTERN EUROPE-EU","GREECE","STANSTED","KALAMATA",3464,3464,0
2021,"WESTERN EUROPE-EU","GREECE","STANSTED","KEFALLINIA",15974,13604,2370
2021,"WESTERN EUROPE-EU","GREECE","STANSTED","KOS",10653,10653,0
2021,"WESTERN EUROPE-EU","GREECE","STANSTED","MYTILINI",4053,2003,2050
2021,"WESTERN EUROPE-EU","GREECE","STANSTED","PREVEZA",10142,10142,0
2021,"WESTERN EUROPE-EU","GREECE","STANSTED","RHODES",52360,43210,9150
2021,"WESTERN EUROPE-EU","GREECE","STANSTED","SALONIKA",51777,51765,12
2021,"WESTERN EUROPE-EU","GREECE","STANSTED","SKIATHOS",5296,5296,0
2021,"WESTERN EUROPE-EU","GREECE","STANSTED","THIRA (SANTORINI)",12103,12103,0
2021,"WESTERN EUROPE-EU","GREECE","STANSTED","ZAKINTHOS",19105,17359,1746
2021,"WESTERN EUROPE-EU","IRISH REPUBLIC","GATWICK","CORK",6126,6126,0
2021,"WESTERN EUROPE-EU","IRISH REPUBLIC","GATWICK","DUBLIN",319909,319850,59
2021,"WESTERN EUROPE-EU","IRISH REPUBLIC","GATWICK","IRELAND WEST(KNOCK)",2115,2115,0
2021,"WESTERN EUROPE-EU","IRISH REPUBLIC","GATWICK","SHANNON",33642,33529,113
2021,"WESTERN EUROPE-EU","IRISH REPUBLIC","HEATHROW","CORK",52235,52235,0
2021,"WESTERN EUROPE-EU","IRISH REPUBLIC","HEATHROW","DUBLIN",403547,403297,250
2021,"WESTERN EUROPE-EU","IRISH REPUBLIC","HEATHROW","SHANNON",24105,24105,0
2021,"WESTERN EUROPE-EU","IRISH REPUBLIC","LONDON CITY","DUBLIN",53442,53442,0
2021,"WESTERN EUROPE-EU","IRISH REPUBLIC","LUTON","CORK",17681,17681,0
2021,"WESTERN EUROPE-EU","IRISH REPUBLIC","LUTON","DUBLIN",85110,85110,0
2021,"WESTERN EUROPE-EU","IRISH REPUBLIC","LUTON","IRELAND WEST(KNOCK)",38084,38084,0
2021,"WESTERN EUROPE-EU","IRISH REPUBLIC","LUTON","KERRY COUNTY",35166,35166,0
2021,"WESTERN EUROPE-EU","IRISH REPUBLIC","LUTON","SHANNON",6065,6065,0
2021,"WESTERN EUROPE-EU","IRISH REPUBLIC","SOUTHEND","DUBLIN",0,0,0
2021,"WESTERN EUROPE-EU","IRISH REPUBLIC","STANSTED","CORK",40658,40658,0
2021,"WESTERN EUROPE-EU","IRISH REPUBLIC","STANSTED","DUBLIN",308546,308546,0
2021,"WESTERN EUROPE-EU","IRISH REPUBLIC","STANSTED","IRELAND WEST(KNOCK)",36506,36506,0
2021,"WESTERN EUROPE-EU","IRISH REPUBLIC","STANSTED","KERRY COUNTY",24259,24259,0
2021,"WESTERN EUROPE-EU","IRISH REPUBLIC","STANSTED","SHANNON",63554,63548,6
2021,"WESTERN EUROPE-EU","ITALY","GATWICK","ANCONA",0,0,0
2021,"WESTERN EUROPE-EU","ITALY","GATWICK","BARI (PALESE)",3747,3747,0
2021,"WESTERN EUROPE-EU","ITALY","GATWICK","BERGAMO",2536,2493,43
2021,"WESTERN EUROPE-EU","ITALY","GATWICK","BOLOGNA",140,140,0
2021,"WESTERN EUROPE-EU","ITALY","GATWICK","CAGLIARI (ELMAS)",1273,1273,0
2021,"WESTERN EUROPE-EU","ITALY","GATWICK","CATANIA (FONTANAROSSA)",22126,22126,0
2021,"WESTERN EUROPE-EU","ITALY","GATWICK","FLORENCE",21265,21265,0
2021,"WESTERN EUROPE-EU","ITALY","GATWICK","GENOA",0,0,0
2021,"WESTERN EUROPE-EU","ITALY","GATWICK","MILAN (LINATE)",16905,16905,0
2021,"WESTERN EUROPE-EU","ITALY","GATWICK","MILAN (MALPENSA)",62005,61635,370
2021,"WESTERN EUROPE-EU","ITALY","GATWICK","NAPLES",26495,26495,0
2021,"WESTERN EUROPE-EU","ITALY","GATWICK","OLBIA",11793,11623,170
2021,"WESTERN EUROPE-EU","ITALY","GATWICK","PALERMO",2886,2886,0
2021,"WESTERN EUROPE-EU","ITALY","GATWICK","PISA",17867,17867,0
2021,"WESTERN EUROPE-EU","ITALY","GATWICK","ROME (CIAMPINO)",90,0,90
2021,"WESTERN EUROPE-EU","ITALY","GATWICK","ROME (FIUMICINO)",46743,46343,400
2021,"WESTERN EUROPE-EU","ITALY","GATWICK","TURIN",4234,2350,1884
2021,"WESTERN EUROPE-EU","ITALY","GATWICK","VENICE",18538,18538,0
2021,"WESTERN EUROPE-EU","ITALY","GATWICK","VERONA VILLAFRANCA",8990,8485,505
2021,"WESTERN EUROPE-EU","ITALY","HEATHROW","BARI (PALESE)",6406,6406,0
2021,"WESTERN EUROPE-EU","ITALY","HEATHROW","BERGAMO",11,0,11
2021,"WESTERN EUROPE-EU","ITALY","HEATHROW","BOLOGNA",29723,29651,72
2021,"WESTERN EUROPE-EU","ITALY","HEATHROW","BRINDISI",0,0,0
2021,"WESTERN EUROPE-EU","ITALY","HEATHROW","CAGLIARI (ELMAS)",0,0,0
2021,"WESTERN EUROPE-EU","ITALY","HEATHROW","CATANIA (FONTANAROSSA)",9651,9473,178
2021,"WESTERN EUROPE-EU","ITALY","HEATHROW","GENOA",0,0,0
2021,"WESTERN EUROPE-EU","ITALY","HEATHROW","MILAN (LINATE)",160191,160191,0
2021,"WESTERN EUROPE-EU","ITALY","HEATHROW","MILAN (MALPENSA)",41956,41275,681
2021,"WESTERN EUROPE-EU","ITALY","HEATHROW","NAPLES",40833,40737,96
2021,"WESTERN EUROPE-EU","ITALY","HEATHROW","OLBIA",0,0,0
2021,"WESTERN EUROPE-EU","ITALY","HEATHROW","PALERMO",1758,1593,165
2021,"WESTERN EUROPE-EU","ITALY","HEATHROW","PISA",32516,32516,0
2021,"WESTERN EUROPE-EU","ITALY","HEATHROW","RIMINI",88,0,88
2021,"WESTERN EUROPE-EU","ITALY","HEATHROW","ROME (FIUMICINO)",191253,190943,310
2021,"WESTERN EUROPE-EU","ITALY","HEATHROW","TURIN",3382,3174,208
2021,"WESTERN EUROPE-EU","ITALY","HEATHROW","VENICE",68228,68228,0
2021,"WESTERN EUROPE-EU","ITALY","HEATHROW","VERONA VILLAFRANCA",1023,1023,0
2021,"WESTERN EUROPE-EU","ITALY","LONDON CITY","BOLOGNA",0,0,0
2021,"WESTERN EUROPE-EU","ITALY","LONDON CITY","FLORENCE",17999,17999,0
2021,"WESTERN EUROPE-EU","ITALY","LONDON CITY","MILAN (LINATE)",0,0,0
2021,"WESTERN EUROPE-EU","ITALY","LONDON CITY","PISA",0,0,0
2021,"WESTERN EUROPE-EU","ITALY","LONDON CITY","ROME (FIUMICINO)",0,0,0
2021,"WESTERN EUROPE-EU","ITALY","LUTON","ALGHERO (FERTILIA)",0,0,0
2021,"WESTERN EUROPE-EU","ITALY","LUTON","BOLOGNA",10335,10335,0
2021,"WESTERN EUROPE-EU","ITALY","LUTON","CATANIA (FONTANAROSSA)",10552,10552,0
2021,"WESTERN EUROPE-EU","ITALY","LUTON","FLORENCE",0,0,0
2021,"WESTERN EUROPE-EU","ITALY","LUTON","MILAN (MALPENSA)",46496,46496,0
2021,"WESTERN EUROPE-EU","ITALY","LUTON","NAPLES",28529,28529,0
2021,"WESTERN EUROPE-EU","ITALY","LUTON","OLBIA",0,0,0
2021,"WESTERN EUROPE-EU","ITALY","LUTON","PALERMO",8269,8269,0
2021,"WESTERN EUROPE-EU","ITALY","LUTON","PISA",95,95,0
2021,"WESTERN EUROPE-EU","ITALY","LUTON","RIMINI",295,0,295
2021,"WESTERN EUROPE-EU","ITALY","LUTON","ROME (FIUMICINO)",15017,14779,238
2021,"WESTERN EUROPE-EU","ITALY","LUTON","TURIN",594,594,0
2021,"WESTERN EUROPE-EU","ITALY","LUTON","VENICE",0,0,0
2021,"WESTERN EUROPE-EU","ITALY","SOUTHEND","BERGAMO",0,0,0
2021,"WESTERN EUROPE-EU","ITALY","SOUTHEND","TREVISO",0,0,0
2021,"WESTERN EUROPE-EU","ITALY","SOUTHEND","TURIN",0,0,0
2021,"WESTERN EUROPE-EU","ITALY","SOUTHEND","VENICE",0,0,0
2021,"WESTERN EUROPE-EU","ITALY","SOUTHEND","VERONA VILLAFRANCA",0,0,0
2021,"WESTERN EUROPE-EU","ITALY","STANSTED","ALGHERO (FERTILIA)",10038,10038,0
2021,"WESTERN EUROPE-EU","ITALY","STANSTED","ANCONA",25720,25720,0
2021,"WESTERN EUROPE-EU","ITALY","STANSTED","BARI (PALESE)",41572,41572,0
2021,"WESTERN EUROPE-EU","ITALY","STANSTED","BERGAMO",125359,125359,0
2021,"WESTERN EUROPE-EU","ITALY","STANSTED","BOLOGNA",48416,48416,0
2021,"WESTERN EUROPE-EU","ITALY","STANSTED","BRINDISI",22872,22872,0
2021,"WESTERN EUROPE-EU","ITALY","STANSTED","CAGLIARI (ELMAS)",16973,16973,0
2021,"WESTERN EUROPE-EU","ITALY","STANSTED","GENOA",20228,20228,0
2021,"WESTERN EUROPE-EU","ITALY","STANSTED","LAMETIA-TERME",16527,16527,0
2021,"WESTERN EUROPE-EU","ITALY","STANSTED","MILAN (MALPENSA)",74845,74845,0
2021,"WESTERN EUROPE-EU","ITALY","STANSTED","NAPLES",52859,52859,0
2021,"WESTERN EUROPE-EU","ITALY","STANSTED","PALERMO",44772,44772,0
2021,"WESTERN EUROPE-EU","ITALY","STANSTED","PERUGIA",22837,22837,0
2021,"WESTERN EUROPE-EU","ITALY","STANSTED","PESCARA",24831,24831,0
2021,"WESTERN EUROPE-EU","ITALY","STANSTED","PISA",63039,63039,0
2021,"WESTERN EUROPE-EU","ITALY","STANSTED","RIMINI",4522,4522,0
2021,"WESTERN EUROPE-EU","ITALY","STANSTED","ROME (CIAMPINO)",120411,120411,0
2021,"WESTERN EUROPE-EU","ITALY","STANSTED","ROME (FIUMICINO)",542,542,0
2021,"WESTERN EUROPE-EU","ITALY","STANSTED","TRAPANI",612,612,0
2021,"WESTERN EUROPE-EU","ITALY","STANSTED","TREVISO",32153,32153,0
2021,"WESTERN EUROPE-EU","ITALY","STANSTED","TRIESTE (RONCHI DEI LEGIONARI)",13445,13445,0
2021,"WESTERN EUROPE-EU","ITALY","STANSTED","TURIN",40948,40501,447
2021,"WESTERN EUROPE-EU","ITALY","STANSTED","VENICE",64827,64827,0
2021,"WESTERN EUROPE-EU","ITALY","STANSTED","VERONA VILLAFRANCA",15866,15866,0
2021,"WESTERN EUROPE-EU","LUXEMBOURG","GATWICK","LUXEMBOURG",0,0,0
2021,"WESTERN EUROPE-EU","LUXEMBOURG","HEATHROW","LUXEMBOURG",7878,7878,0
2021,"WESTERN EUROPE-EU","LUXEMBOURG","LONDON CITY","LUXEMBOURG",23598,23598,0
2021,"WESTERN EUROPE-EU","LUXEMBOURG","LUTON","LUXEMBOURG",0,0,0
2021,"WESTERN EUROPE-EU","LUXEMBOURG","STANSTED","LUXEMBOURG",27374,27276,98
2021,"WESTERN EUROPE-EU","MALTA","GATWICK","MALTA",65142,64006,1136
2021,"WESTERN EUROPE-EU","MALTA","HEATHROW","MALTA",123237,122505,732
2021,"WESTERN EUROPE-EU","MALTA","LUTON","MALTA",48621,48621,0
2021,"WESTERN EUROPE-EU","MALTA","SOUTHEND","MALTA",0,0,0
2021,"WESTERN EUROPE-EU","MALTA","STANSTED","MALTA",50448,50448,0
2021,"WESTERN EUROPE-EU","NETHERLANDS","GATWICK","AMSTERDAM",51462,51459,3
2021,"WESTERN EUROPE-EU","NETHERLANDS","HEATHROW","AMSTERDAM",350659,350659,0
2021,"WESTERN EUROPE-EU","NETHERLANDS","LONDON CITY","AMSTERDAM",81750,81750,0
2021,"WESTERN EUROPE-EU","NETHERLANDS","LONDON CITY","ROTTERDAM",6407,6407,0
2021,"WESTERN EUROPE-EU","NETHERLANDS","LUTON","AMSTERDAM",51422,51422,0
2021,"WESTERN EUROPE-EU","NETHERLANDS","SOUTHEND","AMSTERDAM",0,0,0
2021,"WESTERN EUROPE-EU","NETHERLANDS","SOUTHEND","GRONINGEN",0,0,0
2021,"WESTERN EUROPE-EU","NETHERLANDS","STANSTED","AMSTERDAM",24611,24604,7
2021,"WESTERN EUROPE-EU","NETHERLANDS","STANSTED","EINDHOVEN",41667,41667,0
2021,"WESTERN EUROPE-EU","NETHERLANDS","STANSTED","MAASTRICHT",48,0,48
2021,"WESTERN EUROPE-EU","PORTUGAL(EXCLUDING MADEIRA)","GATWICK","AZORES PONTA DELGADA",0,0,0
2021,"WESTERN EUROPE-EU","PORTUGAL(EXCLUDING MADEIRA)","GATWICK","FARO",147279,135361,11918
2021,"WESTERN EUROPE-EU","PORTUGAL(EXCLUDING MADEIRA)","GATWICK","LISBON",79064,78979,85
2021,"WESTERN EUROPE-EU","PORTUGAL(EXCLUDING MADEIRA)","GATWICK","OPORTO (PORTUGAL)",72964,68325,4639
2021,"WESTERN EUROPE-EU","PORTUGAL(EXCLUDING MADEIRA)","HEATHROW","FARO",128455,128062,393
2021,"WESTERN EUROPE-EU","PORTUGAL(EXCLUDING MADEIRA)","HEATHROW","LISBON",300798,300798,0
2021,"WESTERN EUROPE-EU","PORTUGAL(EXCLUDING MADEIRA)","HEATHROW","OPORTO (PORTUGAL)",23706,23536,170
2021,"WESTERN EUROPE-EU","PORTUGAL(EXCLUDING MADEIRA)","LONDON CITY","FARO",4675,4675,0
2021,"WESTERN EUROPE-EU","PORTUGAL(EXCLUDING MADEIRA)","LUTON","AZORES PONTA DELGADA",206,206,0
2021,"WESTERN EUROPE-EU","PORTUGAL(EXCLUDING MADEIRA)","LUTON","FARO",91770,91604,166
2021,"WESTERN EUROPE-EU","PORTUGAL(EXCLUDING MADEIRA)","LUTON","LISBON",79409,79409,0
2021,"WESTERN EUROPE-EU","PORTUGAL(EXCLUDING MADEIRA)","LUTON","OPORTO (PORTUGAL)",21306,21258,48
2021,"WESTERN EUROPE-EU","PORTUGAL(EXCLUDING MADEIRA)","SOUTHEND","FARO",5141,5141,0
2021,"WESTERN EUROPE-EU","PORTUGAL(EXCLUDING MADEIRA)","STANSTED","AZORES LAJES TERCEIRA ISLAND",0,0,0
2021,"WESTERN EUROPE-EU","PORTUGAL(EXCLUDING MADEIRA)","STANSTED","AZORES PONTA DELGADA",6533,6533,0
2021,"WESTERN EUROPE-EU","PORTUGAL(EXCLUDING MADEIRA)","STANSTED","FARO",134232,133707,525
2021,"WESTERN EUROPE-EU","PORTUGAL(EXCLUDING MADEIRA)","STANSTED","LISBON",188263,188263,0
2021,"WESTERN EUROPE-EU","PORTUGAL(EXCLUDING MADEIRA)","STANSTED","OPORTO (PORTUGAL)",130214,130214,0
2021,"WESTERN EUROPE-EU","PORTUGAL(MADEIRA)","GATWICK","FUNCHAL",87208,74472,12736
2021,"WESTERN EUROPE-EU","PORTUGAL(MADEIRA)","GATWICK","PORTO SANTO",6018,118,5900
2021,"WESTERN EUROPE-EU","PORTUGAL(MADEIRA)","HEATHROW","FUNCHAL",56534,56534,0
2021,"WESTERN EUROPE-EU","PORTUGAL(MADEIRA)","LUTON","FUNCHAL",18673,18673,0
2021,"WESTERN EUROPE-EU","PORTUGAL(MADEIRA)","STANSTED","FUNCHAL",19479,19479,0
2021,"WESTERN EUROPE-EU","SLOVENIA","GATWICK","LJUBLJANA",9200,9200,0
2021,"WESTERN EUROPE-EU","SLOVENIA","HEATHROW","LJUBLJANA",8717,8717,0
2021,"WESTERN EUROPE-EU","SLOVENIA","LUTON","LJUBLJANA",1425,1425,0
2021,"WESTERN EUROPE-EU","SLOVENIA","SOUTHEND","LJUBLJANA",0,0,0
2021,"WESTERN EUROPE-EU","SLOVENIA","STANSTED","LJUBLJANA",67,0,67
2021,"WESTERN EUROPE-EU","SLOVENIA","STANSTED","MARIBOR",100,0,100
2021,"WESTERN EUROPE-EU","SPAIN","GATWICK","ALICANTE",170002,169576,426
2021,"WESTERN EUROPE-EU","SPAIN","GATWICK","ALMERIA",19801,19801,0
2021,"WESTERN EUROPE-EU","SPAIN","GATWICK","ASTURIAS",1182,823,359
2021,"WESTERN EUROPE-EU","SPAIN","GATWICK","BARCELONA",172593,172205,388
2021,"WESTERN EUROPE-EU","SPAIN","GATWICK","BILBAO",29751,29751,0
2021,"WESTERN EUROPE-EU","SPAIN","GATWICK","GRANADA",0,0,0
2021,"WESTERN EUROPE-EU","SPAIN","GATWICK","IBIZA",66583,48639,17944
2021,"WESTERN EUROPE-EU","SPAIN","GATWICK","MADRID",144165,143701,464
2021,"WESTERN EUROPE-EU","SPAIN","GATWICK","MAHON",54980,44417,10563
2021,"WESTERN EUROPE-EU","SPAIN","GATWICK","MALAGA",145676,138690,6986
2021,"WESTERN EUROPE-EU","SPAIN","GATWICK","MURCIA INTERNATIONAL",44759,44759,0
2021,"WESTERN EUROPE-EU","SPAIN","GATWICK","PALMA DE MALLORCA",152286,121177,31109
2021,"WESTERN EUROPE-EU","SPAIN","GATWICK","REUS",849,0,849
2021,"WESTERN EUROPE-EU","SPAIN","GATWICK","SANTIAGO DE COMPOSTELA (SPAIN)",13947,13947,0
2021,"WESTERN EUROPE-EU","SPAIN","GATWICK","SEVILLE",15147,15090,57
2021,"WESTERN EUROPE-EU","SPAIN","GATWICK","VALENCIA",45771,45771,0
2021,"WESTERN EUROPE-EU","SPAIN","HEATHROW","A CORUNA",0,0,0
2021,"WESTERN EUROPE-EU","SPAIN","HEATHROW","ALICANTE",38509,38509,0
2021,"WESTERN EUROPE-EU","SPAIN","HEATHROW","BARCELONA",170837,170837,0
2021,"WESTERN EUROPE-EU","SPAIN","HEATHROW","BILBAO",7784,7784,0
2021,"WESTERN EUROPE-EU","SPAIN","HEATHROW","IBIZA",97874,97874,0
2021,"WESTERN EUROPE-EU","SPAIN","HEATHROW","MADRID",425759,425650,109
2021,"WESTERN EUROPE-EU","SPAIN","HEATHROW","MAHON",16466,16466,0
2021,"WESTERN EUROPE-EU","SPAIN","HEATHROW","MALAGA",168817,168636,181
2021,"WESTERN EUROPE-EU","SPAIN","HEATHROW","PALMA DE MALLORCA",128802,128722,80
2021,"WESTERN EUROPE-EU","SPAIN","HEATHROW","SEVILLE",13859,13726,133
2021,"WESTERN EUROPE-EU","SPAIN","HEATHROW","VALENCIA",21591,21225,366
2021,"WESTERN EUROPE-EU","SPAIN","LONDON CITY","IBIZA",36026,36026,0
2021,"WESTERN EUROPE-EU","SPAIN","LONDON CITY","MAHON",3088,3088,0
2021,"WESTERN EUROPE-EU","SPAIN","LONDON CITY","MALAGA",24512,24512,0
2021,"WESTERN EUROPE-EU","SPAIN","LONDON CITY","PALMA DE MALLORCA",21921,21826,95
2021,"WESTERN EUROPE-EU","SPAIN","LUTON","ALICANTE",84662,84662,0
2021,"WESTERN EUROPE-EU","SPAIN","LUTON","BARCELONA",32528,32353,175
2021,"WESTERN EUROPE-EU","SPAIN","LUTON","CASTELLON COSTA AZAHAR",0,0,0
2021,"WESTERN EUROPE-EU","SPAIN","LUTON","CASTELLON DE LA PLANA AIRPORT",0,0,0
2021,"WESTERN EUROPE-EU","SPAIN","LUTON","GIRONA",4945,4945,0
2021,"WESTERN EUROPE-EU","SPAIN","LUTON","IBIZA",17276,17276,0
2021,"WESTERN EUROPE-EU","SPAIN","LUTON","MADRID",308,68,240
2021,"WESTERN EUROPE-EU","SPAIN","LUTON","MAHON",12853,12853,0
2021,"WESTERN EUROPE-EU","SPAIN","LUTON","MALAGA",127885,127885,0
2021,"WESTERN EUROPE-EU","SPAIN","LUTON","MURCIA INTERNATIONAL",0,0,0
2021,"WESTERN EUROPE-EU","SPAIN","LUTON","PALMA DE MALLORCA",94056,87752,6304
2021,"WESTERN EUROPE-EU","SPAIN","LUTON","REUS",0,0,0
2021,"WESTERN EUROPE-EU","SPAIN","LUTON","SEVILLE",4090,4090,0
2021,"WESTERN EUROPE-EU","SPAIN","LUTON","VALENCIA",0,0,0
2021,"WESTERN EUROPE-EU","SPAIN","SOUTHEND","ALICANTE",19819,19819,0
2021,"WESTERN EUROPE-EU","SPAIN","SOUTHEND","BARCELONA",0,0,0
2021,"WESTERN EUROPE-EU","SPAIN","SOUTHEND","BILBAO",0,0,0
2021,"WESTERN EUROPE-EU","SPAIN","SOUTHEND","GIRONA",0,0,0
2021,"WESTERN EUROPE-EU","SPAIN","SOUTHEND","IBIZA",0,0,0
2021,"WESTERN EUROPE-EU","SPAIN","SOUTHEND","MAHON",0,0,0
2021,"WESTERN EUROPE-EU","SPAIN","SOUTHEND","MALAGA",19235,19235,0
2021,"WESTERN EUROPE-EU","SPAIN","SOUTHEND","MURCIA INTERNATIONAL",0,0,0
2021,"WESTERN EUROPE-EU","SPAIN","SOUTHEND","PALMA DE MALLORCA",21446,21446,0
2021,"WESTERN EUROPE-EU","SPAIN","SOUTHEND","REUS",1375,1375,0
2021,"WESTERN EUROPE-EU","SPAIN","STANSTED","ALICANTE",139874,139874,0
2021,"WESTERN EUROPE-EU","SPAIN","STANSTED","ALMERIA",10068,10068,0
2021,"WESTERN EUROPE-EU","SPAIN","STANSTED","BARCELONA",147468,147215,253
2021,"WESTERN EUROPE-EU","SPAIN","STANSTED","BILBAO",0,0,0
2021,"WESTERN EUROPE-EU","SPAIN","STANSTED","CASTELLON COSTA AZAHAR",13291,13291,0
2021,"WESTERN EUROPE-EU","SPAIN","STANSTED","GIRONA",18490,18406,84
2021,"WESTERN EUROPE-EU","SPAIN","STANSTED","IBIZA",72583,67585,4998
2021,"WESTERN EUROPE-EU","SPAIN","STANSTED","JEREZ",10949,10949,0
2021,"WESTERN EUROPE-EU","SPAIN","STANSTED","MADRID",143938,143887,51
2021,"WESTERN EUROPE-EU","SPAIN","STANSTED","MAHON",16509,14819,1690
2021,"WESTERN EUROPE-EU","SPAIN","STANSTED","MALAGA",119131,119131,0
2021,"WESTERN EUROPE-EU","SPAIN","STANSTED","MURCIA INTERNATIONAL",0,0,0
2021,"WESTERN EUROPE-EU","SPAIN","STANSTED","PALMA DE MALLORCA",131164,122051,9113
2021,"WESTERN EUROPE-EU","SPAIN","STANSTED","REUS",9664,9664,0
2021,"WESTERN EUROPE-EU","SPAIN","STANSTED","SANTANDER",28266,28266,0
2021,"WESTERN EUROPE-EU","SPAIN","STANSTED","SANTIAGO DE COMPOSTELA (SPAIN)",37772,37772,0
2021,"WESTERN EUROPE-EU","SPAIN","STANSTED","SEVILLE",58802,58802,0
2021,"WESTERN EUROPE-EU","SPAIN","STANSTED","VALENCIA",61464,61464,0
2021,"WESTERN EUROPE-EU","SPAIN","STANSTED","ZARAGOZA",20468,20468,0
2021,"WESTERN EUROPE-EU","SPAIN(CANARY ISLANDS)","GATWICK","ARRECIFE",79706,60120,19586
2021,"WESTERN EUROPE-EU","SPAIN(CANARY ISLANDS)","GATWICK","FUERTEVENTURA",41416,25258,16158
2021,"WESTERN EUROPE-EU","SPAIN(CANARY ISLANDS)","GATWICK","LAS PALMAS",51743,30051,21692
2021,"WESTERN EUROPE-EU","SPAIN(CANARY ISLANDS)","GATWICK","SANTA CRUZ DE LA PALMA",1746,0,1746
2021,"WESTERN EUROPE-EU","SPAIN(CANARY ISLANDS)","GATWICK","TENERIFE (SURREINA SOFIA)",116565,86963,29602
2021,"WESTERN EUROPE-EU","SPAIN(CANARY ISLANDS)","HEATHROW","ARRECIFE",31138,31138,0
2021,"WESTERN EUROPE-EU","SPAIN(CANARY ISLANDS)","HEATHROW","LAS PALMAS",10104,9943,161
2021,"WESTERN EUROPE-EU","SPAIN(CANARY ISLANDS)","HEATHROW","TENERIFE (SURREINA SOFIA)",72329,72329,0
2021,"WESTERN EUROPE-EU","SPAIN(CANARY ISLANDS)","LUTON","ARRECIFE",25164,21598,3566
2021,"WESTERN EUROPE-EU","SPAIN(CANARY ISLANDS)","LUTON","FUERTEVENTURA",23531,23531,0
2021,"WESTERN EUROPE-EU","SPAIN(CANARY ISLANDS)","LUTON","LAS PALMAS",23142,23142,0
2021,"WESTERN EUROPE-EU","SPAIN(CANARY ISLANDS)","LUTON","TENERIFE (SURREINA SOFIA)",62720,59944,2776
2021,"WESTERN EUROPE-EU","SPAIN(CANARY ISLANDS)","SOUTHEND","ARRECIFE",0,0,0
2021,"WESTERN EUROPE-EU","SPAIN(CANARY ISLANDS)","SOUTHEND","TENERIFE (SURREINA SOFIA)",0,0,0
2021,"WESTERN EUROPE-EU","SPAIN(CANARY ISLANDS)","STANSTED","ARRECIFE",71258,71258,0
2021,"WESTERN EUROPE-EU","SPAIN(CANARY ISLANDS)","STANSTED","FUERTEVENTURA",37393,37393,0
2021,"WESTERN EUROPE-EU","SPAIN(CANARY ISLANDS)","STANSTED","LAS PALMAS",56475,50306,6169
2021,"WESTERN EUROPE-EU","SPAIN(CANARY ISLANDS)","STANSTED","TENERIFE (SURREINA SOFIA)",121754,118247,3507
2021,"WESTERN EUROPE-EU","SWEDEN","GATWICK","GOTEBORG (LANDVETTER)",0,0,0
2021,"WESTERN EUROPE-EU","SWEDEN","GATWICK","MALMO",285,0,285
2021,"WESTERN EUROPE-EU","SWEDEN","GATWICK","OSTERSUND / FROSON",0,0,0
2021,"WESTERN EUROPE-EU","SWEDEN","GATWICK","PAJALA YLLAS",178,0,178
2021,"WESTERN EUROPE-EU","SWEDEN","GATWICK","STOCKHOLM (ARLANDA)",28071,28071,0
2021,"WESTERN EUROPE-EU","SWEDEN","HEATHROW","GOTEBORG (LANDVETTER)",26756,26756,0
2021,"WESTERN EUROPE-EU","SWEDEN","HEATHROW","KIRUNA",0,0,0
2021,"WESTERN EUROPE-EU","SWEDEN","HEATHROW","SCANDINAVIAN MOUNTAINS AIRPORT",0,0,0
2021,"WESTERN EUROPE-EU","SWEDEN","HEATHROW","STOCKHOLM (ARLANDA)",171246,171246,0
2021,"WESTERN EUROPE-EU","SWEDEN","LUTON","MALMO",205,0,205
2021,"WESTERN EUROPE-EU","SWEDEN","STANSTED","GOTEBORG (LANDVETTER)",38917,38917,0
2021,"WESTERN EUROPE-EU","SWEDEN","STANSTED","HALMSTAD",0,0,0
2021,"WESTERN EUROPE-EU","SWEDEN","STANSTED","STOCKHOLM (ARLANDA)",18676,18495,181
2021,"WESTERN EUROPE-EU","SWEDEN","STANSTED","STOCKHOLM (SKAVSTA)",15342,15342,0
2021,"WESTERN EUROPE-EU","SWEDEN","STANSTED","VASTERAS",16882,16882,0
2021,"WESTERN EUROPE-OTHER","BOSNIA-HERZEGOVINA","HEATHROW","SARAJEVO",0,0,0
2021,"WESTERN EUROPE-OTHER","BOSNIA-HERZEGOVINA","LUTON","SARAJEVO",0,0,0
2021,"WESTERN EUROPE-OTHER","BOSNIA-HERZEGOVINA","STANSTED","SARAJEVO",38,0,38
2021,"WESTERN EUROPE-OTHER","ICELAND","GATWICK","KEFLAVIK",16614,15893,721
2021,"WESTERN EUROPE-OTHER","ICELAND","HEATHROW","KEFLAVIK",110691,110691,0
2021,"WESTERN EUROPE-OTHER","ICELAND","HEATHROW","REYKJAVIK",0,0,0
2021,"WESTERN EUROPE-OTHER","ICELAND","LUTON","KEFLAVIK",34636,34636,0
2021,"WESTERN EUROPE-OTHER","ICELAND","STANSTED","KEFLAVIK",18083,18083,0
2021,"WESTERN EUROPE-OTHER","KOSOVO","GATWICK","PRISTINA",154,0,154
2021,"WESTERN EUROPE-OTHER","KOSOVO","HEATHROW","PRISTINA",8032,8032,0
2021,"WESTERN EUROPE-OTHER","KOSOVO","LUTON","PRISTINA",45948,45948,0
2021,"WESTERN EUROPE-OTHER","KOSOVO","STANSTED","PRISTINA",0,0,0
2021,"WESTERN EUROPE-OTHER","MACEDONIA","LUTON","OHRID",0,0,0
2021,"WESTERN EUROPE-OTHER","MACEDONIA","LUTON","SKOPJE",39536,39536,0
2021,"WESTERN EUROPE-OTHER","NORWAY","GATWICK","BERGEN",15072,14863,209
2021,"WESTERN EUROPE-OTHER","NORWAY","GATWICK","OSLO (GARDERMOEN)",51076,51076,0
2021,"WESTERN EUROPE-OTHER","NORWAY","GATWICK","STAVANGER",8532,8532,0
2021,"WESTERN EUROPE-OTHER","NORWAY","GATWICK","TROMSOE",1300,1300,0
2021,"WESTERN EUROPE-OTHER","NORWAY","GATWICK","TRONDHEIM (VAERNES)",1109,1109,0
2021,"WESTERN EUROPE-OTHER","NORWAY","HEATHROW","BERGEN",16974,16974,0
2021,"WESTERN EUROPE-OTHER","NORWAY","HEATHROW","OSLO (GARDERMOEN)",96313,96313,0
2021,"WESTERN EUROPE-OTHER","NORWAY","HEATHROW","STAVANGER",0,0,0
2021,"WESTERN EUROPE-OTHER","NORWAY","LUTON","BERGEN",0,0,0
2021,"WESTERN EUROPE-OTHER","NORWAY","LUTON","OSLO (GARDERMOEN)",0,0,0
2021,"WESTERN EUROPE-OTHER","NORWAY","LUTON","STAVANGER",0,0,0
2021,"WESTERN EUROPE-OTHER","NORWAY","LUTON","TROMSOE",0,0,0
2021,"WESTERN EUROPE-OTHER","NORWAY","SOUTHEND","BERGEN",0,0,0
2021,"WESTERN EUROPE-OTHER","NORWAY","STANSTED","KRISTIANSAND (KJEVIK)",0,0,0
2021,"WESTERN EUROPE-OTHER","NORWAY","STANSTED","OSLO (GARDERMOEN)",42037,42037,0
2021,"WESTERN EUROPE-OTHER","NORWAY","STANSTED","SANDEFJORD(TORP)",3290,3290,0
2021,"WESTERN EUROPE-OTHER","REPUBLIC OF MONTENEGRO","GATWICK","PODGORICA",0,0,0
2021,"WESTERN EUROPE-OTHER","REPUBLIC OF MONTENEGRO","GATWICK","TIVAT",3404,3404,0
2021,"WESTERN EUROPE-OTHER","REPUBLIC OF MONTENEGRO","STANSTED","PODGORICA",7264,7264,0
2021,"WESTERN EUROPE-OTHER","REPUBLIC OF SERBIA","HEATHROW","BELGRADE",23218,23197,21
2021,"WESTERN EUROPE-OTHER","REPUBLIC OF SERBIA","LUTON","BELGRADE",28144,28144,0
2021,"WESTERN EUROPE-OTHER","SWITZERLAND","GATWICK","BALE MULHOUSE",29745,29745,0
2021,"WESTERN EUROPE-OTHER","SWITZERLAND","GATWICK","GENEVA",94436,94339,97
2021,"WESTERN EUROPE-OTHER","SWITZERLAND","GATWICK","ZURICH",16447,16447,0
2021,"WESTERN EUROPE-OTHER","SWITZERLAND","HEATHROW","BALE MULHOUSE",13533,13533,0
2021,"WESTERN EUROPE-OTHER","SWITZERLAND","HEATHROW","GENEVA",222073,222073,0
2021,"WESTERN EUROPE-OTHER","SWITZERLAND","HEATHROW","SION",0,0,0
2021,"WESTERN EUROPE-OTHER","SWITZERLAND","HEATHROW","ZURICH",267360,267360,0
2021,"WESTERN EUROPE-OTHER","SWITZERLAND","LONDON CITY","ALTENRHEIN",0,0,0
2021,"WESTERN EUROPE-OTHER","SWITZERLAND","LONDON CITY","GENEVA",4105,4105,0
2021,"WESTERN EUROPE-OTHER","SWITZERLAND","LONDON CITY","SION",0,0,0
2021,"WESTERN EUROPE-OTHER","SWITZERLAND","LONDON CITY","ZURICH",49318,49318,0
2021,"WESTERN EUROPE-OTHER","SWITZERLAND","LUTON","BALE MULHOUSE",0,0,0
2021,"WESTERN EUROPE-OTHER","SWITZERLAND","LUTON","GENEVA",28305,28305,0
2021,"WESTERN EUROPE-OTHER","SWITZERLAND","LUTON","ZURICH",5289,5289,0
2021,"WESTERN EUROPE-OTHER","SWITZERLAND","SOUTHEND","GENEVA",0,0,0
2021,"WESTERN EUROPE-OTHER","SWITZERLAND","STANSTED","BALE MULHOUSE",0,0,0
2021,"WESTERN EUROPE-OTHER","SWITZERLAND","STANSTED","GENEVA",654,654,0
2021,"WESTERN EUROPE-OTHER","SWITZERLAND","STANSTED","ZURICH",0,0,0
2021,"WESTERN EUROPE-OTHER","TURKEY","GATWICK","ANKARA (ESENBOGA)",0,0,0
2021,"WESTERN EUROPE-OTHER","TURKEY","GATWICK","ANTALYA",23620,19005,4615
2021,"WESTERN EUROPE-OTHER","TURKEY","GATWICK","BODRUM (MILAS)",405,405,0
2021,"WESTERN EUROPE-OTHER","TURKEY","GATWICK","DALAMAN",11677,8611,3066
2021,"WESTERN EUROPE-OTHER","TURKEY","GATWICK","ISTANBUL",36208,36208,0
2021,"WESTERN EUROPE-OTHER","TURKEY","GATWICK","ISTANBUL (SABIHA GOKCEN)",8,0,8
2021,"WESTERN EUROPE-OTHER","TURKEY","GATWICK","IZMIR (ADNAN MENDERES)",707,0,707
2021,"WESTERN EUROPE-OTHER","TURKEY","HEATHROW","ANKARA (ESENBOGA)",0,0,0
2021,"WESTERN EUROPE-OTHER","TURKEY","HEATHROW","ANTALYA",1663,1663,0
2021,"WESTERN EUROPE-OTHER","TURKEY","HEATHROW","BODRUM (MILAS)",911,911,0
2021,"WESTERN EUROPE-OTHER","TURKEY","HEATHROW","DALAMAN",2928,2928,0
2021,"WESTERN EUROPE-OTHER","TURKEY","HEATHROW","ISTANBUL",385503,385489,14
2021,"WESTERN EUROPE-OTHER","TURKEY","HEATHROW","ISTANBUL (SABIHA GOKCEN)",7901,7901,0
2021,"WESTERN EUROPE-OTHER","TURKEY","LUTON","ANKARA (ESENBOGA)",0,0,0
2021,"WESTERN EUROPE-OTHER","TURKEY","LUTON","ANTALYA",5547,5547,0
2021,"WESTERN EUROPE-OTHER","TURKEY","LUTON","BODRUM (MILAS)",0,0,0
2021,"WESTERN EUROPE-OTHER","TURKEY","LUTON","DALAMAN",1754,1754,0
2021,"WESTERN EUROPE-OTHER","TURKEY","LUTON","GAZIANTEP",957,957,0
2021,"WESTERN EUROPE-OTHER","TURKEY","LUTON","IZMIR (ADNAN MENDERES)",534,534,0
2021,"WESTERN EUROPE-OTHER","TURKEY","STANSTED","ADANA",0,0,0
2021,"WESTERN EUROPE-OTHER","TURKEY","STANSTED","ANKARA (ESENBOGA)",1288,1288,0
2021,"WESTERN EUROPE-OTHER","TURKEY","STANSTED","ANTALYA",30029,30029,0
2021,"WESTERN EUROPE-OTHER","TURKEY","STANSTED","BODRUM (MILAS)",210,210,0
2021,"WESTERN EUROPE-OTHER","TURKEY","STANSTED","DALAMAN",15225,15225,0
2021,"WESTERN EUROPE-OTHER","TURKEY","STANSTED","GAZIANTEP",0,0,0
2021,"WESTERN EUROPE-OTHER","TURKEY","STANSTED","ISTANBUL",0,0,0
2021,"WESTERN EUROPE-OTHER","TURKEY","STANSTED","ISTANBUL (SABIHA GOKCEN)",204382,204382,0
2021,"WESTERN EUROPE-OTHER","TURKEY","STANSTED","IZMIR (ADNAN MENDERES)",15022,14775,247
2021,"WESTERN EUROPE-OTHER","TURKEY","STANSTED","KAHRAMANMARAS",0,0,0
2021,"WESTERN EUROPE-OTHER","TURKEY","STANSTED","KAYSERI  ERKILET",0,0,0
2021,"EASTERN EUROPE-EU","BULGARIA","GATWICK","BURGAS",2455,2455,0
2021,"EASTERN EUROPE-EU","BULGARIA","GATWICK","SOFIA",47287,46289,998
2021,"EASTERN EUROPE-EU","BULGARIA","GATWICK","VARNA",4279,4279,0
2021,"EASTERN EUROPE-EU","BULGARIA","HEATHROW","SOFIA",48812,48812,0
2021,"EASTERN EUROPE-EU","BULGARIA","LUTON","BURGAS",43049,43049,0
2021,"EASTERN EUROPE-EU","BULGARIA","LUTON","PLOVDIV",5562,5562,0
2021,"EASTERN EUROPE-EU","BULGARIA","LUTON","SOFIA",179964,179964,0
2021,"EASTERN EUROPE-EU","BULGARIA","LUTON","VARNA",66766,66766,0
2021,"EASTERN EUROPE-EU","BULGARIA","SOUTHEND","SOFIA",0,0,0
2021,"EASTERN EUROPE-EU","BULGARIA","STANSTED","PLOVDIV",20756,20756,0
2021,"EASTERN EUROPE-EU","BULGARIA","STANSTED","SOFIA",124665,124562,103
2021,"EASTERN EUROPE-EU","CZECH REPUBLIC","GATWICK","PRAGUE",13536,13478,58
2021,"EASTERN EUROPE-EU","CZECH REPUBLIC","HEATHROW","PRAGUE",53729,53729,0
2021,"EASTERN EUROPE-EU","CZECH REPUBLIC","LONDON CITY","PRAGUE",2036,2036,0
2021,"EASTERN EUROPE-EU","CZECH REPUBLIC","LUTON","PRAGUE",0,0,0
2021,"EASTERN EUROPE-EU","CZECH REPUBLIC","SOUTHEND","PRAGUE",0,0,0
2021,"EASTERN EUROPE-EU","CZECH REPUBLIC","STANSTED","BRNO (TURANY)",22799,22799,0
2021,"EASTERN EUROPE-EU","CZECH REPUBLIC","STANSTED","OSTRAVA",10232,10232,0
2021,"EASTERN EUROPE-EU","CZECH REPUBLIC","STANSTED","PRAGUE",115775,115715,60
2021,"EASTERN EUROPE-EU","ESTONIA","GATWICK","TALLIN",16244,16244,0
2021,"EASTERN EUROPE-EU","ESTONIA","HEATHROW","TALLIN",0,0,0
2021,"EASTERN EUROPE-EU","ESTONIA","STANSTED","TALLIN",32949,32835,114
2021,"EASTERN EUROPE-EU","HUNGARY","GATWICK","BUDAPEST",22564,22097,467
2021,"EASTERN EUROPE-EU","HUNGARY","HEATHROW","BUDAPEST",30007,30007,0
2021,"EASTERN EUROPE-EU","HUNGARY","LONDON CITY","BUDAPEST",0,0,0
2021,"EASTERN EUROPE-EU","HUNGARY","LUTON","BUDAPEST",139563,139491,72
2021,"EASTERN EUROPE-EU","HUNGARY","LUTON","DEBRECEN",20369,20369,0
2021,"EASTERN EUROPE-EU","HUNGARY","SOUTHEND","BUDAPEST",0,0,0
2021,"EASTERN EUROPE-EU","HUNGARY","STANSTED","BUDAPEST",133998,133764,234
2021,"EASTERN EUROPE-EU","LATVIA","GATWICK","RIGA",39348,39348,0
2021,"EASTERN EUROPE-EU","LATVIA","LUTON","RIGA",28667,28667,0
2021,"EASTERN EUROPE-EU","LATVIA","STANSTED","RIGA",86374,86374,0
2021,"EASTERN EUROPE-EU","LITHUANIA","GATWICK","VILNIUS",3921,3593,328
2021,"EASTERN EUROPE-EU","LITHUANIA","HEATHROW","VILNIUS",47,47,0
2021,"EASTERN EUROPE-EU","LITHUANIA","LONDON CITY","VILNIUS",21507,21507,0
2021,"EASTERN EUROPE-EU","LITHUANIA","LUTON","KAUNAS",84619,84619,0
2021,"EASTERN EUROPE-EU","LITHUANIA","LUTON","PALANGA",8438,8438,0
2021,"EASTERN EUROPE-EU","LITHUANIA","LUTON","VILNIUS",75689,75689,0
2021,"EASTERN EUROPE-EU","LITHUANIA","SOUTHEND","VILNIUS",78,78,0
2021,"EASTERN EUROPE-EU","LITHUANIA","STANSTED","KAUNAS",31230,31230,0
2021,"EASTERN EUROPE-EU","LITHUANIA","STANSTED","PALANGA",13243,13243,0
2021,"EASTERN EUROPE-EU","LITHUANIA","STANSTED","VILNIUS",44273,44208,65
2021,"EASTERN EUROPE-EU","POLAND","GATWICK","GDANSK",216,216,0
2021,"EASTERN EUROPE-EU","POLAND","GATWICK","KRAKOW",20098,20098,0
2021,"EASTERN EUROPE-EU","POLAND","GATWICK","WARSAW (CHOPIN)",770,0,770
2021,"EASTERN EUROPE-EU","POLAND","GATWICK","WROCLAW",0,0,0
2021,"EASTERN EUROPE-EU","POLAND","HEATHROW","KATOWICE",0,0,0
2021,"EASTERN EUROPE-EU","POLAND","HEATHROW","KRAKOW",8861,8861,0
2021,"EASTERN EUROPE-EU","POLAND","HEATHROW","WARSAW (CHOPIN)",119505,119505,0
2021,"EASTERN EUROPE-EU","POLAND","LONDON CITY","WARSAW (CHOPIN)",0,0,0
2021,"EASTERN EUROPE-EU","POLAND","LUTON","BYDGOSZCZ",13126,13126,0
2021,"EASTERN EUROPE-EU","POLAND","LUTON","GDANSK",82861,82861,0
2021,"EASTERN EUROPE-EU","POLAND","LUTON","KATOWICE",67617,67617,0
2021,"EASTERN EUROPE-EU","POLAND","LUTON","KRAKOW",99705,99705,0
2021,"EASTERN EUROPE-EU","POLAND","LUTON","LUBLIN (PORT LOTNICZY)",35970,35970,0
2021,"EASTERN EUROPE-EU","POLAND","LUTON","POZNAN",41757,41757,0
2021,"EASTERN EUROPE-EU","POLAND","LUTON","RZESZOW",24719,24719,0
2021,"EASTERN EUROPE-EU","POLAND","LUTON","SZYMANY (MAZURY)",958,958,0
2021,"EASTERN EUROPE-EU","POLAND","LUTON","WARSAW (CHOPIN)",124017,124017,0
2021,"EASTERN EUROPE-EU","POLAND","LUTON","WROCLAW",42251,42251,0
2021,"EASTERN EUROPE-EU","POLAND","STANSTED","BYDGOSZCZ",19717,19717,0
2021,"EASTERN EUROPE-EU","POLAND","STANSTED","GDANSK",69635,69501,134
2021,"EASTERN EUROPE-EU","POLAND","STANSTED","KATOWICE",44177,44177,0
2021,"EASTERN EUROPE-EU","POLAND","STANSTED","KRAKOW",105250,105250,0
2021,"EASTERN EUROPE-EU","POLAND","STANSTED","LODZ LUBLINEK",22936,22936,0
2021,"EASTERN EUROPE-EU","POLAND","STANSTED","POZNAN",45689,45689,0
2021,"EASTERN EUROPE-EU","POLAND","STANSTED","RZESZOW",36471,36471,0
2021,"EASTERN EUROPE-EU","POLAND","STANSTED","SZCZECIN (GOLENOW)",30318,30318,0
2021,"EASTERN EUROPE-EU","POLAND","STANSTED","SZYMANY (MAZURY)",10707,10707,0
2021,"EASTERN EUROPE-EU","POLAND","STANSTED","WARSAW (CHOPIN)",177,163,14
2021,"EASTERN EUROPE-EU","POLAND","STANSTED","WARSAW (MODLIN MASOVIA)",112224,112224,0
2021,"EASTERN EUROPE-EU","POLAND","STANSTED","WROCLAW",64182,64182,0
2021,"EASTERN EUROPE-EU","ROMANIA","GATWICK","BUCHAREST (OTOPENI)",4221,3205,1016
2021,"EASTERN EUROPE-EU","ROMANIA","GATWICK","CLUJ NAPOCA",0,0,0
2021,"EASTERN EUROPE-EU","ROMANIA","HEATHROW","BUCHAREST (OTOPENI)",142185,142171,14
2021,"EASTERN EUROPE-EU","ROMANIA","HEATHROW","CLUJ NAPOCA",4872,4872,0
2021,"EASTERN EUROPE-EU","ROMANIA","HEATHROW","IASI",7612,7612,0
2021,"EASTERN EUROPE-EU","ROMANIA","LONDON CITY","BUCHAREST (OTOPENI)",91,0,91
2021,"EASTERN EUROPE-EU","ROMANIA","LUTON","BACAU",118006,118006,0
2021,"EASTERN EUROPE-EU","ROMANIA","LUTON","BUCHAREST (OTOPENI)",228310,228310,0
2021,"EASTERN EUROPE-EU","ROMANIA","LUTON","CLUJ NAPOCA",111672,111672,0
2021,"EASTERN EUROPE-EU","ROMANIA","LUTON","CONSTANTA",20119,20119,0
2021,"EASTERN EUROPE-EU","ROMANIA","LUTON","CRAIOVA",64329,64329,0
2021,"EASTERN EUROPE-EU","ROMANIA","LUTON","IASI",90448,90448,0
2021,"EASTERN EUROPE-EU","ROMANIA","LUTON","SATU MARE",18759,18687,72
2021,"EASTERN EUROPE-EU","ROMANIA","LUTON","SIBIU",41009,41009,0
2021,"EASTERN EUROPE-EU","ROMANIA","LUTON","SUCEAVA",83237,83237,0
2021,"EASTERN EUROPE-EU","ROMANIA","LUTON","TIMISOARA",42396,42396,0
2021,"EASTERN EUROPE-EU","ROMANIA","LUTON","TIRGU MURES",13235,13235,0
2021,"EASTERN EUROPE-EU","ROMANIA","SOUTHEND","BUCHAREST (OTOPENI)",12326,12326,0
2021,"EASTERN EUROPE-EU","ROMANIA","SOUTHEND","SIBIU",0,0,0
2021,"EASTERN EUROPE-EU","ROMANIA","STANSTED","BUCHAREST (OTOPENI)",145772,145772,0
2021,"EASTERN EUROPE-EU","ROMANIA","STANSTED","CLUJ NAPOCA",22499,22499,0
2021,"EASTERN EUROPE-EU","ROMANIA","STANSTED","IASI",0,0,0
2021,"EASTERN EUROPE-EU","ROMANIA","STANSTED","ORADEA",11463,11463,0
2021,"EASTERN EUROPE-EU","ROMANIA","STANSTED","TIMISOARA",89,89,0
2021,"EASTERN EUROPE-EU","SLOVAK REPUBLIC","GATWICK","BRATISLAVA",0,0,0
2021,"EASTERN EUROPE-EU","SLOVAK REPUBLIC","LUTON","BRATISLAVA",13036,13036,0
2021,"EASTERN EUROPE-EU","SLOVAK REPUBLIC","LUTON","KOSICE",38275,38275,0
2021,"EASTERN EUROPE-EU","SLOVAK REPUBLIC","LUTON","TATRY-POPRAD",8096,8096,0
2021,"EASTERN EUROPE-EU","SLOVAK REPUBLIC","STANSTED","BRATISLAVA",42130,42130,0
2021,"EASTERN EUROPE-EU","SLOVAK REPUBLIC","STANSTED","KOSICE",14187,14187,0
2021,"EASTERN EUROPE -OTHER","ALBANIA","GATWICK","TIRANA",15382,14491,891
2021,"EASTERN EUROPE -OTHER","ALBANIA","HEATHROW","TIRANA",71964,71964,0
2021,"EASTERN EUROPE -OTHER","ALBANIA","LUTON","TIRANA",131597,131597,0
2021,"EASTERN EUROPE -OTHER","ALBANIA","STANSTED","TIRANA",5129,5129,0
2021,"EASTERN EUROPE -OTHER","AZERBAIJAN","HEATHROW","BAKU (HEYDER ALIYEV INT'L)",10841,9804,1037
2021,"EASTERN EUROPE -OTHER","BELARUS","GATWICK","MINSK INT'L ",6031,6031,0
2021,"EASTERN EUROPE -OTHER","GEORGIA","GATWICK","TBILISI",0,0,0
2021,"EASTERN EUROPE -OTHER","GEORGIA","LUTON","KUTAISI",0,0,0
2021,"EASTERN EUROPE -OTHER","KAZAKHSTAN","GATWICK","NURSULTAN NAZERBAYEV INTERNATIONAL",0,0,0
2021,"EASTERN EUROPE -OTHER","KAZAKHSTAN","HEATHROW","NURSULTAN NAZERBAYEV INTERNATIONAL",3651,3651,0
2021,"EASTERN EUROPE -OTHER","KAZAKHSTAN","HEATHROW","PETROPAVLOSVK",0,0,0
2021,"EASTERN EUROPE -OTHER","REPUBLIC OF MOLDOVA","LUTON","CHISINAU (KISHINEV)",135991,135991,0
2021,"EASTERN EUROPE -OTHER","REPUBLIC OF MOLDOVA","STANSTED","CHISINAU (KISHINEV)",27182,27182,0
2021,"EASTERN EUROPE -OTHER","RUSSIA","GATWICK","KRASNODAR",0,0,0
2021,"EASTERN EUROPE -OTHER","RUSSIA","GATWICK","MOSCOW (VNUKOVO)",0,0,0
2021,"EASTERN EUROPE -OTHER","RUSSIA","GATWICK","ST PETERSBURG",424,0,424
2021,"EASTERN EUROPE -OTHER","RUSSIA","HEATHROW","ADLER / SOCHI",1112,0,1112
2021,"EASTERN EUROPE -OTHER","RUSSIA","HEATHROW","MOSCOW (DOMODEDOVO)",33928,33928,0
2021,"EASTERN EUROPE -OTHER","RUSSIA","HEATHROW","MOSCOW (SHEREMETYEVO)",89999,81440,8559
2021,"EASTERN EUROPE -OTHER","RUSSIA","HEATHROW","ST PETERSBURG",0,0,0
2021,"EASTERN EUROPE -OTHER","RUSSIA","LUTON","MOSCOW (VNUKOVO)",0,0,0
2021,"EASTERN EUROPE -OTHER","RUSSIA","LUTON","ST PETERSBURG",0,0,0
2021,"EASTERN EUROPE -OTHER","RUSSIA","SOUTHEND","ST PETERSBURG",0,0,0
2021,"EASTERN EUROPE -OTHER","RUSSIA","STANSTED","ADLER / SOCHI",0,0,0
2021,"EASTERN EUROPE -OTHER","RUSSIA","STANSTED","MOSCOW (DOMODEDOVO)",0,0,0
2021,"EASTERN EUROPE -OTHER","UKRAINE","GATWICK","KIEV (BORISPOL)",51526,51526,0
2021,"EASTERN EUROPE -OTHER","UKRAINE","HEATHROW","KIEV (BORISPOL)",14544,14544,0
2021,"EASTERN EUROPE -OTHER","UKRAINE","LUTON","KIEV (ZHULYANY)",41480,41480,0
2021,"EASTERN EUROPE -OTHER","UKRAINE","LUTON","LVOV",34256,34256,0
2021,"EASTERN EUROPE -OTHER","UKRAINE","SOUTHEND","KIEV (BORISPOL)",0,0,0
2021,"EASTERN EUROPE -OTHER","UKRAINE","STANSTED","KIEV (BORISPOL)",36602,36602,0
2021,"EASTERN EUROPE -OTHER","UKRAINE","STANSTED","LVOV",22594,22594,0
2021,"EASTERN EUROPE -OTHER","UZBEKISTAN","HEATHROW","TASHKENT",4962,4953,9
2021,"NEAR EAST","ISRAEL","GATWICK","TEL AVIV",1472,1472,0
2021,"NEAR EAST","ISRAEL","HEATHROW","TEL AVIV",212030,211593,437
2021,"NEAR EAST","ISRAEL","LUTON","TEL AVIV",46539,46539,0
2021,"NEAR EAST","ISRAEL","STANSTED","TEL AVIV",0,0,0
2021,"NEAR EAST","JORDAN","GATWICK","AMMAN",0,0,0
2021,"NEAR EAST","JORDAN","GATWICK","AQABA",1822,1822,0
2021,"NEAR EAST","JORDAN","HEATHROW","AMMAN",109350,109350,0
2021,"NEAR EAST","LEBANON","HEATHROW","BEIRUT",83181,83181,0
2021,"NORTH AFRICA","ALGERIA","GATWICK","ALGIERS",0,0,0
2021,"NORTH AFRICA","ALGERIA","HEATHROW","ADRAR",22,0,22
2021,"NORTH AFRICA","ALGERIA","HEATHROW","ALGIERS",11157,11157,0
2021,"NORTH AFRICA","ALGERIA","HEATHROW","HASSI MESSAOUD",0,0,0
2021,"NORTH AFRICA","ALGERIA","STANSTED","HASSI MESSAOUD",36,0,36
2021,"NORTH AFRICA","EGYPT","GATWICK","ALEXANDRIA (BORG EL ARAB)",426,0,426
2021,"NORTH AFRICA","EGYPT","GATWICK","CAIRO",317,0,317
2021,"NORTH AFRICA","EGYPT","GATWICK","HURGHADA",25180,25180,0
2021,"NORTH AFRICA","EGYPT","GATWICK","MARSA ALAM",0,0,0
2021,"NORTH AFRICA","EGYPT","GATWICK","SHARM EL SHEIKH (OPHIRA)",17880,17880,0
2021,"NORTH AFRICA","EGYPT","HEATHROW","ALEXANDRIA (BORG EL ARAB)",0,0,0
2021,"NORTH AFRICA","EGYPT","HEATHROW","CAIRO",154155,154047,108
2021,"NORTH AFRICA","EGYPT","HEATHROW","LUXOR",827,827,0
2021,"NORTH AFRICA","EGYPT","HEATHROW","MARSA ALAM",0,0,0
2021,"NORTH AFRICA","EGYPT","LUTON","HURGHADA",3820,3820,0
2021,"NORTH AFRICA","EGYPT","LUTON","SHARM EL SHEIKH (OPHIRA)",2088,2088,0
2021,"NORTH AFRICA","EGYPT","STANSTED","HURGHADA",0,0,0
2021,"NORTH AFRICA","EGYPT","STANSTED","SHARM EL SHEIKH (OPHIRA)",378,378,0
2021,"NORTH AFRICA","MOROCCO","GATWICK","AGADIR (AL MASSIRA)",8991,8991,0
2021,"NORTH AFRICA","MOROCCO","GATWICK","CASABLANCA MOHAMED V",17236,17236,0
2021,"NORTH AFRICA","MOROCCO","GATWICK","ERRACHIDIA",215,0,215
2021,"NORTH AFRICA","MOROCCO","GATWICK","FEZ",0,0,0
2021,"NORTH AFRICA","MOROCCO","GATWICK","MARRAKESH",18234,18232,2
2021,"NORTH AFRICA","MOROCCO","GATWICK","OUARZAZATE",161,0,161
2021,"NORTH AFRICA","MOROCCO","GATWICK","TANGIERS (IBN BATUTA)",9797,9797,0
2021,"NORTH AFRICA","MOROCCO","HEATHROW","CASABLANCA MOHAMED V",25890,25890,0
2021,"NORTH AFRICA","MOROCCO","HEATHROW","ERRACHIDIA",0,0,0
2021,"NORTH AFRICA","MOROCCO","HEATHROW","FEZ",291,0,291
2021,"NORTH AFRICA","MOROCCO","HEATHROW","MARRAKESH",0,0,0
2021,"NORTH AFRICA","MOROCCO","HEATHROW","RABAT",3466,3466,0
2021,"NORTH AFRICA","MOROCCO","LUTON","CASABLANCA MOHAMED V",0,0,0
2021,"NORTH AFRICA","MOROCCO","LUTON","MARRAKESH",510,510,0
2021,"NORTH AFRICA","MOROCCO","SOUTHEND","CASABLANCA MOHAMED V",0,0,0
2021,"NORTH AFRICA","MOROCCO","STANSTED","AGADIR (AL MASSIRA)",8456,8456,0
2021,"NORTH AFRICA","MOROCCO","STANSTED","CASABLANCA MOHAMED V",0,0,0
2021,"NORTH AFRICA","MOROCCO","STANSTED","ERRACHIDIA",94,0,94
2021,"NORTH AFRICA","MOROCCO","STANSTED","ESSAOUIRA",0,0,0
2021,"NORTH AFRICA","MOROCCO","STANSTED","FEZ",0,0,0
2021,"NORTH AFRICA","MOROCCO","STANSTED","MARRAKESH",28875,28875,0
2021,"NORTH AFRICA","MOROCCO","STANSTED","RABAT",14888,14888,0
2021,"NORTH AFRICA","TUNISIA","GATWICK","ENFIDHA - HAMMAMET INTL",1254,0,1254
2021,"NORTH AFRICA","TUNISIA","GATWICK","TUNIS",3870,3870,0
2021,"NORTH AFRICA","TUNISIA","HEATHROW","TUNIS",5911,5911,0
2021,"EAST AFRICA","ETHIOPIA","HEATHROW","ADDIS ABABA",97671,97671,0
2021,"EAST AFRICA","KENYA","HEATHROW","ELDORET INTERNATIONAL AIRPORT",39,0,39
2021,"EAST AFRICA","KENYA","HEATHROW","NAIROBI",71814,71813,1
2021,"EAST AFRICA","RWANDA","GATWICK","KIGALI",0,0,0
2021,"EAST AFRICA","RWANDA","HEATHROW","KIGALI",3289,3289,0
2021,"EAST AFRICA","SUDAN","HEATHROW","KHARTOUM",0,0,0
2021,"EAST AFRICA","TANZANIA","HEATHROW","DAR-ES-SALAAM",0,0,0
2021,"EAST AFRICA","UGANDA","HEATHROW","ENTEBBE",0,0,0
2021,"WEST AFRICA","BENIN","STANSTED","COTONOU",0,0,0
2021,"WEST AFRICA","BURKINO FASO","HEATHROW","OUAGADOUGOU",0,0,0
2021,"WEST AFRICA","CAMEROON","STANSTED","DOUALA",0,0,0
2021,"WEST AFRICA","EQUATORIAL GUINEA","HEATHROW","MALABO",0,0,0
2021,"WEST AFRICA","EQUATORIAL GUINEA","STANSTED","MALABO",0,0,0
2021,"WEST AFRICA","GAMBIA","GATWICK","BANJUL",6751,0,6751
2021,"WEST AFRICA","GAMBIA","STANSTED","BANJUL",0,0,0
2021,"WEST AFRICA","GHANA","GATWICK","ACCRA",48,0,48
2021,"WEST AFRICA","GHANA","HEATHROW","ACCRA",169966,169966,0
2021,"WEST AFRICA","GHANA","STANSTED","ACCRA",0,0,0
2021,"WEST AFRICA","NIGERIA","GATWICK","ABUJA",0,0,0
2021,"WEST AFRICA","NIGERIA","GATWICK","LAGOS",0,0,0
2021,"WEST AFRICA","NIGERIA","HEATHROW","ABUJA",105799,105799,0
2021,"WEST AFRICA","NIGERIA","HEATHROW","KANO",0,0,0
2021,"WEST AFRICA","NIGERIA","HEATHROW","LAGOS",290593,290574,19
2021,"WEST AFRICA","NIGERIA","STANSTED","LAGOS",0,0,0
2021,"WEST AFRICA","SIERRA LEONE","GATWICK","FREETOWN",0,0,0
2021,"CENTRAL AFRICA","ANGOLA","GATWICK","LUANDA",0,0,0
2021,"CENTRAL AFRICA","ANGOLA","HEATHROW","LUANDA",0,0,0
2021,"CENTRAL AFRICA","ANGOLA","STANSTED","LUANDA",0,0,0
2021,"SOUTHERN AFRICA","NAMIBIA","HEATHROW","WINDHOEK",0,0,0
2021,"SOUTHERN AFRICA","REPUBLIC OF SOUTH AFRICA","GATWICK","CAPE TOWN",0,0,0
2021,"SOUTHERN AFRICA","REPUBLIC OF SOUTH AFRICA","HEATHROW","CAPE TOWN",18349,18349,0
2021,"SOUTHERN AFRICA","REPUBLIC OF SOUTH AFRICA","HEATHROW","DURBAN",0,0,0
2021,"SOUTHERN AFRICA","REPUBLIC OF SOUTH AFRICA","HEATHROW","JOHANNESBURG",59123,58905,218
2021,"SOUTHERN AFRICA","ZIMBABWE","GATWICK","HARARE",126,0,126
2021,"MIDDLE EAST","BAHRAIN","HEATHROW","BAHRAIN",176560,174752,1808
2021,"MIDDLE EAST","IRAN","HEATHROW","TEHRAN IMAM KHOMEINI",38313,38313,0
2021,"MIDDLE EAST","IRAQ","GATWICK","BAGHDAD (GECA)",1478,1478,0
2021,"MIDDLE EAST","IRAQ","GATWICK","ERBIL INTERNATIONAL",1,0,1
2021,"MIDDLE EAST","IRAQ","GATWICK","SULAYMANIYAH INT",1812,1812,0
2021,"MIDDLE EAST","IRAQ","STANSTED","ERBIL INTERNATIONAL",0,0,0
2021,"MIDDLE EAST","KUWAIT","GATWICK","KUWAIT",256,0,256
2021,"MIDDLE EAST","KUWAIT","HEATHROW","KUWAIT",87834,87762,72
2021,"MIDDLE EAST","OMAN","HEATHROW","MUSCAT",25250,24633,617
2021,"MIDDLE EAST","QATAR","GATWICK","DOHA HAMAD",7352,7349,3
2021,"MIDDLE EAST","QATAR","HEATHROW","DOHA HAMAD",394835,394155,680
2021,"MIDDLE EAST","SAUDI ARABIA","HEATHROW","DAMMAM",0,0,0
2021,"MIDDLE EAST","SAUDI ARABIA","HEATHROW","JEDDAH",63799,63074,725
2021,"MIDDLE EAST","SAUDI ARABIA","HEATHROW","RIYADH",121244,121156,88
2021,"MIDDLE EAST","SAUDI ARABIA","HEATHROW","TABUK",0,0,0
2021,"MIDDLE EAST","SAUDI ARABIA","STANSTED","JEDDAH",0,0,0
2021,"MIDDLE EAST","SAUDI ARABIA","STANSTED","RIYADH",0,0,0
2021,"MIDDLE EAST","UNITED ARAB EMIRATES","GATWICK","DUBAI",15090,15090,0
2021,"MIDDLE EAST","UNITED ARAB EMIRATES","GATWICK","DUBAI (WORLD CENTRAL)",8,0,8
2021,"MIDDLE EAST","UNITED ARAB EMIRATES","HEATHROW","ABU DHABI INTERNATIONAL",175874,175761,113
2021,"MIDDLE EAST","UNITED ARAB EMIRATES","HEATHROW","DUBAI",808620,808620,0
2021,"MIDDLE EAST","UNITED ARAB EMIRATES","HEATHROW","DUBAI (WORLD CENTRAL)",3589,0,3589
2021,"MIDDLE EAST","UNITED ARAB EMIRATES","STANSTED","DUBAI",0,0,0
2021,"INDIAN SUB-CONTINENT","AFGHANISTAN","HEATHROW","BAGRAM",0,0,0
2021,"INDIAN SUB-CONTINENT","AFGHANISTAN","STANSTED","KABUL",74,0,74
2021,"INDIAN SUB-CONTINENT","BANGLADESH","HEATHROW","DHAKHA",17897,17897,0
2021,"INDIAN SUB-CONTINENT","BANGLADESH","HEATHROW","SYLHET",25200,25200,0
2021,"INDIAN SUB-CONTINENT","INDIA","GATWICK","GOA",0,0,0
2021,"INDIAN SUB-CONTINENT","INDIA","GATWICK","MUMBAI",0,0,0
2021,"INDIAN SUB-CONTINENT","INDIA","HEATHROW","AHMEDABAD",17129,17084,45
2021,"INDIAN SUB-CONTINENT","INDIA","HEATHROW","AMRITSAR",8674,8674,0
2021,"INDIAN SUB-CONTINENT","INDIA","HEATHROW","BANGALORE (BENGALURU)",98558,89229,9329
2021,"INDIAN SUB-CONTINENT","INDIA","HEATHROW","BIJU PATNAIK INTERNATIONAL",0,0,0
2021,"INDIAN SUB-CONTINENT","INDIA","HEATHROW","CHENNAI",25457,25457,0
2021,"INDIAN SUB-CONTINENT","INDIA","HEATHROW","COCHIN",24378,24378,0
2021,"INDIAN SUB-CONTINENT","INDIA","HEATHROW","DELHI",323844,305887,17957
2021,"INDIAN SUB-CONTINENT","INDIA","HEATHROW","GOA",16350,16123,227
2021,"INDIAN SUB-CONTINENT","INDIA","HEATHROW","HYDERABAD ( RAJIV GHANDI )",61728,61728,0
2021,"INDIAN SUB-CONTINENT","INDIA","HEATHROW","KOLKATA",7499,7499,0
2021,"INDIAN SUB-CONTINENT","INDIA","HEATHROW","MUMBAI",226928,209708,17220
2021,"INDIAN SUB-CONTINENT","INDIA","HEATHROW","VIJAYAWADA",0,0,0
2021,"INDIAN SUB-CONTINENT","INDIA","HEATHROW","VISHAKHPATNAM",0,0,0
2021,"INDIAN SUB-CONTINENT","INDIA","STANSTED","AMRITSAR",0,0,0
2021,"INDIAN SUB-CONTINENT","INDIA","STANSTED","GOA",0,0,0
2021,"INDIAN SUB-CONTINENT","INDIA","STANSTED","MUMBAI",0,0,0
2021,"INDIAN SUB-CONTINENT","NEPAL","STANSTED","KATHMANDU",0,0,0
2021,"INDIAN SUB-CONTINENT","PAKISTAN","GATWICK","BENAZIR BHUTTO INTERNATIONAL AIRPORT",195,0,195
2021,"INDIAN SUB-CONTINENT","PAKISTAN","HEATHROW","ISLAMABAD INTERNATIONAL AIRPORT",159665,142602,17063
2021,"INDIAN SUB-CONTINENT","PAKISTAN","HEATHROW","KARACHI",0,0,0
2021,"INDIAN SUB-CONTINENT","PAKISTAN","HEATHROW","LAHORE",90105,89888,217
2021,"INDIAN SUB-CONTINENT","PAKISTAN","HEATHROW","SIALKOT",0,0,0
2021,"INDIAN SUB-CONTINENT","PAKISTAN","STANSTED","ISLAMABAD INTERNATIONAL AIRPORT",479,0,479
2021,"INDIAN SUB-CONTINENT","SRI LANKA","GATWICK","COLOMBO",0,0,0
2021,"INDIAN SUB-CONTINENT","SRI LANKA","HEATHROW","COLOMBO",36789,36789,0
2021,"INDIAN SUB-CONTINENT","SRI LANKA","HEATHROW","MATTALA RAJAPAKSA",40,0,40
2021,"INDIAN SUB-CONTINENT","SRI LANKA","STANSTED","COLOMBO",0,0,0
2021,"FAR EAST","BRUNEI","HEATHROW","BANDAR SERI BEGAWAN",3418,3418,0
2021,"FAR EAST","CHINA","GATWICK","CHENGDU",0,0,0
2021,"FAR EAST","CHINA","GATWICK","NANJING LUKOU INTERNATIONAL",0,0,0
2021,"FAR EAST","CHINA","GATWICK","SHANGHAI (PU DONG)",0,0,0
2021,"FAR EAST","CHINA","HEATHROW","BEIJING",171,0,171
2021,"FAR EAST","CHINA","HEATHROW","BEIJING DAXING INTERNATIONAL AIRPORT",0,0,0
2021,"FAR EAST","CHINA","HEATHROW","CHANGSHA HUANGHUA INTERNATIONAL AIRPORT",0,0,0
2021,"FAR EAST","CHINA","HEATHROW","CHENGDU",0,0,0
2021,"FAR EAST","CHINA","HEATHROW","CHONGQING JIANGBEI INTERNATIONAL",0,0,0
2021,"FAR EAST","CHINA","HEATHROW","GUANGZHOU BAIYUN INTERNATIONAL",0,0,0
2021,"FAR EAST","CHINA","HEATHROW","HAIKOU",0,0,0
2021,"FAR EAST","CHINA","HEATHROW","HANGZHOU",0,0,0
2021,"FAR EAST","CHINA","HEATHROW","HEFEI",0,0,0
2021,"FAR EAST","CHINA","HEATHROW","JINAN YAOQIANG INTERNATIONAL",0,0,0
2021,"FAR EAST","CHINA","HEATHROW","NANJING LUKOU INTERNATIONAL",0,0,0
2021,"FAR EAST","CHINA","HEATHROW","QINGDAO",0,0,0
2021,"FAR EAST","CHINA","HEATHROW","SANYA PHOENIX INTERNATIONAL",0,0,0
2021,"FAR EAST","CHINA","HEATHROW","SHANGHAI (PU DONG)",456,251,205
2021,"FAR EAST","CHINA","HEATHROW","SHENZHEN (HUANGTIAN)",0,0,0
2021,"FAR EAST","CHINA","HEATHROW","TIANJIN",0,0,0
2021,"FAR EAST","CHINA","HEATHROW","WUHAN TIANHE INTERNATIONAL",0,0,0
2021,"FAR EAST","CHINA","HEATHROW","XIAN XIANYANG",0,0,0
2021,"FAR EAST","CHINA","HEATHROW","ZHENGZHOU XINZHENG",0,0,0
2021,"FAR EAST","HONG KONG","GATWICK","HONG KONG (CHEK LAP KOK)",0,0,0
2021,"FAR EAST","HONG KONG","HEATHROW","HONG KONG (CHEK LAP KOK)",191096,191096,0
2021,"FAR EAST","INDONESIA","HEATHROW","BALI INTERNATIONAL",0,0,0
2021,"FAR EAST","INDONESIA","HEATHROW","KUALANAMU INTERNATIONAL AIRPORT",0,0,0
2021,"FAR EAST","JAPAN","HEATHROW","NAGOYA",114,114,0
2021,"FAR EAST","JAPAN","HEATHROW","OSAKA (KANSAI)",1161,1161,0
2021,"FAR EAST","JAPAN","HEATHROW","TOKYO (HANEDA)",63795,63795,0
2021,"FAR EAST","JAPAN","HEATHROW","TOKYO (NARITA)",0,0,0
2021,"FAR EAST","MALAYSIA","GATWICK","LANGKAWI",0,0,0
2021,"FAR EAST","MALAYSIA","HEATHROW","KUALA LUMPUR (SEPANG)",14914,14849,65
2021,"FAR EAST","PHILIPPINES","GATWICK","CLARK INTERNATIONAL",0,0,0
2021,"FAR EAST","PHILIPPINES","GATWICK","MANILA",0,0,0
2021,"FAR EAST","PHILIPPINES","HEATHROW","CEBU",0,0,0
2021,"FAR EAST","PHILIPPINES","HEATHROW","CLARK INTERNATIONAL",0,0,0
2021,"FAR EAST","PHILIPPINES","HEATHROW","MANILA",2549,2549,0
2021,"FAR EAST","REPUBLIC OF KOREA","HEATHROW","SEOUL (INCHEON)",21290,21290,0
2021,"FAR EAST","SINGAPORE","HEATHROW","SINGAPORE",187739,187674,65
2021,"FAR EAST","TAIWAN","GATWICK","TAIPEI",0,0,0
2021,"FAR EAST","TAIWAN","HEATHROW","TAIPEI",1617,1617,0
2021,"FAR EAST","THAILAND","GATWICK","PHUKET",468,0,468
2021,"FAR EAST","THAILAND","GATWICK","U-TAPAO",0,0,0
2021,"FAR EAST","THAILAND","HEATHROW","BANGKOK SUVARNABHUMI ",32631,18532,14099
2021,"FAR EAST","THAILAND","HEATHROW","PHUKET",1417,37,1380
2021,"FAR EAST","VIETNAM","GATWICK","PHU QUOC INTERNATIONAL",0,0,0
2021,"FAR EAST","VIETNAM","HEATHROW","HANOI",825,654,171
2021,"FAR EAST","VIETNAM","HEATHROW","HO CHI MINH CITY",346,346,0
2021,"FAR EAST","VIETNAM","STANSTED","HO CHI MINH CITY",0,0,0
2021,"AUSTRALASIA","AUSTRALIA","HEATHROW","DARWIN",10580,10580,0
2021,"AUSTRALASIA","AUSTRALIA","HEATHROW","MELBOURNE",3971,3971,0
2021,"AUSTRALASIA","AUSTRALIA","HEATHROW","PERTH (AUSTRALIA)",179,179,0
2021,"AUSTRALASIA","AUSTRALIA","HEATHROW","SYDNEY",13557,13557,0
2021,"AUSTRALASIA","NEW ZEALAND","HEATHROW","AUCKLAND INTERNATIONAL",0,0,0
2021,"CANADA","CANADA","GATWICK","CALGARY",27739,27739,0
2021,"CANADA","CANADA","GATWICK","TORONTO",47963,47963,0
2021,"CANADA","CANADA","HEATHROW","CALGARY",15127,15127,0
2021,"CANADA","CANADA","HEATHROW","MONTREAL (DORVAL)",55477,55477,0
2021,"CANADA","CANADA","HEATHROW","OTTAWA INTERNATIONAL",0,0,0
2021,"CANADA","CANADA","HEATHROW","TORONTO",297113,297113,0
2021,"CANADA","CANADA","HEATHROW","VANCOUVER",114306,114306,0
2021,"CANADA","CANADA","HEATHROW","WINNIPEG",218,0,218
2021,"UNITED STATES OF AMERICA","USA","GATWICK","AUSTIN (BERGSTROM)",72,0,72
2021,"UNITED STATES OF AMERICA","USA","GATWICK","BOSTON",0,0,0
2021,"UNITED STATES OF AMERICA","USA","GATWICK","HONOLULU",0,0,0
2021,"UNITED STATES OF AMERICA","USA","GATWICK","LAS VEGAS",0,0,0
2021,"UNITED STATES OF AMERICA","USA","GATWICK","LOS ANGELES INTERNATIONAL",0,0,0
2021,"UNITED STATES OF AMERICA","USA","GATWICK","MIAMI INTERNATIONAL",0,0,0
2021,"UNITED STATES OF AMERICA","USA","GATWICK","NEW YORK (JF KENNEDY)",12649,12649,0
2021,"UNITED STATES OF AMERICA","USA","GATWICK","ORLANDO",8118,8118,0
2021,"UNITED STATES OF AMERICA","USA","GATWICK","SAN FRANCISCO",0,0,0
2021,"UNITED STATES OF AMERICA","USA","GATWICK","TAMPA",16381,16381,0
2021,"UNITED STATES OF AMERICA","USA","GATWICK","WILLIAM P HOBBY AIRPORT",449,0,449
2021,"UNITED STATES OF AMERICA","USA","HEATHROW","ATLANTA",164335,164179,156
2021,"UNITED STATES OF AMERICA","USA","HEATHROW","AUSTIN (BERGSTROM)",14209,13035,1174
2021,"UNITED STATES OF AMERICA","USA","HEATHROW","BALTIMORE",5864,5864,0
2021,"UNITED STATES OF AMERICA","USA","HEATHROW","BOSTON",172975,172975,0
2021,"UNITED STATES OF AMERICA","USA","HEATHROW","CHARLOTTE",78121,78121,0
2021,"UNITED STATES OF AMERICA","USA","HEATHROW","CHICAGO (O'HARE)",236746,236746,0
2021,"UNITED STATES OF AMERICA","USA","HEATHROW","DALLAS/FORT WORTH",198773,198773,0
2021,"UNITED STATES OF AMERICA","USA","HEATHROW","DENVER INTERNATIONAL",22158,22158,0
2021,"UNITED STATES OF AMERICA","USA","HEATHROW","DETROIT",13011,13011,0
2021,"UNITED STATES OF AMERICA","USA","HEATHROW","FORT LAUDERDALE",0,0,0
2021,"UNITED STATES OF AMERICA","USA","HEATHROW","HOUSTON",78022,78022,0
2021,"UNITED STATES OF AMERICA","USA","HEATHROW","JACKSONVILLE",140,0,140
2021,"UNITED STATES OF AMERICA","USA","HEATHROW","LAS VEGAS",26767,26767,0
2021,"UNITED STATES OF AMERICA","USA","HEATHROW","LOS ANGELES INTERNATIONAL",287992,287992,0
2021,"UNITED STATES OF AMERICA","USA","HEATHROW","MIAMI INTERNATIONAL",201288,201288,0
2021,"UNITED STATES OF AMERICA","USA","HEATHROW","MILWAUKEE",297,0,297
2021,"UNITED STATES OF AMERICA","USA","HEATHROW","MINNEAPOLIS-ST PAUL",0,0,0
2021,"UNITED STATES OF AMERICA","USA","HEATHROW","NASHVILLE METROPOLITAN",2740,2740,0
2021,"UNITED STATES OF AMERICA","USA","HEATHROW","NEW ORLEANS",2206,2206,0
2021,"UNITED STATES OF AMERICA","USA","HEATHROW","NEW YORK (JF KENNEDY)",615543,615278,265
2021,"UNITED STATES OF AMERICA","USA","HEATHROW","NEW YORK (NEWARK)",140398,140398,0
2021,"UNITED STATES OF AMERICA","USA","HEATHROW","ORLANDO",44763,44763,0
2021,"UNITED STATES OF AMERICA","USA","HEATHROW","PHILADELPHIA INTERNATIONAL",79874,79874,0
2021,"UNITED STATES OF AMERICA","USA","HEATHROW","PHOENIX",31326,31326,0
2021,"UNITED STATES OF AMERICA","USA","HEATHROW","PITTSBURGH",0,0,0
2021,"UNITED STATES OF AMERICA","USA","HEATHROW","RALEIGH",0,0,0
2021,"UNITED STATES OF AMERICA","USA","HEATHROW","SALT LAKE CITY",0,0,0
2021,"UNITED STATES OF AMERICA","USA","HEATHROW","SAN DIEGO",14374,14374,0
2021,"UNITED STATES OF AMERICA","USA","HEATHROW","SAN FRANCISCO",157290,157203,87
2021,"UNITED STATES OF AMERICA","USA","HEATHROW","SAN JOSE",0,0,0
2021,"UNITED STATES OF AMERICA","USA","HEATHROW","SEATTLE (TACOMA)",77833,77833,0
2021,"UNITED STATES OF AMERICA","USA","HEATHROW","WASHINGTON (DULLES)",188355,188355,0
2021,"UNITED STATES OF AMERICA","USA","LONDON CITY","NEW YORK (JF KENNEDY)",0,0,0
2021,"UNITED STATES OF AMERICA","USA","STANSTED","ATLANTA",139,0,139
2021,"UNITED STATES OF AMERICA","USA","STANSTED","MIAMI INTERNATIONAL",160,0,160
2021,"UNITED STATES OF AMERICA","USA","STANSTED","NEW YORK (NEWARK)",294,0,294
2021,"CENTRAL AMERICA","COSTA RICA","GATWICK","LIBERIA",2438,0,2438
2021,"CENTRAL AMERICA","COSTA RICA","GATWICK","SAN JOSE COST RICA",4670,4670,0
2021,"CENTRAL AMERICA","COSTA RICA","HEATHROW","SAN JOSE COST RICA",0,0,0
2021,"CENTRAL AMERICA","CUBA","GATWICK","HAVANA",0,0,0
2021,"CENTRAL AMERICA","CUBA","GATWICK","VARADERO",730,0,730
2021,"CENTRAL AMERICA","CUBA","HEATHROW","HAVANA",0,0,0
2021,"CENTRAL AMERICA","DOMINICAN REPUBLIC","GATWICK","PUNTA CANA",13109,5059,8050
2021,"CENTRAL AMERICA","DOMINICAN REPUBLIC","HEATHROW","PUNTA CANA",0,0,0
2021,"CENTRAL AMERICA","HONDURAS","HEATHROW","SAN PEDRO SULA",0,0,0
2021,"CENTRAL AMERICA","MEXICO","GATWICK","CANCUN",76473,76473,0
2021,"CENTRAL AMERICA","MEXICO","GATWICK","LOS CABOS",0,0,0
2021,"CENTRAL AMERICA","MEXICO","GATWICK","MEXICO CITY",66,66,0
2021,"CENTRAL AMERICA","MEXICO","GATWICK","PUERTO VALLARTA",2929,0,2929
2021,"CENTRAL AMERICA","MEXICO","HEATHROW","CANCUN",1091,1091,0
2021,"CENTRAL AMERICA","MEXICO","HEATHROW","MEXICO CITY",45564,44727,837
2021,"SOUTH AMERICA","ARGENTINA","GATWICK","BUENOS AIRES",0,0,0
2021,"SOUTH AMERICA","ARGENTINA","HEATHROW","BUENOS AIRES",6583,6583,0
2021,"SOUTH AMERICA","BRAZIL","GATWICK","RIO DE JANEIRO (GALEAO)",0,0,0
2021,"SOUTH AMERICA","BRAZIL","HEATHROW","RECIFE",0,0,0
2021,"SOUTH AMERICA","BRAZIL","HEATHROW","RIO DE JANEIRO (GALEAO)",6477,6477,0
2021,"SOUTH AMERICA","BRAZIL","HEATHROW","SAO PAULO (GUARULHOS)",23066,22975,91
2021,"SOUTH AMERICA","CHILE","HEATHROW","SANTIAGO DE CHILE",5241,5241,0
2021,"SOUTH AMERICA","COLOMBIA","HEATHROW","BOGOTA",0,0,0
2021,"SOUTH AMERICA","COLOMBIA","HEATHROW","CARTAGENA",0,0,0
2021,"SOUTH AMERICA","ECUADOR","GATWICK","GUAYAQUIL",0,0,0
2021,"SOUTH AMERICA","ECUADOR","HEATHROW","GUAYAQUIL",0,0,0
2021,"SOUTH AMERICA","ECUADOR","HEATHROW","MARISCAL SUCRE INTERNATIONAL",0,0,0
2021,"SOUTH AMERICA","GUYANA","HEATHROW","GEORGETOWN (GUYANA)",964,0,964
2021,"SOUTH AMERICA","GUYANA","STANSTED","GEORGETOWN (GUYANA)",43,0,43
2021,"SOUTH AMERICA","PERU","GATWICK","JORGE CHAVEZ INTERNATIONAL",0,0,0
2021,"SOUTH AMERICA","PERU","HEATHROW","JORGE CHAVEZ INTERNATIONAL",0,0,0
2021,"SOUTH AMERICA","SURINAM","STANSTED","PARAMARIBO",16,0,16
2021,"CARIBBEAN AREA","ANTIGUA AND BARBUDA","GATWICK","ANTIGUA",71290,71290,0
2021,"CARIBBEAN AREA","ANTIGUA AND BARBUDA","HEATHROW","ANTIGUA",32702,32702,0
2021,"CARIBBEAN AREA","BAHAMAS","HEATHROW","FREEPORT",0,0,0
2021,"CARIBBEAN AREA","BAHAMAS","HEATHROW","NASSAU",37251,37251,0
2021,"CARIBBEAN AREA","BARBADOS","GATWICK","BRIDGETOWN",26483,17008,9475
2021,"CARIBBEAN AREA","BARBADOS","HEATHROW","BRIDGETOWN",159048,159048,0
2021,"CARIBBEAN AREA","BARBADOS","STANSTED","BRIDGETOWN",0,0,0
2021,"CARIBBEAN AREA","BERMUDA","GATWICK","BERMUDA",3043,3043,0
2021,"CARIBBEAN AREA","BERMUDA","HEATHROW","BERMUDA",40224,40224,0
2021,"CARIBBEAN AREA","CAYMAN ISLANDS","GATWICK","GRAND CAYMAN",0,0,0
2021,"CARIBBEAN AREA","CAYMAN ISLANDS","HEATHROW","GRAND CAYMAN",10142,10142,0
2021,"CARIBBEAN AREA","GRENADA","GATWICK","GRENADA",8435,8435,0
2021,"CARIBBEAN AREA","GRENADA","HEATHROW","GRENADA",3161,3161,0
2021,"CARIBBEAN AREA","GUADELOUPE","HEATHROW","POINTE A PITRE GUADELOUPE",0,0,0
2021,"CARIBBEAN AREA","ISLE OF CURACAO NETH.ANTILLES","GATWICK","ARUBA",274,0,274
2021,"CARIBBEAN AREA","ISLE OF CURACAO NETH.ANTILLES","HEATHROW","CURACAO",0,0,0
2021,"CARIBBEAN AREA","ISLE OF CURACAO NETH.ANTILLES","STANSTED","CURACAO",0,0,0
2021,"CARIBBEAN AREA","JAMAICA","GATWICK","KINGSTON",48508,48382,126
2021,"CARIBBEAN AREA","JAMAICA","GATWICK","MONTEGO BAY",40572,16998,23574
2021,"CARIBBEAN AREA","JAMAICA","HEATHROW","KINGSTON",0,0,0
2021,"CARIBBEAN AREA","JAMAICA","HEATHROW","MONTEGO BAY",27325,27325,0
2021,"CARIBBEAN AREA","SAINT KITTS AND NEVIS","GATWICK","ST KITTS",3558,3558,0
2021,"CARIBBEAN AREA","SAINT VINCENT AND THE GRENADINES","HEATHROW","E T JOSHUA",1530,1530,0
2021,"CARIBBEAN AREA","ST LUCIA","GATWICK","ST LUCIA (HEWANORRA)",59390,44777,14613
2021,"CARIBBEAN AREA","ST LUCIA","HEATHROW","ST LUCIA (HEWANORRA)",11240,11240,0
2021,"CARIBBEAN AREA","TRINIDAD AND TOBAGO","GATWICK","PORT OF SPAIN",4880,4880,0
2021,"CARIBBEAN AREA","TRINIDAD AND TOBAGO","GATWICK","TOBAGO",0,0,0
2021,"CARIBBEAN AREA","TURKS AND CAICOS ISLANDS","GATWICK","PROVIDENCIALES",6183,6183,0
2021,"CARIBBEAN AREA","TURKS AND CAICOS ISLANDS","HEATHROW","PROVIDENCIALES",1231,1231,0
2021,"INDIAN OCEAN ISLANDS","MALDIVE ISLANDS","GATWICK","MALE INTERNATIONAL",0,0,0
2021,"INDIAN OCEAN ISLANDS","MALDIVE ISLANDS","HEATHROW","MALE INTERNATIONAL",43221,43221,0
2021,"INDIAN OCEAN ISLANDS","MAURITIUS","GATWICK","MAURITIUS",28560,28560,0
2021,"INDIAN OCEAN ISLANDS","MAURITIUS","HEATHROW","MAURITIUS",21354,21354,0
2021,"INDIAN OCEAN ISLANDS","SEYCHELLES","HEATHROW","SEYCHELLES",272,272,0
2021,"ATLANTIC OCEAN ISLANDS","ASCENSION ISLAND","STANSTED","SAINT HELENA",1280,0,1280
2021,"ATLANTIC OCEAN ISLANDS","CAPE VERDE ISLANDS","GATWICK","BOA VISTA (RABIL)",6575,6575,0
2021,"ATLANTIC OCEAN ISLANDS","CAPE VERDE ISLANDS","GATWICK","ILHA DO SAL C.VERDE",8073,8073,0
2021,"ATLANTIC OCEAN ISLANDS","CAPE VERDE ISLANDS","STANSTED","ILHA DO SAL C.VERDE",0,0,0
2021,"ATLANTIC OCEAN ISLANDS","CAPE VERDE ISLANDS","STANSTED","PRAIA",25,0,25
2021,"ATLANTIC OCEAN ISLANDS","GREENLAND","STANSTED","SONDRE STROMFJORD",431,0,431
2022,"WESTERN EUROPE-EU","AUSTRIA","GATWICK","INNSBRUCK",131247,109163,22084
2022,"WESTERN EUROPE-EU","AUSTRIA","GATWICK","SALZBURG",48452,35061,13391
2022,"WESTERN EUROPE-EU","AUSTRIA","GATWICK","VIENNA",203487,203425,62
2022,"WESTERN EUROPE-EU","AUSTRIA","HEATHROW","INNSBRUCK",36025,36025,0
2022,"WESTERN EUROPE-EU","AUSTRIA","HEATHROW","SALZBURG",26813,26813,0
2022,"WESTERN EUROPE-EU","AUSTRIA","HEATHROW","VIENNA",589365,589365,0
2022,"WESTERN EUROPE-EU","AUSTRIA","LONDON CITY","SALZBURG",2251,2251,0
2022,"WESTERN EUROPE-EU","AUSTRIA","LUTON","INNSBRUCK",8908,3624,5284
2022,"WESTERN EUROPE-EU","AUSTRIA","LUTON","SALZBURG",6220,6220,0
2022,"WESTERN EUROPE-EU","AUSTRIA","LUTON","VIENNA",11964,11841,123
2022,"WESTERN EUROPE-EU","AUSTRIA","STANSTED","INNSBRUCK",9197,4526,4671
2022,"WESTERN EUROPE-EU","AUSTRIA","STANSTED","KLAGENFURT",4640,4640,0
2022,"WESTERN EUROPE-EU","AUSTRIA","STANSTED","SALZBURG",79132,76580,2552
2022,"WESTERN EUROPE-EU","AUSTRIA","STANSTED","VIENNA",226120,226120,0
2022,"WESTERN EUROPE-EU","BELGIUM","HEATHROW","BRUSSELS",431729,431729,0
2022,"WESTERN EUROPE-EU","BELGIUM","LUTON","LIEGE",0,0,0
2022,"WESTERN EUROPE-EU","BELGIUM","LUTON","OSTEND",130,130,0
2022,"WESTERN EUROPE-EU","BELGIUM","STANSTED","BRUSSELS",247,247,0
2022,"WESTERN EUROPE-EU","BELGIUM","STANSTED","CHARLEROI",0,0,0
2022,"WESTERN EUROPE-EU","CROATIA","GATWICK","DUBROVNIK",196255,193525,2730
2022,"WESTERN EUROPE-EU","CROATIA","GATWICK","PULA",42126,28295,13831
2022,"WESTERN EUROPE-EU","CROATIA","GATWICK","RIJEKA",1308,1234,74
2022,"WESTERN EUROPE-EU","CROATIA","GATWICK","SPLIT",158855,143047,15808
2022,"WESTERN EUROPE-EU","CROATIA","GATWICK","ZADAR",13698,13575,123
2022,"WESTERN EUROPE-EU","CROATIA","GATWICK","ZAGREB",133,133,0
2022,"WESTERN EUROPE-EU","CROATIA","HEATHROW","DUBROVNIK",37187,37187,0
2022,"WESTERN EUROPE-EU","CROATIA","HEATHROW","PULA",8747,8747,0
2022,"WESTERN EUROPE-EU","CROATIA","HEATHROW","SPLIT",59830,59830,0
2022,"WESTERN EUROPE-EU","CROATIA","HEATHROW","ZAGREB",108463,108186,277
2022,"WESTERN EUROPE-EU","CROATIA","LONDON CITY","SPLIT",5007,5007,0
2022,"WESTERN EUROPE-EU","CROATIA","LUTON","DUBROVNIK",20307,20124,183
2022,"WESTERN EUROPE-EU","CROATIA","LUTON","PULA",10598,10598,0
2022,"WESTERN EUROPE-EU","CROATIA","LUTON","SPLIT",92327,92327,0
2022,"WESTERN EUROPE-EU","CROATIA","LUTON","ZAGREB",209,209,0
2022,"WESTERN EUROPE-EU","CROATIA","STANSTED","DUBROVNIK",36206,36206,0
2022,"WESTERN EUROPE-EU","CROATIA","STANSTED","PULA",23500,23500,0
2022,"WESTERN EUROPE-EU","CROATIA","STANSTED","RIJEKA",15883,15883,0
2022,"WESTERN EUROPE-EU","CROATIA","STANSTED","SPLIT",15050,15050,0
2022,"WESTERN EUROPE-EU","CROATIA","STANSTED","ZADAR",42883,42883,0
2022,"WESTERN EUROPE-EU","CROATIA","STANSTED","ZAGREB",100537,100537,0
2022,"WESTERN EUROPE-EU","CYPRUS","GATWICK","LARNACA",322303,275267,47036
2022,"WESTERN EUROPE-EU","CYPRUS","GATWICK","PAPHOS",358312,284234,74078
2022,"WESTERN EUROPE-EU","CYPRUS","HEATHROW","LARNACA",313479,313479,0
2022,"WESTERN EUROPE-EU","CYPRUS","HEATHROW","PAPHOS",15987,15987,0
2022,"WESTERN EUROPE-EU","CYPRUS","LUTON","LARNACA",115891,115891,0
2022,"WESTERN EUROPE-EU","CYPRUS","LUTON","PAPHOS",50349,50179,170
2022,"WESTERN EUROPE-EU","CYPRUS","STANSTED","LARNACA",51997,51997,0
2022,"WESTERN EUROPE-EU","CYPRUS","STANSTED","PAPHOS",210261,188198,22063
2022,"WESTERN EUROPE-EU","DENMARK","GATWICK","COPENHAGEN",511928,511928,0
2022,"WESTERN EUROPE-EU","DENMARK","GATWICK","ROSKILDE",0,0,0
2022,"WESTERN EUROPE-EU","DENMARK","HEATHROW","BILLUND",57054,57054,0
2022,"WESTERN EUROPE-EU","DENMARK","HEATHROW","COPENHAGEN",659919,659748,171
2022,"WESTERN EUROPE-EU","DENMARK","LONDON CITY","BILLUND",2208,2208,0
2022,"WESTERN EUROPE-EU","DENMARK","LUTON","COPENHAGEN",168,0,168
2022,"WESTERN EUROPE-EU","DENMARK","STANSTED","AALBORG",37621,37621,0
2022,"WESTERN EUROPE-EU","DENMARK","STANSTED","AARHUS (TIRSTRUP)",84316,84316,0
2022,"WESTERN EUROPE-EU","DENMARK","STANSTED","BILLUND",201706,201706,0
2022,"WESTERN EUROPE-EU","DENMARK","STANSTED","COPENHAGEN",318573,318286,287
2022,"WESTERN EUROPE-EU","FINLAND","GATWICK","ENONTEKIO",5221,0,5221
2022,"WESTERN EUROPE-EU","FINLAND","GATWICK","HELSINKI",74311,74311,0
2022,"WESTERN EUROPE-EU","FINLAND","GATWICK","IVALO",8118,0,8118
2022,"WESTERN EUROPE-EU","FINLAND","GATWICK","KITTILA",16571,0,16571
2022,"WESTERN EUROPE-EU","FINLAND","GATWICK","KUUSAMO",7241,0,7241
2022,"WESTERN EUROPE-EU","FINLAND","GATWICK","ROVANIEMI",25475,13094,12381
2022,"WESTERN EUROPE-EU","FINLAND","HEATHROW","HELSINKI",430778,430778,0
2022,"WESTERN EUROPE-EU","FINLAND","HEATHROW","KITTILA",2319,0,2319
2022,"WESTERN EUROPE-EU","FINLAND","LUTON","IVALO",866,0,866
2022,"WESTERN EUROPE-EU","FINLAND","STANSTED","ENONTEKIO",2068,0,2068
2022,"WESTERN EUROPE-EU","FINLAND","STANSTED","HELSINKI",112415,112415,0
2022,"WESTERN EUROPE-EU","FINLAND","STANSTED","IVALO",3034,0,3034
2022,"WESTERN EUROPE-EU","FINLAND","STANSTED","KITTILA",559,191,368
2022,"WESTERN EUROPE-EU","FINLAND","STANSTED","KUUSAMO",4010,0,4010
2022,"WESTERN EUROPE-EU","FINLAND","STANSTED","ROVANIEMI",12114,11946,168
2022,"WESTERN EUROPE-EU","FINLAND","STANSTED","TAMPERE",26524,26524,0
2022,"WESTERN EUROPE-EU","FRANCE","GATWICK","BASTIA",11483,11483,0
2022,"WESTERN EUROPE-EU","FRANCE","GATWICK","BIARRITZ",32523,32523,0
2022,"WESTERN EUROPE-EU","FRANCE","GATWICK","BORDEAUX",246937,246937,0
2022,"WESTERN EUROPE-EU","FRANCE","GATWICK","CHALONS (VATRY)",53,0,53
2022,"WESTERN EUROPE-EU","FRANCE","GATWICK","CHAMBERY",35222,0,35222
2022,"WESTERN EUROPE-EU","FRANCE","GATWICK","FIGARI",4730,4730,0
2022,"WESTERN EUROPE-EU","FRANCE","GATWICK","GRENOBLE",35772,19112,16660
2022,"WESTERN EUROPE-EU","FRANCE","GATWICK","LA ROCHELLE",21593,21593,0
2022,"WESTERN EUROPE-EU","FRANCE","GATWICK","LILLE",176,0,176
2022,"WESTERN EUROPE-EU","FRANCE","GATWICK","LIMOGES",13554,13554,0
2022,"WESTERN EUROPE-EU","FRANCE","GATWICK","LYON",181348,167068,14280
2022,"WESTERN EUROPE-EU","FRANCE","GATWICK","LYON(BRON)",0,0,0
2022,"WESTERN EUROPE-EU","FRANCE","GATWICK","MARSEILLE",117607,117607,0
2022,"WESTERN EUROPE-EU","FRANCE","GATWICK","MONTPELLIER",114145,113821,324
2022,"WESTERN EUROPE-EU","FRANCE","GATWICK","NANTES",107538,107538,0
2022,"WESTERN EUROPE-EU","FRANCE","GATWICK","NICE",449190,447747,1443
2022,"WESTERN EUROPE-EU","FRANCE","GATWICK","PARIS (CHARLES DE GAULLE)",309910,309910,0
2022,"WESTERN EUROPE-EU","FRANCE","GATWICK","PARIS (LE BOURGET)",50,0,50
2022,"WESTERN EUROPE-EU","FRANCE","GATWICK","PARIS (ORLY)",205398,205398,0
2022,"WESTERN EUROPE-EU","FRANCE","GATWICK","PAU",0,0,0
2022,"WESTERN EUROPE-EU","FRANCE","GATWICK","RENNES",24327,24327,0
2022,"WESTERN EUROPE-EU","FRANCE","GATWICK","TOULON / HYERES",8816,8816,0
2022,"WESTERN EUROPE-EU","FRANCE","GATWICK","TOULOUSE (BLAGNAC)",100624,91269,9355
2022,"WESTERN EUROPE-EU","FRANCE","HEATHROW","BASTIA",4141,4141,0
2022,"WESTERN EUROPE-EU","FRANCE","HEATHROW","BORDEAUX",357,357,0
2022,"WESTERN EUROPE-EU","FRANCE","HEATHROW","FIGARI",8908,8908,0
2022,"WESTERN EUROPE-EU","FRANCE","HEATHROW","GRENOBLE",18883,10644,8239
2022,"WESTERN EUROPE-EU","FRANCE","HEATHROW","LYON",194108,189997,4111
2022,"WESTERN EUROPE-EU","FRANCE","HEATHROW","MARSEILLE",196559,196559,0
2022,"WESTERN EUROPE-EU","FRANCE","HEATHROW","MONTPELLIER",0,0,0
2022,"WESTERN EUROPE-EU","FRANCE","HEATHROW","NICE",460199,460199,0
2022,"WESTERN EUROPE-EU","FRANCE","HEATHROW","PARIS (CHARLES DE GAULLE)",917541,917266,275
2022,"WESTERN EUROPE-EU","FRANCE","HEATHROW","TOULOUSE (BLAGNAC)",175269,174983,286
2022,"WESTERN EUROPE-EU","FRANCE","LONDON CITY","BERGERAC",12772,12772,0
2022,"WESTERN EUROPE-EU","FRANCE","LONDON CITY","CHAMBERY",3770,3770,0
2022,"WESTERN EUROPE-EU","FRANCE","LONDON CITY","NICE",55586,55586,0
2022,"WESTERN EUROPE-EU","FRANCE","LONDON CITY","QUIMPER",6790,6790,0
2022,"WESTERN EUROPE-EU","FRANCE","LUTON","BEZIERS",19415,19415,0
2022,"WESTERN EUROPE-EU","FRANCE","LUTON","BORDEAUX",45024,45024,0
2022,"WESTERN EUROPE-EU","FRANCE","LUTON","GRENOBLE",11722,11722,0
2022,"WESTERN EUROPE-EU","FRANCE","LUTON","LYON",68206,68206,0
2022,"WESTERN EUROPE-EU","FRANCE","LUTON","MARSEILLE",357,0,357
2022,"WESTERN EUROPE-EU","FRANCE","LUTON","MONTPELLIER",5641,5641,0
2022,"WESTERN EUROPE-EU","FRANCE","LUTON","NANTES",177,177,0
2022,"WESTERN EUROPE-EU","FRANCE","LUTON","NICE",72670,72670,0
2022,"WESTERN EUROPE-EU","FRANCE","LUTON","PARIS (CHARLES DE GAULLE)",243990,243990,0
2022,"WESTERN EUROPE-EU","FRANCE","LUTON","PARIS (LE BOURGET)",135,135,0
2022,"WESTERN EUROPE-EU","FRANCE","LUTON","TOULOUSE (BLAGNAC)",104,104,0
2022,"WESTERN EUROPE-EU","FRANCE","SOUTHEND","BREST",0,0,0
2022,"WESTERN EUROPE-EU","FRANCE","SOUTHEND","MARSEILLE",232,0,232
2022,"WESTERN EUROPE-EU","FRANCE","STANSTED","AJACCIO",5436,5436,0
2022,"WESTERN EUROPE-EU","FRANCE","STANSTED","BERGERAC",66883,66883,0
2022,"WESTERN EUROPE-EU","FRANCE","STANSTED","BEZIERS",24847,24847,0
2022,"WESTERN EUROPE-EU","FRANCE","STANSTED","BIARRITZ",71199,71199,0
2022,"WESTERN EUROPE-EU","FRANCE","STANSTED","BORDEAUX",82483,82483,0
2022,"WESTERN EUROPE-EU","FRANCE","STANSTED","BRIVE-LA-GAILLARDE",14989,14989,0
2022,"WESTERN EUROPE-EU","FRANCE","STANSTED","CALVI",126,126,0
2022,"WESTERN EUROPE-EU","FRANCE","STANSTED","CARCASSONNE",56336,56336,0
2022,"WESTERN EUROPE-EU","FRANCE","STANSTED","CHAMBERY",9330,5224,4106
2022,"WESTERN EUROPE-EU","FRANCE","STANSTED","CLERMONT FERRAND",53,53,0
2022,"WESTERN EUROPE-EU","FRANCE","STANSTED","DOLE",323,323,0
2022,"WESTERN EUROPE-EU","FRANCE","STANSTED","GRENOBLE",16599,15728,871
2022,"WESTERN EUROPE-EU","FRANCE","STANSTED","LA ROCHELLE",37161,37161,0
2022,"WESTERN EUROPE-EU","FRANCE","STANSTED","LIMOGES",62034,62034,0
2022,"WESTERN EUROPE-EU","FRANCE","STANSTED","LYON",1098,0,1098
2022,"WESTERN EUROPE-EU","FRANCE","STANSTED","MARSEILLE",148838,148767,71
2022,"WESTERN EUROPE-EU","FRANCE","STANSTED","MONTPELLIER",372,372,0
2022,"WESTERN EUROPE-EU","FRANCE","STANSTED","NANTES",81383,81383,0
2022,"WESTERN EUROPE-EU","FRANCE","STANSTED","NICE",57789,57789,0
2022,"WESTERN EUROPE-EU","FRANCE","STANSTED","NIMES",8628,8628,0
2022,"WESTERN EUROPE-EU","FRANCE","STANSTED","PARIS (ORLY)",2581,2581,0
2022,"WESTERN EUROPE-EU","FRANCE","STANSTED","PERPIGNAN",34605,34605,0
2022,"WESTERN EUROPE-EU","FRANCE","STANSTED","POITIERS",41628,41628,0
2022,"WESTERN EUROPE-EU","FRANCE","STANSTED","RODEZ",11412,11412,0
2022,"WESTERN EUROPE-EU","FRANCE","STANSTED","TARBES-LOURDES INTERNATIONAL",55176,53195,1981
2022,"WESTERN EUROPE-EU","FRANCE","STANSTED","TOULOUSE (BLAGNAC)",142781,142781,0
2022,"WESTERN EUROPE-EU","FRANCE","STANSTED","TOURS",35981,35981,0
2022,"WESTERN EUROPE-EU","GERMANY","GATWICK","BERLIN BRANDENBURG",345743,345743,0
2022,"WESTERN EUROPE-EU","GERMANY","GATWICK","BRAUNSCHWEIG",0,0,0
2022,"WESTERN EUROPE-EU","GERMANY","GATWICK","COLOGNE BONN",32061,31764,297
2022,"WESTERN EUROPE-EU","GERMANY","GATWICK","DUSSELDORF",95,0,95
2022,"WESTERN EUROPE-EU","GERMANY","GATWICK","FRANKFURT MAIN",0,0,0
2022,"WESTERN EUROPE-EU","GERMANY","GATWICK","FRIEDRICHSHAFEN",2542,2542,0
2022,"WESTERN EUROPE-EU","GERMANY","GATWICK","HAMBURG",79244,79082,162
2022,"WESTERN EUROPE-EU","GERMANY","GATWICK","MUNICH",132494,132316,178
2022,"WESTERN EUROPE-EU","GERMANY","HEATHROW","BERLIN BRANDENBURG",383555,383555,0
2022,"WESTERN EUROPE-EU","GERMANY","HEATHROW","COLOGNE BONN",108450,108450,0
2022,"WESTERN EUROPE-EU","GERMANY","HEATHROW","DUSSELDORF",410770,410770,0
2022,"WESTERN EUROPE-EU","GERMANY","HEATHROW","FRANKFURT MAIN",1046015,1046015,0
2022,"WESTERN EUROPE-EU","GERMANY","HEATHROW","HAMBURG",382428,382428,0
2022,"WESTERN EUROPE-EU","GERMANY","HEATHROW","HANOVER",85779,85779,0
2022,"WESTERN EUROPE-EU","GERMANY","HEATHROW","LEIPZIG",250,0,250
2022,"WESTERN EUROPE-EU","GERMANY","HEATHROW","MUNICH",933939,933939,0
2022,"WESTERN EUROPE-EU","GERMANY","HEATHROW","NUREMBERG",47632,47632,0
2022,"WESTERN EUROPE-EU","GERMANY","HEATHROW","STUTTGART",246956,246956,0
2022,"WESTERN EUROPE-EU","GERMANY","LONDON CITY","BERLIN BRANDENBURG",136281,136281,0
2022,"WESTERN EUROPE-EU","GERMANY","LONDON CITY","DUSSELDORF",118997,118997,0
2022,"WESTERN EUROPE-EU","GERMANY","LONDON CITY","FRANKFURT MAIN",226711,226711,0
2022,"WESTERN EUROPE-EU","GERMANY","LUTON","BERLIN BRANDENBURG",42319,42319,0
2022,"WESTERN EUROPE-EU","GERMANY","LUTON","COLOGNE BONN",343,343,0
2022,"WESTERN EUROPE-EU","GERMANY","LUTON","FRANKFURT MAIN",173,173,0
2022,"WESTERN EUROPE-EU","GERMANY","LUTON","HAMBURG",174,174,0
2022,"WESTERN EUROPE-EU","GERMANY","LUTON","MUNSTER-OSNABRUCK",138,138,0
2022,"WESTERN EUROPE-EU","GERMANY","LUTON","NIEDERRHEIN",0,0,0
2022,"WESTERN EUROPE-EU","GERMANY","LUTON","NUREMBERG",0,0,0
2022,"WESTERN EUROPE-EU","GERMANY","LUTON","PADERBORN",429,429,0
2022,"WESTERN EUROPE-EU","GERMANY","LUTON","STUTTGART",0,0,0
2022,"WESTERN EUROPE-EU","GERMANY","STANSTED","BERLIN BRANDENBURG",319487,319487,0
2022,"WESTERN EUROPE-EU","GERMANY","STANSTED","BRAUNSCHWEIG",58,0,58
2022,"WESTERN EUROPE-EU","GERMANY","STANSTED","BREMEN",139970,139970,0
2022,"WESTERN EUROPE-EU","GERMANY","STANSTED","COLOGNE BONN",243355,243355,0
2022,"WESTERN EUROPE-EU","GERMANY","STANSTED","DORTMUND",62826,62826,0
2022,"WESTERN EUROPE-EU","GERMANY","STANSTED","DRESDEN",36278,36278,0
2022,"WESTERN EUROPE-EU","GERMANY","STANSTED","FRANKFURT MAIN",30818,29676,1142
2022,"WESTERN EUROPE-EU","GERMANY","STANSTED","HAHN",84075,84075,0
2022,"WESTERN EUROPE-EU","GERMANY","STANSTED","HAMBURG",158188,158188,0
2022,"WESTERN EUROPE-EU","GERMANY","STANSTED","KARLSRUHE/BADEN BADEN",105518,105518,0
2022,"WESTERN EUROPE-EU","GERMANY","STANSTED","LEIPZIG",7723,7723,0
2022,"WESTERN EUROPE-EU","GERMANY","STANSTED","MEMMINGEN ALLGAU",59946,59946,0
2022,"WESTERN EUROPE-EU","GERMANY","STANSTED","MUNICH",125,0,125
2022,"WESTERN EUROPE-EU","GERMANY","STANSTED","NIEDERRHEIN",273,273,0
2022,"WESTERN EUROPE-EU","GERMANY","STANSTED","NUREMBERG",131291,131291,0
2022,"WESTERN EUROPE-EU","GIBRALTAR","GATWICK","GIBRALTAR",153043,153043,0
2022,"WESTERN EUROPE-EU","GIBRALTAR","HEATHROW","GIBRALTAR",152468,152366,102
2022,"WESTERN EUROPE-EU","GIBRALTAR","LONDON CITY","GIBRALTAR",0,0,0
2022,"WESTERN EUROPE-EU","GIBRALTAR","LUTON","GIBRALTAR",388,388,0
2022,"WESTERN EUROPE-EU","GIBRALTAR","STANSTED","GIBRALTAR",0,0,0
2022,"WESTERN EUROPE-EU","GREECE","GATWICK","ATHENS",316229,316229,0
2022,"WESTERN EUROPE-EU","GREECE","GATWICK","CHANIA",193660,165003,28657
2022,"WESTERN EUROPE-EU","GREECE","GATWICK","CORFU",249881,207822,42059
2022,"WESTERN EUROPE-EU","GREECE","GATWICK","HERAKLION",232851,182825,50026
2022,"WESTERN EUROPE-EU","GREECE","GATWICK","KALAMATA",48829,40328,8501
2022,"WESTERN EUROPE-EU","GREECE","GATWICK","KAVALA",13082,0,13082
2022,"WESTERN EUROPE-EU","GREECE","GATWICK","KEFALLINIA",132296,106282,26014
2022,"WESTERN EUROPE-EU","GREECE","GATWICK","KOS",127065,72292,54773
2022,"WESTERN EUROPE-EU","GREECE","GATWICK","LEMNOS",6168,6168,0
2022,"WESTERN EUROPE-EU","GREECE","GATWICK","MIKONOS",103614,103614,0
2022,"WESTERN EUROPE-EU","GREECE","GATWICK","NEA ANCHIALOS",14820,14820,0
2022,"WESTERN EUROPE-EU","GREECE","GATWICK","PREVEZA",109124,87147,21977
2022,"WESTERN EUROPE-EU","GREECE","GATWICK","RHODES",246034,187306,58728
2022,"WESTERN EUROPE-EU","GREECE","GATWICK","SALONIKA",162847,146860,15987
2022,"WESTERN EUROPE-EU","GREECE","GATWICK","SAMOS",6850,0,6850
2022,"WESTERN EUROPE-EU","GREECE","GATWICK","SKIATHOS",24549,3708,20841
2022,"WESTERN EUROPE-EU","GREECE","GATWICK","THIRA (SANTORINI)",136031,136031,0
2022,"WESTERN EUROPE-EU","GREECE","GATWICK","ZAKINTHOS",130194,90753,39441
2022,"WESTERN EUROPE-EU","GREECE","HEATHROW","ATHENS",764419,764419,0
2022,"WESTERN EUROPE-EU","GREECE","HEATHROW","CHANIA",38450,38450,0
2022,"WESTERN EUROPE-EU","GREECE","HEATHROW","CORFU",104037,104037,0
2022,"WESTERN EUROPE-EU","GREECE","HEATHROW","HERAKLION",51287,51287,0
2022,"WESTERN EUROPE-EU","GREECE","HEATHROW","KALAMATA",15055,15055,0
2022,"WESTERN EUROPE-EU","GREECE","HEATHROW","KEFALLINIA",14670,14670,0
2022,"WESTERN EUROPE-EU","GREECE","HEATHROW","KOS",15690,15690,0
2022,"WESTERN EUROPE-EU","GREECE","HEATHROW","MIKONOS",55496,55496,0
2022,"WESTERN EUROPE-EU","GREECE","HEATHROW","PREVEZA",21802,21802,0
2022,"WESTERN EUROPE-EU","GREECE","HEATHROW","RHODES",24519,24519,0
2022,"WESTERN EUROPE-EU","GREECE","HEATHROW","SALONIKA",47029,47029,0
2022,"WESTERN EUROPE-EU","GREECE","HEATHROW","THIRA (SANTORINI)",65011,65011,0
2022,"WESTERN EUROPE-EU","GREECE","HEATHROW","ZAKINTHOS",9637,9637,0
2022,"WESTERN EUROPE-EU","GREECE","LONDON CITY","MIKONOS",15791,15791,0
2022,"WESTERN EUROPE-EU","GREECE","LONDON CITY","SALONIKA",1506,1506,0
2022,"WESTERN EUROPE-EU","GREECE","LONDON CITY","SKIATHOS",5662,5662,0
2022,"WESTERN EUROPE-EU","GREECE","LONDON CITY","THIRA (SANTORINI)",2848,2848,0
2022,"WESTERN EUROPE-EU","GREECE","LUTON","ATHENS",86209,86209,0
2022,"WESTERN EUROPE-EU","GREECE","LUTON","CHANIA",14841,14841,0
2022,"WESTERN EUROPE-EU","GREECE","LUTON","CORFU",87273,72750,14523
2022,"WESTERN EUROPE-EU","GREECE","LUTON","HERAKLION",40315,40315,0
2022,"WESTERN EUROPE-EU","GREECE","LUTON","KALAMATA",204,0,204
2022,"WESTERN EUROPE-EU","GREECE","LUTON","KEFALLINIA",4931,4931,0
2022,"WESTERN EUROPE-EU","GREECE","LUTON","KOS",7266,0,7266
2022,"WESTERN EUROPE-EU","GREECE","LUTON","MIKONOS",16644,16644,0
2022,"WESTERN EUROPE-EU","GREECE","LUTON","PREVEZA",2169,2169,0
2022,"WESTERN EUROPE-EU","GREECE","LUTON","RHODES",57224,39312,17912
2022,"WESTERN EUROPE-EU","GREECE","LUTON","SALONIKA",61306,61306,0
2022,"WESTERN EUROPE-EU","GREECE","LUTON","SKIATHOS",5598,173,5425
2022,"WESTERN EUROPE-EU","GREECE","LUTON","THIRA (SANTORINI)",26115,26115,0
2022,"WESTERN EUROPE-EU","GREECE","LUTON","ZAKINTHOS",27859,27859,0
2022,"WESTERN EUROPE-EU","GREECE","SOUTHEND","ATHENS",143,143,0
2022,"WESTERN EUROPE-EU","GREECE","SOUTHEND","CORFU",0,0,0
2022,"WESTERN EUROPE-EU","GREECE","SOUTHEND","KAVALA",0,0,0
2022,"WESTERN EUROPE-EU","GREECE","STANSTED","ATHENS",126138,126138,0
2022,"WESTERN EUROPE-EU","GREECE","STANSTED","CHANIA",62603,62603,0
2022,"WESTERN EUROPE-EU","GREECE","STANSTED","CORFU",87318,72863,14455
2022,"WESTERN EUROPE-EU","GREECE","STANSTED","HERAKLION",87538,72619,14919
2022,"WESTERN EUROPE-EU","GREECE","STANSTED","KALAMATA",16697,16316,381
2022,"WESTERN EUROPE-EU","GREECE","STANSTED","KEFALLINIA",59574,46129,13445
2022,"WESTERN EUROPE-EU","GREECE","STANSTED","KOS",37853,37853,0
2022,"WESTERN EUROPE-EU","GREECE","STANSTED","MYTILINI",7310,7310,0
2022,"WESTERN EUROPE-EU","GREECE","STANSTED","PREVEZA",33428,33428,0
2022,"WESTERN EUROPE-EU","GREECE","STANSTED","RHODES",144636,127041,17595
2022,"WESTERN EUROPE-EU","GREECE","STANSTED","SALONIKA",123350,123350,0
2022,"WESTERN EUROPE-EU","GREECE","STANSTED","SKIATHOS",20774,20774,0
2022,"WESTERN EUROPE-EU","GREECE","STANSTED","THIRA (SANTORINI)",38789,38789,0
2022,"WESTERN EUROPE-EU","GREECE","STANSTED","ZAKINTHOS",54146,46890,7256
2022,"WESTERN EUROPE-EU","IRISH REPUBLIC","GATWICK","CORK",110358,110358,0
2022,"WESTERN EUROPE-EU","IRISH REPUBLIC","GATWICK","DUBLIN",1155114,1155037,77
2022,"WESTERN EUROPE-EU","IRISH REPUBLIC","GATWICK","IRELAND WEST(KNOCK)",63708,63708,0
2022,"WESTERN EUROPE-EU","IRISH REPUBLIC","GATWICK","SHANNON",109094,109094,0
2022,"WESTERN EUROPE-EU","IRISH REPUBLIC","HEATHROW","CORK",297556,297556,0
2022,"WESTERN EUROPE-EU","IRISH REPUBLIC","HEATHROW","DUBLIN",1320119,1320004,115
2022,"WESTERN EUROPE-EU","IRISH REPUBLIC","HEATHROW","SHANNON",194272,194272,0
2022,"WESTERN EUROPE-EU","IRISH REPUBLIC","LONDON CITY","DUBLIN",206945,206945,0
2022,"WESTERN EUROPE-EU","IRISH REPUBLIC","LUTON","CORK",68339,68339,0
2022,"WESTERN EUROPE-EU","IRISH REPUBLIC","LUTON","DUBLIN",328568,328568,0
2022,"WESTERN EUROPE-EU","IRISH REPUBLIC","LUTON","IRELAND WEST(KNOCK)",128994,128994,0
2022,"WESTERN EUROPE-EU","IRISH REPUBLIC","LUTON","KERRY COUNTY",101351,101351,0
2022,"WESTERN EUROPE-EU","IRISH REPUBLIC","LUTON","SHANNON",3593,3593,0
2022,"WESTERN EUROPE-EU","IRISH REPUBLIC","STANSTED","CORK",263107,263107,0
2022,"WESTERN EUROPE-EU","IRISH REPUBLIC","STANSTED","DUBLIN",815761,815387,374
2022,"WESTERN EUROPE-EU","IRISH REPUBLIC","STANSTED","IRELAND WEST(KNOCK)",143243,143243,0
2022,"WESTERN EUROPE-EU","IRISH REPUBLIC","STANSTED","KERRY COUNTY",69848,69848,0
2022,"WESTERN EUROPE-EU","IRISH REPUBLIC","STANSTED","SHANNON",192173,192000,173
2022,"WESTERN EUROPE-EU","ITALY","GATWICK","BARI (PALESE)",120287,120287,0
2022,"WESTERN EUROPE-EU","ITALY","GATWICK","BERGAMO",39781,39781,0
2022,"WESTERN EUROPE-EU","ITALY","GATWICK","BOLOGNA",35658,35658,0
2022,"WESTERN EUROPE-EU","ITALY","GATWICK","BRINDISI",22447,22447,0
2022,"WESTERN EUROPE-EU","ITALY","GATWICK","CAGLIARI (ELMAS)",61665,58917,2748
2022,"WESTERN EUROPE-EU","ITALY","GATWICK","CATANIA (FONTANAROSSA)",201103,200837,266
2022,"WESTERN EUROPE-EU","ITALY","GATWICK","FLORENCE",130618,130618,0
2022,"WESTERN EUROPE-EU","ITALY","GATWICK","GENOA",12045,11998,47
2022,"WESTERN EUROPE-EU","ITALY","GATWICK","LAMETIA-TERME",8211,0,8211
2022,"WESTERN EUROPE-EU","ITALY","GATWICK","MILAN (LINATE)",84274,84272,2
2022,"WESTERN EUROPE-EU","ITALY","GATWICK","MILAN (MALPENSA)",553763,553636,127
2022,"WESTERN EUROPE-EU","ITALY","GATWICK","NAPLES",266352,246268,20084
2022,"WESTERN EUROPE-EU","ITALY","GATWICK","OLBIA",90867,78898,11969
2022,"WESTERN EUROPE-EU","ITALY","GATWICK","PALERMO",63455,63455,0
2022,"WESTERN EUROPE-EU","ITALY","GATWICK","PISA",153477,153477,0
2022,"WESTERN EUROPE-EU","ITALY","GATWICK","ROME (CIAMPINO)",0,0,0
2022,"WESTERN EUROPE-EU","ITALY","GATWICK","ROME (FIUMICINO)",573555,571788,1767
2022,"WESTERN EUROPE-EU","ITALY","GATWICK","TRIESTE (RONCHI DEI LEGIONARI)",104,0,104
2022,"WESTERN EUROPE-EU","ITALY","GATWICK","TURIN",111412,95356,16056
2022,"WESTERN EUROPE-EU","ITALY","GATWICK","VENICE",323812,323812,0
2022,"WESTERN EUROPE-EU","ITALY","GATWICK","VERONA VILLAFRANCA",173664,155596,18068
2022,"WESTERN EUROPE-EU","ITALY","HEATHROW","BARI (PALESE)",0,0,0
2022,"WESTERN EUROPE-EU","ITALY","HEATHROW","BERGAMO",914,914,0
2022,"WESTERN EUROPE-EU","ITALY","HEATHROW","BOLOGNA",201891,201891,0
2022,"WESTERN EUROPE-EU","ITALY","HEATHROW","BRINDISI",26292,26292,0
2022,"WESTERN EUROPE-EU","ITALY","HEATHROW","CATANIA (FONTANAROSSA)",30080,30080,0
2022,"WESTERN EUROPE-EU","ITALY","HEATHROW","FLORENCE",346,346,0
2022,"WESTERN EUROPE-EU","ITALY","HEATHROW","MILAN (LINATE)",463266,463266,0
2022,"WESTERN EUROPE-EU","ITALY","HEATHROW","MILAN (MALPENSA)",216926,216926,0
2022,"WESTERN EUROPE-EU","ITALY","HEATHROW","NAPLES",180259,180259,0
2022,"WESTERN EUROPE-EU","ITALY","HEATHROW","OLBIA",38509,38509,0
2022,"WESTERN EUROPE-EU","ITALY","HEATHROW","PALERMO",22472,22472,0
2022,"WESTERN EUROPE-EU","ITALY","HEATHROW","PERUGIA",19610,19610,0
2022,"WESTERN EUROPE-EU","ITALY","HEATHROW","PISA",134557,134557,0
2022,"WESTERN EUROPE-EU","ITALY","HEATHROW","RIMINI",0,0,0
2022,"WESTERN EUROPE-EU","ITALY","HEATHROW","ROME (FIUMICINO)",576295,576180,115
2022,"WESTERN EUROPE-EU","ITALY","HEATHROW","TURIN",29260,29260,0
2022,"WESTERN EUROPE-EU","ITALY","HEATHROW","VENICE",296739,296739,0
2022,"WESTERN EUROPE-EU","ITALY","HEATHROW","VERONA VILLAFRANCA",5494,5494,0
2022,"WESTERN EUROPE-EU","ITALY","LONDON CITY","FLORENCE",95467,95467,0
2022,"WESTERN EUROPE-EU","ITALY","LONDON CITY","MILAN (LINATE)",81499,81499,0
2022,"WESTERN EUROPE-EU","ITALY","LONDON CITY","MILAN (MALPENSA)",31350,31350,0
2022,"WESTERN EUROPE-EU","ITALY","LONDON CITY","PISA",132,132,0
2022,"WESTERN EUROPE-EU","ITALY","LUTON","BARI (PALESE)",123,123,0
2022,"WESTERN EUROPE-EU","ITALY","LUTON","BOLOGNA",54924,54755,169
2022,"WESTERN EUROPE-EU","ITALY","LUTON","CATANIA (FONTANAROSSA)",71082,71082,0
2022,"WESTERN EUROPE-EU","ITALY","LUTON","MILAN (MALPENSA)",92489,92489,0
2022,"WESTERN EUROPE-EU","ITALY","LUTON","NAPLES",134023,133802,221
2022,"WESTERN EUROPE-EU","ITALY","LUTON","OLBIA",9149,9149,0
2022,"WESTERN EUROPE-EU","ITALY","LUTON","PALERMO",27403,27403,0
2022,"WESTERN EUROPE-EU","ITALY","LUTON","PISA",17301,17301,0
2022,"WESTERN EUROPE-EU","ITALY","LUTON","RIMINI",0,0,0
2022,"WESTERN EUROPE-EU","ITALY","LUTON","ROME (FIUMICINO)",12197,12197,0
2022,"WESTERN EUROPE-EU","ITALY","LUTON","TURIN",3981,3981,0
2022,"WESTERN EUROPE-EU","ITALY","LUTON","VENICE",30949,30949,0
2022,"WESTERN EUROPE-EU","ITALY","STANSTED","ALGHERO (FERTILIA)",24778,24778,0
2022,"WESTERN EUROPE-EU","ITALY","STANSTED","ANCONA",82670,82670,0
2022,"WESTERN EUROPE-EU","ITALY","STANSTED","BARI (PALESE)",104585,104585,0
2022,"WESTERN EUROPE-EU","ITALY","STANSTED","BERGAMO",441375,441375,0
2022,"WESTERN EUROPE-EU","ITALY","STANSTED","BOLOGNA",186890,186890,0
2022,"WESTERN EUROPE-EU","ITALY","STANSTED","BRINDISI",62335,62335,0
2022,"WESTERN EUROPE-EU","ITALY","STANSTED","CAGLIARI (ELMAS)",55748,55580,168
2022,"WESTERN EUROPE-EU","ITALY","STANSTED","CATANIA (FONTANAROSSA)",15259,15259,0
2022,"WESTERN EUROPE-EU","ITALY","STANSTED","FLORENCE",90,90,0
2022,"WESTERN EUROPE-EU","ITALY","STANSTED","GENOA",61795,61795,0
2022,"WESTERN EUROPE-EU","ITALY","STANSTED","LAMETIA-TERME",49169,49169,0
2022,"WESTERN EUROPE-EU","ITALY","STANSTED","MILAN (LINATE)",53,53,0
2022,"WESTERN EUROPE-EU","ITALY","STANSTED","MILAN (MALPENSA)",300009,300009,0
2022,"WESTERN EUROPE-EU","ITALY","STANSTED","NAPLES",172551,172551,0
2022,"WESTERN EUROPE-EU","ITALY","STANSTED","OLBIA",7040,7040,0
2022,"WESTERN EUROPE-EU","ITALY","STANSTED","PALERMO",106339,106339,0
2022,"WESTERN EUROPE-EU","ITALY","STANSTED","PERUGIA",76066,76066,0
2022,"WESTERN EUROPE-EU","ITALY","STANSTED","PESCARA",77431,77431,0
2022,"WESTERN EUROPE-EU","ITALY","STANSTED","PISA",256933,256933,0
2022,"WESTERN EUROPE-EU","ITALY","STANSTED","RIMINI",11446,11446,0
2022,"WESTERN EUROPE-EU","ITALY","STANSTED","ROME (CIAMPINO)",470293,470293,0
2022,"WESTERN EUROPE-EU","ITALY","STANSTED","ROME (FIUMICINO)",1954,1106,848
2022,"WESTERN EUROPE-EU","ITALY","STANSTED","TRAPANI",24216,24216,0
2022,"WESTERN EUROPE-EU","ITALY","STANSTED","TREVISO",44021,44021,0
2022,"WESTERN EUROPE-EU","ITALY","STANSTED","TRIESTE (RONCHI DEI LEGIONARI)",49939,49939,0
2022,"WESTERN EUROPE-EU","ITALY","STANSTED","TURIN",128625,123343,5282
2022,"WESTERN EUROPE-EU","ITALY","STANSTED","VENICE",271495,271369,126
2022,"WESTERN EUROPE-EU","ITALY","STANSTED","VERONA VILLAFRANCA",73062,73062,0
2022,"WESTERN EUROPE-EU","LUXEMBOURG","GATWICK","LUXEMBOURG",5932,5932,0
2022,"WESTERN EUROPE-EU","LUXEMBOURG","HEATHROW","LUXEMBOURG",48858,48858,0
2022,"WESTERN EUROPE-EU","LUXEMBOURG","LONDON CITY","LUXEMBOURG",181670,181670,0
2022,"WESTERN EUROPE-EU","LUXEMBOURG","LUTON","LUXEMBOURG",227,177,50
2022,"WESTERN EUROPE-EU","LUXEMBOURG","STANSTED","LUXEMBOURG",92596,92596,0
2022,"WESTERN EUROPE-EU","MALTA","GATWICK","MALTA",294968,279006,15962
2022,"WESTERN EUROPE-EU","MALTA","HEATHROW","MALTA",216299,216299,0
2022,"WESTERN EUROPE-EU","MALTA","LUTON","MALTA",67506,67506,0
2022,"WESTERN EUROPE-EU","MALTA","SOUTHEND","MALTA",261,261,0
2022,"WESTERN EUROPE-EU","MALTA","STANSTED","MALTA",105634,105481,153
2022,"WESTERN EUROPE-EU","NETHERLANDS","GATWICK","AMSTERDAM",605141,605141,0
2022,"WESTERN EUROPE-EU","NETHERLANDS","HEATHROW","AMSTERDAM",1143986,1143986,0
2022,"WESTERN EUROPE-EU","NETHERLANDS","LONDON CITY","AMSTERDAM",393748,393748,0
2022,"WESTERN EUROPE-EU","NETHERLANDS","LONDON CITY","ROTTERDAM",111282,111282,0
2022,"WESTERN EUROPE-EU","NETHERLANDS","LUTON","AMSTERDAM",414313,414313,0
2022,"WESTERN EUROPE-EU","NETHERLANDS","SOUTHEND","AMSTERDAM",61,0,61
2022,"WESTERN EUROPE-EU","NETHERLANDS","STANSTED","AMSTERDAM",124671,124671,0
2022,"WESTERN EUROPE-EU","NETHERLANDS","STANSTED","EINDHOVEN",308211,308211,0
2022,"WESTERN EUROPE-EU","NETHERLANDS","STANSTED","MAASTRICHT",23047,23047,0
2022,"WESTERN EUROPE-EU","PORTUGAL(EXCLUDING MADEIRA)","GATWICK","AZORES LAJES TERCEIRA ISLAND",250,0,250
2022,"WESTERN EUROPE-EU","PORTUGAL(EXCLUDING MADEIRA)","GATWICK","FARO",626800,606249,20551
2022,"WESTERN EUROPE-EU","PORTUGAL(EXCLUDING MADEIRA)","GATWICK","LISBON",407060,407060,0
2022,"WESTERN EUROPE-EU","PORTUGAL(EXCLUDING MADEIRA)","GATWICK","OPORTO (PORTUGAL)",275577,275577,0
2022,"WESTERN EUROPE-EU","PORTUGAL(EXCLUDING MADEIRA)","HEATHROW","AZORES LAJES TERCEIRA ISLAND",939,939,0
2022,"WESTERN EUROPE-EU","PORTUGAL(EXCLUDING MADEIRA)","HEATHROW","AZORES PONTA DELGADA",2232,2232,0
2022,"WESTERN EUROPE-EU","PORTUGAL(EXCLUDING MADEIRA)","HEATHROW","FARO",161224,161224,0
2022,"WESTERN EUROPE-EU","PORTUGAL(EXCLUDING MADEIRA)","HEATHROW","LISBON",912824,912824,0
2022,"WESTERN EUROPE-EU","PORTUGAL(EXCLUDING MADEIRA)","HEATHROW","OPORTO (PORTUGAL)",137636,137636,0
2022,"WESTERN EUROPE-EU","PORTUGAL(EXCLUDING MADEIRA)","LONDON CITY","FARO",9351,9351,0
2022,"WESTERN EUROPE-EU","PORTUGAL(EXCLUDING MADEIRA)","LUTON","AZORES PONTA DELGADA",0,0,0
2022,"WESTERN EUROPE-EU","PORTUGAL(EXCLUDING MADEIRA)","LUTON","FARO",239198,239198,0
2022,"WESTERN EUROPE-EU","PORTUGAL(EXCLUDING MADEIRA)","LUTON","LISBON",287378,287378,0
2022,"WESTERN EUROPE-EU","PORTUGAL(EXCLUDING MADEIRA)","LUTON","OPORTO (PORTUGAL)",100492,100492,0
2022,"WESTERN EUROPE-EU","PORTUGAL(EXCLUDING MADEIRA)","SOUTHEND","FARO",16600,16600,0
2022,"WESTERN EUROPE-EU","PORTUGAL(EXCLUDING MADEIRA)","STANSTED","AZORES LAJES TERCEIRA ISLAND",5589,5589,0
2022,"WESTERN EUROPE-EU","PORTUGAL(EXCLUDING MADEIRA)","STANSTED","AZORES PONTA DELGADA",12252,12252,0
2022,"WESTERN EUROPE-EU","PORTUGAL(EXCLUDING MADEIRA)","STANSTED","FARO",380778,380692,86
2022,"WESTERN EUROPE-EU","PORTUGAL(EXCLUDING MADEIRA)","STANSTED","LISBON",436069,436069,0
2022,"WESTERN EUROPE-EU","PORTUGAL(EXCLUDING MADEIRA)","STANSTED","OPORTO (PORTUGAL)",337183,337183,0
2022,"WESTERN EUROPE-EU","PORTUGAL(MADEIRA)","GATWICK","FUNCHAL",194923,194923,0
2022,"WESTERN EUROPE-EU","PORTUGAL(MADEIRA)","GATWICK","PORTO SANTO",9154,0,9154
2022,"WESTERN EUROPE-EU","PORTUGAL(MADEIRA)","HEATHROW","FUNCHAL",89646,89646,0
2022,"WESTERN EUROPE-EU","PORTUGAL(MADEIRA)","LUTON","FUNCHAL",30894,30894,0
2022,"WESTERN EUROPE-EU","PORTUGAL(MADEIRA)","STANSTED","FUNCHAL",105596,105596,0
2022,"WESTERN EUROPE-EU","SLOVENIA","GATWICK","LJUBLJANA",58292,58292,0
2022,"WESTERN EUROPE-EU","SLOVENIA","HEATHROW","LJUBLJANA",29430,29430,0
2022,"WESTERN EUROPE-EU","SLOVENIA","LUTON","LJUBLJANA",33616,33616,0
2022,"WESTERN EUROPE-EU","SLOVENIA","STANSTED","LJUBLJANA",10,0,10
2022,"WESTERN EUROPE-EU","SLOVENIA","STANSTED","MARIBOR",0,0,0
2022,"WESTERN EUROPE-EU","SPAIN","GATWICK","A CORUNA",36850,36850,0
2022,"WESTERN EUROPE-EU","SPAIN","GATWICK","ALICANTE",577717,556872,20845
2022,"WESTERN EUROPE-EU","SPAIN","GATWICK","ALMERIA",95832,95832,0
2022,"WESTERN EUROPE-EU","SPAIN","GATWICK","ASTURIAS",41649,41649,0
2022,"WESTERN EUROPE-EU","SPAIN","GATWICK","BARCELONA",1006584,1004554,2030
2022,"WESTERN EUROPE-EU","SPAIN","GATWICK","BILBAO",250500,250500,0
2022,"WESTERN EUROPE-EU","SPAIN","GATWICK","GIRONA",13085,0,13085
2022,"WESTERN EUROPE-EU","SPAIN","GATWICK","GRANADA",28770,28770,0
2022,"WESTERN EUROPE-EU","SPAIN","GATWICK","IBIZA",206111,154832,51279
2022,"WESTERN EUROPE-EU","SPAIN","GATWICK","JEREZ",16951,8383,8568
2022,"WESTERN EUROPE-EU","SPAIN","GATWICK","MADRID",632257,632257,0
2022,"WESTERN EUROPE-EU","SPAIN","GATWICK","MAHON",229605,195683,33922
2022,"WESTERN EUROPE-EU","SPAIN","GATWICK","MALAGA",879306,848500,30806
2022,"WESTERN EUROPE-EU","SPAIN","GATWICK","MURCIA INTERNATIONAL",163647,163647,0
2022,"WESTERN EUROPE-EU","SPAIN","GATWICK","PALMA DE MALLORCA",626301,526188,100113
2022,"WESTERN EUROPE-EU","SPAIN","GATWICK","REUS",22042,0,22042
2022,"WESTERN EUROPE-EU","SPAIN","GATWICK","SANTIAGO DE COMPOSTELA (SPAIN)",68148,68148,0
2022,"WESTERN EUROPE-EU","SPAIN","GATWICK","SEVILLE",236774,236774,0
2022,"WESTERN EUROPE-EU","SPAIN","GATWICK","VALENCIA",285984,285984,0
2022,"WESTERN EUROPE-EU","SPAIN","HEATHROW","ALICANTE",0,0,0
2022,"WESTERN EUROPE-EU","SPAIN","HEATHROW","BARCELONA",557224,557224,0
2022,"WESTERN EUROPE-EU","SPAIN","HEATHROW","BILBAO",3381,3381,0
2022,"WESTERN EUROPE-EU","SPAIN","HEATHROW","IBIZA",115317,115317,0
2022,"WESTERN EUROPE-EU","SPAIN","HEATHROW","MADRID",1185456,1185456,0
2022,"WESTERN EUROPE-EU","SPAIN","HEATHROW","MAHON",0,0,0
2022,"WESTERN EUROPE-EU","SPAIN","HEATHROW","MALAGA",263779,263779,0
2022,"WESTERN EUROPE-EU","SPAIN","HEATHROW","PALMA DE MALLORCA",169897,169897,0
2022,"WESTERN EUROPE-EU","SPAIN","HEATHROW","SEVILLE",16898,16898,0
2022,"WESTERN EUROPE-EU","SPAIN","HEATHROW","VALENCIA",93145,93145,0
2022,"WESTERN EUROPE-EU","SPAIN","LONDON CITY","BARCELONA",18272,18272,0
2022,"WESTERN EUROPE-EU","SPAIN","LONDON CITY","IBIZA",95320,95320,0
2022,"WESTERN EUROPE-EU","SPAIN","LONDON CITY","MAHON",4684,4684,0
2022,"WESTERN EUROPE-EU","SPAIN","LONDON CITY","MALAGA",53508,53508,0
2022,"WESTERN EUROPE-EU","SPAIN","LONDON CITY","PALMA DE MALLORCA",49390,49390,0
2022,"WESTERN EUROPE-EU","SPAIN","LONDON CITY","SAN SEBASTIAN",2473,2473,0
2022,"WESTERN EUROPE-EU","SPAIN","LUTON","ALICANTE",241554,241554,0
2022,"WESTERN EUROPE-EU","SPAIN","LUTON","ALMERIA",158,158,0
2022,"WESTERN EUROPE-EU","SPAIN","LUTON","BARCELONA",220602,220602,0
2022,"WESTERN EUROPE-EU","SPAIN","LUTON","CASTELLON COSTA AZAHAR",8237,8237,0
2022,"WESTERN EUROPE-EU","SPAIN","LUTON","GIRONA",178,0,178
2022,"WESTERN EUROPE-EU","SPAIN","LUTON","IBIZA",60253,59528,725
2022,"WESTERN EUROPE-EU","SPAIN","LUTON","MADRID",6033,5836,197
2022,"WESTERN EUROPE-EU","SPAIN","LUTON","MAHON",32829,32829,0
2022,"WESTERN EUROPE-EU","SPAIN","LUTON","MALAGA",381189,381189,0
2022,"WESTERN EUROPE-EU","SPAIN","LUTON","MURCIA INTERNATIONAL",48552,48552,0
2022,"WESTERN EUROPE-EU","SPAIN","LUTON","PALMA DE MALLORCA",295609,270622,24987
2022,"WESTERN EUROPE-EU","SPAIN","LUTON","SEVILLE",29483,29425,58
2022,"WESTERN EUROPE-EU","SPAIN","LUTON","VALENCIA",77,77,0
2022,"WESTERN EUROPE-EU","SPAIN","SOUTHEND","ALICANTE",0,0,0
2022,"WESTERN EUROPE-EU","SPAIN","SOUTHEND","MALAGA",42487,42487,0
2022,"WESTERN EUROPE-EU","SPAIN","SOUTHEND","PALMA DE MALLORCA",28231,28227,4
2022,"WESTERN EUROPE-EU","SPAIN","SOUTHEND","REUS",0,0,0
2022,"WESTERN EUROPE-EU","SPAIN","STANSTED","ALICANTE",372451,372451,0
2022,"WESTERN EUROPE-EU","SPAIN","STANSTED","ALMERIA",30116,30116,0
2022,"WESTERN EUROPE-EU","SPAIN","STANSTED","ASTURIAS",6551,6551,0
2022,"WESTERN EUROPE-EU","SPAIN","STANSTED","BARCELONA",435732,435732,0
2022,"WESTERN EUROPE-EU","SPAIN","STANSTED","BILBAO",96,96,0
2022,"WESTERN EUROPE-EU","SPAIN","STANSTED","CASTELLON COSTA AZAHAR",33686,33686,0
2022,"WESTERN EUROPE-EU","SPAIN","STANSTED","GIRONA",101897,101897,0
2022,"WESTERN EUROPE-EU","SPAIN","STANSTED","IBIZA",216641,201554,15087
2022,"WESTERN EUROPE-EU","SPAIN","STANSTED","JEREZ",30432,30432,0
2022,"WESTERN EUROPE-EU","SPAIN","STANSTED","MADRID",370521,370376,145
2022,"WESTERN EUROPE-EU","SPAIN","STANSTED","MAHON",101261,84937,16324
2022,"WESTERN EUROPE-EU","SPAIN","STANSTED","MALAGA",341438,341438,0
2022,"WESTERN EUROPE-EU","SPAIN","STANSTED","MURCIA INTERNATIONAL",97768,97768,0
2022,"WESTERN EUROPE-EU","SPAIN","STANSTED","PALMA DE MALLORCA",387592,355177,32415
2022,"WESTERN EUROPE-EU","SPAIN","STANSTED","REUS",59406,59406,0
2022,"WESTERN EUROPE-EU","SPAIN","STANSTED","SANTANDER",73321,73321,0
2022,"WESTERN EUROPE-EU","SPAIN","STANSTED","SANTIAGO DE COMPOSTELA (SPAIN)",110540,110540,0
2022,"WESTERN EUROPE-EU","SPAIN","STANSTED","SEVILLE",146633,146261,372
2022,"WESTERN EUROPE-EU","SPAIN","STANSTED","VALENCIA",174284,174115,169
2022,"WESTERN EUROPE-EU","SPAIN","STANSTED","ZARAGOZA",70882,70882,0
2022,"WESTERN EUROPE-EU","SPAIN(CANARY ISLANDS)","GATWICK","ARRECIFE",353946,294970,58976
2022,"WESTERN EUROPE-EU","SPAIN(CANARY ISLANDS)","GATWICK","FUERTEVENTURA",159039,111723,47316
2022,"WESTERN EUROPE-EU","SPAIN(CANARY ISLANDS)","GATWICK","LAS PALMAS",229915,165261,64654
2022,"WESTERN EUROPE-EU","SPAIN(CANARY ISLANDS)","GATWICK","SANTA CRUZ DE LA PALMA",11826,0,11826
2022,"WESTERN EUROPE-EU","SPAIN(CANARY ISLANDS)","GATWICK","TENERIFE (SURREINA SOFIA)",574445,459697,114748
2022,"WESTERN EUROPE-EU","SPAIN(CANARY ISLANDS)","HEATHROW","ARRECIFE",15147,15147,0
2022,"WESTERN EUROPE-EU","SPAIN(CANARY ISLANDS)","HEATHROW","LAS PALMAS",6121,6121,0
2022,"WESTERN EUROPE-EU","SPAIN(CANARY ISLANDS)","HEATHROW","TENERIFE (SURREINA SOFIA)",102417,102417,0
2022,"WESTERN EUROPE-EU","SPAIN(CANARY ISLANDS)","LUTON","ARRECIFE",95609,66090,29519
2022,"WESTERN EUROPE-EU","SPAIN(CANARY ISLANDS)","LUTON","FUERTEVENTURA",88954,88954,0
2022,"WESTERN EUROPE-EU","SPAIN(CANARY ISLANDS)","LUTON","LAS PALMAS",91177,91177,0
2022,"WESTERN EUROPE-EU","SPAIN(CANARY ISLANDS)","LUTON","TENERIFE (SURREINA SOFIA)",215250,205243,10007
2022,"WESTERN EUROPE-EU","SPAIN(CANARY ISLANDS)","STANSTED","ARRECIFE",264803,264803,0
2022,"WESTERN EUROPE-EU","SPAIN(CANARY ISLANDS)","STANSTED","FUERTEVENTURA",158052,158052,0
2022,"WESTERN EUROPE-EU","SPAIN(CANARY ISLANDS)","STANSTED","LAS PALMAS",187572,161755,25817
2022,"WESTERN EUROPE-EU","SPAIN(CANARY ISLANDS)","STANSTED","TENERIFE (SURREINA SOFIA)",451476,436515,14961
2022,"WESTERN EUROPE-EU","SWEDEN","GATWICK","HALMSTAD",363,0,363
2022,"WESTERN EUROPE-EU","SWEDEN","GATWICK","MALMO",0,0,0
2022,"WESTERN EUROPE-EU","SWEDEN","GATWICK","PAJALA YLLAS",374,0,374
2022,"WESTERN EUROPE-EU","SWEDEN","GATWICK","SCANDINAVIAN MOUNTAINS AIRPORT",674,0,674
2022,"WESTERN EUROPE-EU","SWEDEN","GATWICK","STOCKHOLM (ARLANDA)",300270,300270,0
2022,"WESTERN EUROPE-EU","SWEDEN","HEATHROW","GOTEBORG (LANDVETTER)",163926,163926,0
2022,"WESTERN EUROPE-EU","SWEDEN","HEATHROW","LULEA",1248,1248,0
2022,"WESTERN EUROPE-EU","SWEDEN","HEATHROW","SCANDINAVIAN MOUNTAINS AIRPORT",537,537,0
2022,"WESTERN EUROPE-EU","SWEDEN","HEATHROW","STOCKHOLM (ARLANDA)",626261,626261,0
2022,"WESTERN EUROPE-EU","SWEDEN","LUTON","MALMO",0,0,0
2022,"WESTERN EUROPE-EU","SWEDEN","STANSTED","GOTEBORG (LANDVETTER)",114772,114772,0
2022,"WESTERN EUROPE-EU","SWEDEN","STANSTED","OREBRO",23306,23306,0
2022,"WESTERN EUROPE-EU","SWEDEN","STANSTED","STOCKHOLM (ARLANDA)",141446,140815,631
2022,"WESTERN EUROPE-EU","SWEDEN","STANSTED","STOCKHOLM (SKAVSTA)",0,0,0
2022,"WESTERN EUROPE-EU","SWEDEN","STANSTED","VASTERAS",47154,47154,0
2022,"WESTERN EUROPE-EU","SWEDEN","STANSTED","VAXJO",20724,20724,0
2022,"WESTERN EUROPE-OTHER","BOSNIA-HERZEGOVINA","GATWICK","SARAJEVO",182,0,182
2022,"WESTERN EUROPE-OTHER","BOSNIA-HERZEGOVINA","LUTON","SARAJEVO",22737,22737,0
2022,"WESTERN EUROPE-OTHER","BOSNIA-HERZEGOVINA","LUTON","TUZLA",152,152,0
2022,"WESTERN EUROPE-OTHER","BOSNIA-HERZEGOVINA","STANSTED","SARAJEVO",0,0,0
2022,"WESTERN EUROPE-OTHER","ICELAND","GATWICK","KEFLAVIK",141040,135119,5921
2022,"WESTERN EUROPE-OTHER","ICELAND","HEATHROW","KEFLAVIK",293609,293609,0
2022,"WESTERN EUROPE-OTHER","ICELAND","LUTON","KEFLAVIK",135983,135983,0
2022,"WESTERN EUROPE-OTHER","ICELAND","STANSTED","AKUREYRI",145,83,62
2022,"WESTERN EUROPE-OTHER","ICELAND","STANSTED","KEFLAVIK",82093,82024,69
2022,"WESTERN EUROPE-OTHER","KOSOVO","GATWICK","PRISTINA",6962,6962,0
2022,"WESTERN EUROPE-OTHER","KOSOVO","HEATHROW","PRISTINA",4285,4285,0
2022,"WESTERN EUROPE-OTHER","KOSOVO","LUTON","PRISTINA",101016,101016,0
2022,"WESTERN EUROPE-OTHER","MACEDONIA","LUTON","OHRID",11218,11218,0
2022,"WESTERN EUROPE-OTHER","MACEDONIA","LUTON","SKOPJE",61659,61659,0
2022,"WESTERN EUROPE-OTHER","MACEDONIA","STANSTED","SKOPJE",174,0,174
2022,"WESTERN EUROPE-OTHER","NORWAY","GATWICK","ALESUND",219,0,219
2022,"WESTERN EUROPE-OTHER","NORWAY","GATWICK","BERGEN",149518,149004,514
2022,"WESTERN EUROPE-OTHER","NORWAY","GATWICK","OSLO (GARDERMOEN)",344392,344392,0
2022,"WESTERN EUROPE-OTHER","NORWAY","GATWICK","STAVANGER",93185,93185,0
2022,"WESTERN EUROPE-OTHER","NORWAY","GATWICK","TROMSOE",11143,11143,0
2022,"WESTERN EUROPE-OTHER","NORWAY","GATWICK","TRONDHEIM (VAERNES)",41600,41600,0
2022,"WESTERN EUROPE-OTHER","NORWAY","HEATHROW","BERGEN",57411,57411,0
2022,"WESTERN EUROPE-OTHER","NORWAY","HEATHROW","OSLO (GARDERMOEN)",479248,479208,40
2022,"WESTERN EUROPE-OTHER","NORWAY","HEATHROW","STAVANGER",29735,29735,0
2022,"WESTERN EUROPE-OTHER","NORWAY","LUTON","BODO",705,0,705
2022,"WESTERN EUROPE-OTHER","NORWAY","LUTON","OSLO (GARDERMOEN)",49,0,49
2022,"WESTERN EUROPE-OTHER","NORWAY","LUTON","TROMSOE",2234,2234,0
2022,"WESTERN EUROPE-OTHER","NORWAY","SOUTHEND","BERGEN",104,104,0
2022,"WESTERN EUROPE-OTHER","NORWAY","SOUTHEND","BODO",336,0,336
2022,"WESTERN EUROPE-OTHER","NORWAY","STANSTED","BERGEN",1076,1076,0
2022,"WESTERN EUROPE-OTHER","NORWAY","STANSTED","BODO",186,0,186
2022,"WESTERN EUROPE-OTHER","NORWAY","STANSTED","OSLO (GARDERMOEN)",166779,166650,129
2022,"WESTERN EUROPE-OTHER","NORWAY","STANSTED","SANDEFJORD(TORP)",55019,55019,0
2022,"WESTERN EUROPE-OTHER","REPUBLIC OF MONTENEGRO","GATWICK","PODGORICA",32829,32829,0
2022,"WESTERN EUROPE-OTHER","REPUBLIC OF MONTENEGRO","GATWICK","TIVAT",28713,28713,0
2022,"WESTERN EUROPE-OTHER","REPUBLIC OF MONTENEGRO","STANSTED","PODGORICA",56020,56020,0
2022,"WESTERN EUROPE-OTHER","REPUBLIC OF SERBIA","HEATHROW","BELGRADE",61434,61434,0
2022,"WESTERN EUROPE-OTHER","REPUBLIC OF SERBIA","LUTON","BELGRADE",74042,74042,0
2022,"WESTERN EUROPE-OTHER","SWITZERLAND","GATWICK","BALE MULHOUSE",224095,224095,0
2022,"WESTERN EUROPE-OTHER","SWITZERLAND","GATWICK","GENEVA",611172,605805,5367
2022,"WESTERN EUROPE-OTHER","SWITZERLAND","GATWICK","ZURICH",143070,143070,0
2022,"WESTERN EUROPE-OTHER","SWITZERLAND","HEATHROW","BALE MULHOUSE",168795,168795,0
2022,"WESTERN EUROPE-OTHER","SWITZERLAND","HEATHROW","GENEVA",894269,894269,0
2022,"WESTERN EUROPE-OTHER","SWITZERLAND","HEATHROW","ZURICH",827907,827441,466
2022,"WESTERN EUROPE-OTHER","SWITZERLAND","LONDON CITY","GENEVA",85728,85728,0
2022,"WESTERN EUROPE-OTHER","SWITZERLAND","LONDON CITY","ZURICH",293822,293772,50
2022,"WESTERN EUROPE-OTHER","SWITZERLAND","LUTON","BALE MULHOUSE",46,46,0
2022,"WESTERN EUROPE-OTHER","SWITZERLAND","LUTON","GENEVA",229200,229200,0
2022,"WESTERN EUROPE-OTHER","SWITZERLAND","LUTON","ZURICH",48231,48188,43
2022,"WESTERN EUROPE-OTHER","SWITZERLAND","STANSTED","GENEVA",23167,21785,1382
2022,"WESTERN EUROPE-OTHER","SWITZERLAND","STANSTED","ZURICH",250,163,87
2022,"WESTERN EUROPE-OTHER","TURKEY","GATWICK","ANTALYA",574772,443494,131278
2022,"WESTERN EUROPE-OTHER","TURKEY","GATWICK","BODRUM (MILAS)",158412,136162,22250
2022,"WESTERN EUROPE-OTHER","TURKEY","GATWICK","DALAMAN",411887,312154,99733
2022,"WESTERN EUROPE-OTHER","TURKEY","GATWICK","ISTANBUL",231302,231302,0
2022,"WESTERN EUROPE-OTHER","TURKEY","GATWICK","ISTANBUL (SABIHA GOKCEN)",0,0,0
2022,"WESTERN EUROPE-OTHER","TURKEY","GATWICK","IZMIR (ADNAN MENDERES)",66193,42993,23200
2022,"WESTERN EUROPE-OTHER","TURKEY","GATWICK","KAYSERI  ERKILET",502,365,137
2022,"WESTERN EUROPE-OTHER","TURKEY","HEATHROW","ANTALYA",0,0,0
2022,"WESTERN EUROPE-OTHER","TURKEY","HEATHROW","BODRUM (MILAS)",6334,6334,0
2022,"WESTERN EUROPE-OTHER","TURKEY","HEATHROW","DALAMAN",43089,43089,0
2022,"WESTERN EUROPE-OTHER","TURKEY","HEATHROW","ISTANBUL",1103949,1103949,0
2022,"WESTERN EUROPE-OTHER","TURKEY","HEATHROW","ISTANBUL (SABIHA GOKCEN)",0,0,0
2022,"WESTERN EUROPE-OTHER","TURKEY","LUTON","ANKARA (ESENBOGA)",3493,3493,0
2022,"WESTERN EUROPE-OTHER","TURKEY","LUTON","ANTALYA",88977,88483,494
2022,"WESTERN EUROPE-OTHER","TURKEY","LUTON","BODRUM (MILAS)",54263,54263,0
2022,"WESTERN EUROPE-OTHER","TURKEY","LUTON","DALAMAN",92959,80486,12473
2022,"WESTERN EUROPE-OTHER","TURKEY","LUTON","GAZIANTEP",4408,4408,0
2022,"WESTERN EUROPE-OTHER","TURKEY","LUTON","ISTANBUL ATATURK",81,81,0
2022,"WESTERN EUROPE-OTHER","TURKEY","LUTON","IZMIR (ADNAN MENDERES)",26248,26248,0
2022,"WESTERN EUROPE-OTHER","TURKEY","STANSTED","ANKARA (ESENBOGA)",35508,35508,0
2022,"WESTERN EUROPE-OTHER","TURKEY","STANSTED","ANTALYA",320545,292961,27584
2022,"WESTERN EUROPE-OTHER","TURKEY","STANSTED","BODRUM (MILAS)",35814,35469,345
2022,"WESTERN EUROPE-OTHER","TURKEY","STANSTED","DALAMAN",163299,134350,28949
2022,"WESTERN EUROPE-OTHER","TURKEY","STANSTED","ISTANBUL",909,746,163
2022,"WESTERN EUROPE-OTHER","TURKEY","STANSTED","ISTANBUL (SABIHA GOKCEN)",726387,726387,0
2022,"WESTERN EUROPE-OTHER","TURKEY","STANSTED","IZMIR (ADNAN MENDERES)",124087,124087,0
2022,"WESTERN EUROPE-OTHER","TURKEY","STANSTED","KAYSERI  ERKILET",184,0,184
2022,"EASTERN EUROPE-EU","BULGARIA","GATWICK","BURGAS",45381,19758,25623
2022,"EASTERN EUROPE-EU","BULGARIA","GATWICK","SOFIA",155213,147047,8166
2022,"EASTERN EUROPE-EU","BULGARIA","GATWICK","VARNA",24739,24739,0
2022,"EASTERN EUROPE-EU","BULGARIA","HEATHROW","SOFIA",99538,99538,0
2022,"EASTERN EUROPE-EU","BULGARIA","LUTON","BURGAS",90440,90440,0
2022,"EASTERN EUROPE-EU","BULGARIA","LUTON","PLOVDIV",47082,47082,0
2022,"EASTERN EUROPE-EU","BULGARIA","LUTON","SOFIA",271650,271641,9
2022,"EASTERN EUROPE-EU","BULGARIA","LUTON","VARNA",98937,98937,0
2022,"EASTERN EUROPE-EU","BULGARIA","STANSTED","BURGAS",6602,6602,0
2022,"EASTERN EUROPE-EU","BULGARIA","STANSTED","PLOVDIV",70906,70906,0
2022,"EASTERN EUROPE-EU","BULGARIA","STANSTED","SOFIA",272342,272342,0
2022,"EASTERN EUROPE-EU","CZECH REPUBLIC","GATWICK","KARLOVY VARY",90,0,90
2022,"EASTERN EUROPE-EU","CZECH REPUBLIC","GATWICK","PRAGUE",108049,108049,0
2022,"EASTERN EUROPE-EU","CZECH REPUBLIC","HEATHROW","PRAGUE",304480,304480,0
2022,"EASTERN EUROPE-EU","CZECH REPUBLIC","LONDON CITY","PRAGUE",4007,4007,0
2022,"EASTERN EUROPE-EU","CZECH REPUBLIC","LUTON","PRAGUE",59085,59085,0
2022,"EASTERN EUROPE-EU","CZECH REPUBLIC","STANSTED","BRNO (TURANY)",94130,94130,0
2022,"EASTERN EUROPE-EU","CZECH REPUBLIC","STANSTED","OSTRAVA",30203,30203,0
2022,"EASTERN EUROPE-EU","CZECH REPUBLIC","STANSTED","PRAGUE",268227,268227,0
2022,"EASTERN EUROPE-EU","ESTONIA","GATWICK","TALLIN",27625,27625,0
2022,"EASTERN EUROPE-EU","ESTONIA","LUTON","TALLIN",8702,8702,0
2022,"EASTERN EUROPE-EU","ESTONIA","STANSTED","TALLIN",69236,69236,0
2022,"EASTERN EUROPE-EU","HUNGARY","GATWICK","BUDAPEST",152971,152971,0
2022,"EASTERN EUROPE-EU","HUNGARY","HEATHROW","BUDAPEST",245247,245247,0
2022,"EASTERN EUROPE-EU","HUNGARY","LUTON","BUDAPEST",363070,363070,0
2022,"EASTERN EUROPE-EU","HUNGARY","LUTON","DEBRECEN",74359,74359,0
2022,"EASTERN EUROPE-EU","HUNGARY","STANSTED","BUDAPEST",479766,479766,0
2022,"EASTERN EUROPE-EU","LATVIA","GATWICK","RIGA",106965,106965,0
2022,"EASTERN EUROPE-EU","LATVIA","LUTON","RIGA",99660,99660,0
2022,"EASTERN EUROPE-EU","LATVIA","STANSTED","RIGA",210716,210716,0
2022,"EASTERN EUROPE-EU","LITHUANIA","GATWICK","VILNIUS",11045,10664,381
2022,"EASTERN EUROPE-EU","LITHUANIA","HEATHROW","VILNIUS",0,0,0
2022,"EASTERN EUROPE-EU","LITHUANIA","LONDON CITY","VILNIUS",38654,38654,0
2022,"EASTERN EUROPE-EU","LITHUANIA","LUTON","KAUNAS",195582,195582,0
2022,"EASTERN EUROPE-EU","LITHUANIA","LUTON","PALANGA",36221,36221,0
2022,"EASTERN EUROPE-EU","LITHUANIA","LUTON","VILNIUS",212367,212367,0
2022,"EASTERN EUROPE-EU","LITHUANIA","SOUTHEND","VILNIUS",0,0,0
2022,"EASTERN EUROPE-EU","LITHUANIA","STANSTED","KAUNAS",79454,79454,0
2022,"EASTERN EUROPE-EU","LITHUANIA","STANSTED","PALANGA",46576,46576,0
2022,"EASTERN EUROPE-EU","LITHUANIA","STANSTED","VILNIUS",120084,120084,0
2022,"EASTERN EUROPE-EU","POLAND","GATWICK","GDANSK",0,0,0
2022,"EASTERN EUROPE-EU","POLAND","GATWICK","KRAKOW",124296,123680,616
2022,"EASTERN EUROPE-EU","POLAND","GATWICK","LUBLIN (PORT LOTNICZY)",272,0,272
2022,"EASTERN EUROPE-EU","POLAND","GATWICK","RZESZOW",1,0,1
2022,"EASTERN EUROPE-EU","POLAND","GATWICK","WARSAW (CHOPIN)",706,0,706
2022,"EASTERN EUROPE-EU","POLAND","HEATHROW","KRAKOW",59838,59838,0
2022,"EASTERN EUROPE-EU","POLAND","HEATHROW","WARSAW (CHOPIN)",411685,411597,88
2022,"EASTERN EUROPE-EU","POLAND","LUTON","BYDGOSZCZ",39976,39976,0
2022,"EASTERN EUROPE-EU","POLAND","LUTON","GDANSK",190379,190379,0
2022,"EASTERN EUROPE-EU","POLAND","LUTON","KATOWICE",200572,200572,0
2022,"EASTERN EUROPE-EU","POLAND","LUTON","KRAKOW",304450,304450,0
2022,"EASTERN EUROPE-EU","POLAND","LUTON","LODZ LUBLINEK",1690,1690,0
2022,"EASTERN EUROPE-EU","POLAND","LUTON","LUBLIN (PORT LOTNICZY)",156258,156258,0
2022,"EASTERN EUROPE-EU","POLAND","LUTON","POZNAN",105307,105307,0
2022,"EASTERN EUROPE-EU","POLAND","LUTON","RZESZOW",75977,75977,0
2022,"EASTERN EUROPE-EU","POLAND","LUTON","SZYMANY (MAZURY)",22553,22553,0
2022,"EASTERN EUROPE-EU","POLAND","LUTON","WARSAW (CHOPIN)",342471,342471,0
2022,"EASTERN EUROPE-EU","POLAND","LUTON","WARSAW (MODLIN MASOVIA)",159,159,0
2022,"EASTERN EUROPE-EU","POLAND","LUTON","WROCLAW",115990,115990,0
2022,"EASTERN EUROPE-EU","POLAND","STANSTED","BYDGOSZCZ",64361,64361,0
2022,"EASTERN EUROPE-EU","POLAND","STANSTED","GDANSK",193660,193660,0
2022,"EASTERN EUROPE-EU","POLAND","STANSTED","KATOWICE",148728,148728,0
2022,"EASTERN EUROPE-EU","POLAND","STANSTED","KRAKOW",295090,294721,369
2022,"EASTERN EUROPE-EU","POLAND","STANSTED","LODZ LUBLINEK",81837,81837,0
2022,"EASTERN EUROPE-EU","POLAND","STANSTED","POZNAN",137464,137464,0
2022,"EASTERN EUROPE-EU","POLAND","STANSTED","RZESZOW",117333,117333,0
2022,"EASTERN EUROPE-EU","POLAND","STANSTED","SZCZECIN (GOLENOW)",80990,80990,0
2022,"EASTERN EUROPE-EU","POLAND","STANSTED","SZYMANY (MAZURY)",28401,28401,0
2022,"EASTERN EUROPE-EU","POLAND","STANSTED","WARSAW (CHOPIN)",0,0,0
2022,"EASTERN EUROPE-EU","POLAND","STANSTED","WARSAW (MODLIN MASOVIA)",322116,322116,0
2022,"EASTERN EUROPE-EU","POLAND","STANSTED","WROCLAW",167472,167472,0
2022,"EASTERN EUROPE-EU","ROMANIA","GATWICK","BUCHAREST (OTOPENI)",94652,93826,826
2022,"EASTERN EUROPE-EU","ROMANIA","HEATHROW","BUCHAREST (OTOPENI)",282467,282467,0
2022,"EASTERN EUROPE-EU","ROMANIA","HEATHROW","CLUJ NAPOCA",0,0,0
2022,"EASTERN EUROPE-EU","ROMANIA","HEATHROW","IASI",675,675,0
2022,"EASTERN EUROPE-EU","ROMANIA","LONDON CITY","BUCHAREST (OTOPENI)",0,0,0
2022,"EASTERN EUROPE-EU","ROMANIA","LUTON","BACAU",199213,199213,0
2022,"EASTERN EUROPE-EU","ROMANIA","LUTON","BUCHAREST (BANEASA)",226,0,226
2022,"EASTERN EUROPE-EU","ROMANIA","LUTON","BUCHAREST (OTOPENI)",457368,457194,174
2022,"EASTERN EUROPE-EU","ROMANIA","LUTON","CLUJ NAPOCA",249413,249413,0
2022,"EASTERN EUROPE-EU","ROMANIA","LUTON","CONSTANTA",29167,29167,0
2022,"EASTERN EUROPE-EU","ROMANIA","LUTON","CRAIOVA",137210,137210,0
2022,"EASTERN EUROPE-EU","ROMANIA","LUTON","IASI",269580,269580,0
2022,"EASTERN EUROPE-EU","ROMANIA","LUTON","SATU MARE",29157,29157,0
2022,"EASTERN EUROPE-EU","ROMANIA","LUTON","SIBIU",85904,85904,0
2022,"EASTERN EUROPE-EU","ROMANIA","LUTON","SUCEAVA",162827,162827,0
2022,"EASTERN EUROPE-EU","ROMANIA","LUTON","TIMISOARA",113318,113318,0
2022,"EASTERN EUROPE-EU","ROMANIA","LUTON","TIRGU MURES",29007,29007,0
2022,"EASTERN EUROPE-EU","ROMANIA","SOUTHEND","BACAU",324,324,0
2022,"EASTERN EUROPE-EU","ROMANIA","SOUTHEND","BUCHAREST (BANEASA)",46,0,46
2022,"EASTERN EUROPE-EU","ROMANIA","SOUTHEND","BUCHAREST (OTOPENI)",635,635,0
2022,"EASTERN EUROPE-EU","ROMANIA","SOUTHEND","IASI",21,21,0
2022,"EASTERN EUROPE-EU","ROMANIA","STANSTED","BUCHAREST (OTOPENI)",364025,363911,114
2022,"EASTERN EUROPE-EU","ROMANIA","STANSTED","CLUJ NAPOCA",54936,54936,0
2022,"EASTERN EUROPE-EU","ROMANIA","STANSTED","ORADEA",30995,30995,0
2022,"EASTERN EUROPE-EU","ROMANIA","STANSTED","TIMISOARA",0,0,0
2022,"EASTERN EUROPE-EU","SLOVAK REPUBLIC","LUTON","BRATISLAVA",64049,64049,0
2022,"EASTERN EUROPE-EU","SLOVAK REPUBLIC","LUTON","KOSICE",82992,82992,0
2022,"EASTERN EUROPE-EU","SLOVAK REPUBLIC","LUTON","TATRY-POPRAD",30427,30427,0
2022,"EASTERN EUROPE-EU","SLOVAK REPUBLIC","STANSTED","BRATISLAVA",98914,98914,0
2022,"EASTERN EUROPE-EU","SLOVAK REPUBLIC","STANSTED","KOSICE",63541,63541,0
2022,"EASTERN EUROPE -OTHER","ALBANIA","GATWICK","TIRANA",50992,48562,2430
2022,"EASTERN EUROPE -OTHER","ALBANIA","HEATHROW","TIRANA",97392,97392,0
2022,"EASTERN EUROPE -OTHER","ALBANIA","LUTON","TIRANA",289255,289255,0
2022,"EASTERN EUROPE -OTHER","ALBANIA","STANSTED","TIRANA",28602,28414,188
2022,"EASTERN EUROPE -OTHER","AZERBAIJAN","HEATHROW","BAKU (HEYDER ALIYEV INT'L)",33801,33128,673
2022,"EASTERN EUROPE -OTHER","BELARUS","GATWICK","MINSK INT'L ",0,0,0
2022,"EASTERN EUROPE -OTHER","KAZAKHSTAN","HEATHROW","AKTAU",12490,12490,0
2022,"EASTERN EUROPE -OTHER","KAZAKHSTAN","HEATHROW","ALMATY",14541,14541,0
2022,"EASTERN EUROPE -OTHER","KAZAKHSTAN","HEATHROW","NURSULTAN NAZERBAYEV INTERNATIONAL",3234,3234,0
2022,"EASTERN EUROPE -OTHER","REPUBLIC OF MOLDOVA","LUTON","CHISINAU (KISHINEV)",116936,116936,0
2022,"EASTERN EUROPE -OTHER","REPUBLIC OF MOLDOVA","STANSTED","CHISINAU (KISHINEV)",47584,47584,0
2022,"EASTERN EUROPE -OTHER","RUSSIA","GATWICK","ST PETERSBURG",0,0,0
2022,"EASTERN EUROPE -OTHER","RUSSIA","HEATHROW","ADLER / SOCHI",0,0,0
2022,"EASTERN EUROPE -OTHER","RUSSIA","HEATHROW","MOSCOW (DOMODEDOVO)",8910,8910,0
2022,"EASTERN EUROPE -OTHER","RUSSIA","HEATHROW","MOSCOW (SHEREMETYEVO)",20100,20100,0
2022,"EASTERN EUROPE -OTHER","UKRAINE","GATWICK","KIEV (BORISPOL)",7468,7468,0
2022,"EASTERN EUROPE -OTHER","UKRAINE","HEATHROW","KIEV (BORISPOL)",0,0,0
2022,"EASTERN EUROPE -OTHER","UKRAINE","LUTON","KIEV (ZHULYANY)",6200,6200,0
2022,"EASTERN EUROPE -OTHER","UKRAINE","LUTON","LVOV",6410,6410,0
2022,"EASTERN EUROPE -OTHER","UKRAINE","STANSTED","KIEV (BORISPOL)",9652,9652,0
2022,"EASTERN EUROPE -OTHER","UKRAINE","STANSTED","LVOV",5080,5080,0
2022,"EASTERN EUROPE -OTHER","UZBEKISTAN","HEATHROW","TASHKENT",28357,28357,0
2022,"NEAR EAST","ISRAEL","GATWICK","TEL AVIV",115293,115293,0
2022,"NEAR EAST","ISRAEL","HEATHROW","TEL AVIV",582029,582029,0
2022,"NEAR EAST","ISRAEL","LUTON","RAMON",134,0,134
2022,"NEAR EAST","ISRAEL","LUTON","TEL AVIV",360729,360729,0
2022,"NEAR EAST","ISRAEL","STANSTED","TEL AVIV",941,180,761
2022,"NEAR EAST","JORDAN","GATWICK","AQABA",8551,8551,0
2022,"NEAR EAST","JORDAN","HEATHROW","AMMAN",226923,226923,0
2022,"NEAR EAST","JORDAN","LUTON","AMMAN",2995,2995,0
2022,"NEAR EAST","JORDAN","STANSTED","AQABA",53,0,53
2022,"NEAR EAST","LEBANON","HEATHROW","BEIRUT",149728,149728,0
2022,"NEAR EAST","LEBANON","STANSTED","BEIRUT",229,0,229
2022,"NORTH AFRICA","ALGERIA","GATWICK","HASSI MESSAOUD",208,0,208
2022,"NORTH AFRICA","ALGERIA","HEATHROW","ADRAR",0,0,0
2022,"NORTH AFRICA","ALGERIA","HEATHROW","ALGIERS",87584,87584,0
2022,"NORTH AFRICA","ALGERIA","STANSTED","ALGIERS",8811,1062,7749
2022,"NORTH AFRICA","ALGERIA","STANSTED","HASSI MESSAOUD",0,0,0
2022,"NORTH AFRICA","EGYPT","GATWICK","ALEXANDRIA (BORG EL ARAB)",0,0,0
2022,"NORTH AFRICA","EGYPT","GATWICK","CAIRO",0,0,0
2022,"NORTH AFRICA","EGYPT","GATWICK","HURGHADA",130152,130152,0
2022,"NORTH AFRICA","EGYPT","GATWICK","SHARM EL SHEIKH (OPHIRA)",117132,117132,0
2022,"NORTH AFRICA","EGYPT","HEATHROW","CAIRO",512471,512471,0
2022,"NORTH AFRICA","EGYPT","HEATHROW","LUXOR",6963,6963,0
2022,"NORTH AFRICA","EGYPT","HEATHROW","SHARM EL SHEIKH (OPHIRA)",262,262,0
2022,"NORTH AFRICA","EGYPT","LUTON","HURGHADA",24000,24000,0
2022,"NORTH AFRICA","EGYPT","LUTON","SHARM EL SHEIKH (OPHIRA)",42336,42336,0
2022,"NORTH AFRICA","EGYPT","STANSTED","SHARM EL SHEIKH (OPHIRA)",16278,16107,171
2022,"NORTH AFRICA","MOROCCO","GATWICK","AGADIR (AL MASSIRA)",92928,92928,0
2022,"NORTH AFRICA","MOROCCO","GATWICK","CASABLANCA MOHAMED V",61988,61988,0
2022,"NORTH AFRICA","MOROCCO","GATWICK","ERRACHIDIA",276,0,276
2022,"NORTH AFRICA","MOROCCO","GATWICK","MARRAKESH",293459,293040,419
2022,"NORTH AFRICA","MOROCCO","GATWICK","OUARZAZATE",300,0,300
2022,"NORTH AFRICA","MOROCCO","GATWICK","TANGIERS (IBN BATUTA)",28902,28902,0
2022,"NORTH AFRICA","MOROCCO","HEATHROW","CASABLANCA MOHAMED V",92185,92185,0
2022,"NORTH AFRICA","MOROCCO","HEATHROW","FEZ",0,0,0
2022,"NORTH AFRICA","MOROCCO","HEATHROW","MARRAKESH",44422,44283,139
2022,"NORTH AFRICA","MOROCCO","HEATHROW","RABAT",3771,3771,0
2022,"NORTH AFRICA","MOROCCO","LUTON","AGADIR (AL MASSIRA)",22363,22363,0
2022,"NORTH AFRICA","MOROCCO","LUTON","MARRAKESH",25623,25623,0
2022,"NORTH AFRICA","MOROCCO","STANSTED","AGADIR (AL MASSIRA)",57389,57291,98
2022,"NORTH AFRICA","MOROCCO","STANSTED","ERRACHIDIA",0,0,0
2022,"NORTH AFRICA","MOROCCO","STANSTED","ESSAOUIRA",4375,4375,0
2022,"NORTH AFRICA","MOROCCO","STANSTED","FEZ",26856,26856,0
2022,"NORTH AFRICA","MOROCCO","STANSTED","MARRAKESH",157678,157142,536
2022,"NORTH AFRICA","MOROCCO","STANSTED","RABAT",42687,42687,0
2022,"NORTH AFRICA","MOROCCO","STANSTED","TANGIERS (IBN BATUTA)",25213,25213,0
2022,"NORTH AFRICA","TUNISIA","GATWICK","ENFIDHA - HAMMAMET INTL",67812,42190,25622
2022,"NORTH AFRICA","TUNISIA","GATWICK","TUNIS",28335,28335,0
2022,"NORTH AFRICA","TUNISIA","HEATHROW","TUNIS",16444,16444,0
2022,"NORTH AFRICA","TUNISIA","LUTON","ENFIDHA - HAMMAMET INTL",9215,0,9215
2022,"NORTH AFRICA","TUNISIA","LUTON","TUNIS",169,169,0
2022,"NORTH AFRICA","TUNISIA","STANSTED","TUNIS",15145,15145,0
2022,"EAST AFRICA","ETHIOPIA","HEATHROW","ADDIS ABABA",219282,219281,1
2022,"EAST AFRICA","KENYA","HEATHROW","ELDORET INTERNATIONAL AIRPORT",0,0,0
2022,"EAST AFRICA","KENYA","HEATHROW","NAIROBI",298598,298598,0
2022,"EAST AFRICA","RWANDA","HEATHROW","KIGALI",35874,35874,0
2022,"WEST AFRICA","GAMBIA","GATWICK","BANJUL",31623,865,30758
2022,"WEST AFRICA","GAMBIA","HEATHROW","BANJUL",173,173,0
2022,"WEST AFRICA","GHANA","GATWICK","ACCRA",0,0,0
2022,"WEST AFRICA","GHANA","HEATHROW","ACCRA",184062,184062,0
2022,"WEST AFRICA","NIGERIA","GATWICK","LAGOS",35,0,35
2022,"WEST AFRICA","NIGERIA","HEATHROW","ABUJA",124768,124768,0
2022,"WEST AFRICA","NIGERIA","HEATHROW","LAGOS",327235,327235,0
2022,"WEST AFRICA","SENEGAL","GATWICK","DAKAR",187,0,187
2022,"WEST AFRICA","SENEGAL","GATWICK","DAKAR (BLAISE DIAGNE)",2461,0,2461
2022,"SOUTHERN AFRICA","REPUBLIC OF SOUTH AFRICA","GATWICK","CAPE TOWN",3547,3547,0
2022,"SOUTHERN AFRICA","REPUBLIC OF SOUTH AFRICA","HEATHROW","CAPE TOWN",268191,267713,478
2022,"SOUTHERN AFRICA","REPUBLIC OF SOUTH AFRICA","HEATHROW","JOHANNESBURG",547227,547227,0
2022,"SOUTHERN AFRICA","ZIMBABWE","GATWICK","HARARE",250,0,250
2022,"MIDDLE EAST","BAHRAIN","HEATHROW","BAHRAIN",426063,425686,377
2022,"MIDDLE EAST","IRAN","HEATHROW","TEHRAN IMAM KHOMEINI",50668,50668,0
2022,"MIDDLE EAST","IRAQ","GATWICK","BAGHDAD (GECA)",44,44,0
2022,"MIDDLE EAST","IRAQ","GATWICK","ERBIL INTERNATIONAL",0,0,0
2022,"MIDDLE EAST","IRAQ","GATWICK","SULAYMANIYAH INT",283,283,0
2022,"MIDDLE EAST","KUWAIT","GATWICK","KUWAIT",0,0,0
2022,"MIDDLE EAST","KUWAIT","HEATHROW","KUWAIT",335074,335074,0
2022,"MIDDLE EAST","OMAN","HEATHROW","MUSCAT",134081,134081,0
2022,"MIDDLE EAST","OMAN","STANSTED","MUSCAT",55,0,55
2022,"MIDDLE EAST","QATAR","GATWICK","DOHA HAMAD",194709,194197,512
2022,"MIDDLE EAST","QATAR","HEATHROW","DOHA HAMAD",1491364,1490887,477
2022,"MIDDLE EAST","SAUDI ARABIA","GATWICK","RIYADH",199,0,199
2022,"MIDDLE EAST","SAUDI ARABIA","HEATHROW","JEDDAH",205316,204944,372
2022,"MIDDLE EAST","SAUDI ARABIA","HEATHROW","NEOM BAY",246,246,0
2022,"MIDDLE EAST","SAUDI ARABIA","HEATHROW","RIYADH",376343,375943,400
2022,"MIDDLE EAST","UNITED ARAB EMIRATES","GATWICK","DUBAI",658158,658158,0
2022,"MIDDLE EAST","UNITED ARAB EMIRATES","GATWICK","DUBAI (WORLD CENTRAL)",2,0,2
2022,"MIDDLE EAST","UNITED ARAB EMIRATES","GATWICK","SHARJAH",3,0,3
2022,"MIDDLE EAST","UNITED ARAB EMIRATES","HEATHROW","ABU DHABI INTERNATIONAL",711343,711343,0
2022,"MIDDLE EAST","UNITED ARAB EMIRATES","HEATHROW","DUBAI",2260330,2260330,0
2022,"MIDDLE EAST","UNITED ARAB EMIRATES","HEATHROW","DUBAI (WORLD CENTRAL)",0,0,0
2022,"MIDDLE EAST","UNITED ARAB EMIRATES","STANSTED","DUBAI",95802,95802,0
2022,"INDIAN SUB-CONTINENT","AFGHANISTAN","STANSTED","KABUL",0,0,0
2022,"INDIAN SUB-CONTINENT","BANGLADESH","HEATHROW","DHAKHA",85493,85493,0
2022,"INDIAN SUB-CONTINENT","BANGLADESH","HEATHROW","SYLHET",74981,74981,0
2022,"INDIAN SUB-CONTINENT","INDIA","GATWICK","GOA",3497,0,3497
2022,"INDIAN SUB-CONTINENT","INDIA","GATWICK","MUMBAI",14,14,0
2022,"INDIAN SUB-CONTINENT","INDIA","HEATHROW","AHMEDABAD",70557,70557,0
2022,"INDIAN SUB-CONTINENT","INDIA","HEATHROW","AMRITSAR",56002,56002,0
2022,"INDIAN SUB-CONTINENT","INDIA","HEATHROW","BANGALORE (BENGALURU)",146085,146085,0
2022,"INDIAN SUB-CONTINENT","INDIA","HEATHROW","CHENNAI",96379,96379,0
2022,"INDIAN SUB-CONTINENT","INDIA","HEATHROW","COCHIN",69767,69767,0
2022,"INDIAN SUB-CONTINENT","INDIA","HEATHROW","DELHI",892836,892836,0
2022,"INDIAN SUB-CONTINENT","INDIA","HEATHROW","GOA",62809,62809,0
2022,"INDIAN SUB-CONTINENT","INDIA","HEATHROW","HYDERABAD ( RAJIV GHANDI )",158602,158602,0
2022,"INDIAN SUB-CONTINENT","INDIA","HEATHROW","KOLKATA",3322,3322,0
2022,"INDIAN SUB-CONTINENT","INDIA","HEATHROW","MUMBAI",596942,596942,0
2022,"INDIAN SUB-CONTINENT","PAKISTAN","GATWICK","BENAZIR BHUTTO INTERNATIONAL AIRPORT",34041,34041,0
2022,"INDIAN SUB-CONTINENT","PAKISTAN","HEATHROW","ISLAMABAD INTERNATIONAL AIRPORT",127997,113499,14498
2022,"INDIAN SUB-CONTINENT","PAKISTAN","HEATHROW","LAHORE",101931,101931,0
2022,"INDIAN SUB-CONTINENT","PAKISTAN","STANSTED","ISLAMABAD INTERNATIONAL AIRPORT",0,0,0
2022,"INDIAN SUB-CONTINENT","SRI LANKA","HEATHROW","COLOMBO",201169,201169,0
2022,"INDIAN SUB-CONTINENT","SRI LANKA","HEATHROW","MATTALA RAJAPAKSA",0,0,0
2022,"FAR EAST","BRUNEI","HEATHROW","BANDAR SERI BEGAWAN",30963,30963,0
2022,"FAR EAST","CHINA","GATWICK","BEIJING",86,0,86
2022,"FAR EAST","CHINA","HEATHROW","BEIJING",7152,6726,426
2022,"FAR EAST","CHINA","HEATHROW","GUANGZHOU BAIYUN INTERNATIONAL",6046,6046,0
2022,"FAR EAST","CHINA","HEATHROW","QINGDAO",4955,4907,48
2022,"FAR EAST","CHINA","HEATHROW","SHANGHAI (PU DONG)",15322,15182,140
2022,"FAR EAST","CHINA","HEATHROW","SHENZHEN (HUANGTIAN)",338,0,338
2022,"FAR EAST","CHINA","HEATHROW","TIANJIN",29,0,29
2022,"FAR EAST","HONG KONG","HEATHROW","HONG KONG (CHEK LAP KOK)",239018,239018,0
2022,"FAR EAST","JAPAN","HEATHROW","NAGOYA",388,0,388
2022,"FAR EAST","JAPAN","HEATHROW","OSAKA (KANSAI)",0,0,0
2022,"FAR EAST","JAPAN","HEATHROW","TOKYO (HANEDA)",238729,238729,0
2022,"FAR EAST","MALAYSIA","GATWICK","KUALA LUMPUR (SEPANG)",7,0,7
2022,"FAR EAST","MALAYSIA","HEATHROW","KUALA LUMPUR (SEPANG)",258372,258372,0
2022,"FAR EAST","PHILIPPINES","HEATHROW","MANILA",3505,3505,0
2022,"FAR EAST","REPUBLIC OF KOREA","HEATHROW","SEOUL (INCHEON)",155272,155087,185
2022,"FAR EAST","SINGAPORE","GATWICK","SINGAPORE",1198,1198,0
2022,"FAR EAST","SINGAPORE","HEATHROW","SINGAPORE",949782,949725,57
2022,"FAR EAST","TAIWAN","HEATHROW","TAIPEI",79293,79293,0
2022,"FAR EAST","THAILAND","GATWICK","BANGKOK SUVARNABHUMI ",22296,22296,0
2022,"FAR EAST","THAILAND","GATWICK","PHUKET",8274,0,8274
2022,"FAR EAST","THAILAND","HEATHROW","BANGKOK SUVARNABHUMI ",392553,392553,0
2022,"FAR EAST","THAILAND","HEATHROW","PHUKET",0,0,0
2022,"FAR EAST","VIETNAM","GATWICK","HANOI",4708,4578,130
2022,"FAR EAST","VIETNAM","GATWICK","HO CHI MINH CITY",1984,1984,0
2022,"FAR EAST","VIETNAM","HEATHROW","HANOI",56741,56501,240
2022,"FAR EAST","VIETNAM","HEATHROW","HO CHI MINH CITY",14675,14675,0
2022,"AUSTRALASIA","AUSTRALIA","HEATHROW","DARWIN",42609,42609,0
2022,"AUSTRALASIA","AUSTRALIA","HEATHROW","MELBOURNE",82785,82785,0
2022,"AUSTRALASIA","AUSTRALIA","HEATHROW","PERTH (AUSTRALIA)",85919,85919,0
2022,"AUSTRALASIA","AUSTRALIA","HEATHROW","SYDNEY",262169,262169,0
2022,"CANADA","CANADA","GATWICK","CALGARY",68976,68976,0
2022,"CANADA","CANADA","GATWICK","HALIFAX INT",21897,21897,0
2022,"CANADA","CANADA","GATWICK","MONTREAL (DORVAL)",59470,59396,74
2022,"CANADA","CANADA","GATWICK","OTTAWA INTERNATIONAL",24,24,0
2022,"CANADA","CANADA","GATWICK","QUEBEC",5284,5284,0
2022,"CANADA","CANADA","GATWICK","TORONTO",308610,308610,0
2022,"CANADA","CANADA","GATWICK","VANCOUVER",77506,77506,0
2022,"CANADA","CANADA","HEATHROW","CALGARY",247289,247289,0
2022,"CANADA","CANADA","HEATHROW","HALIFAX INT",59770,59770,0
2022,"CANADA","CANADA","HEATHROW","MONTREAL (DORVAL)",301427,301427,0
2022,"CANADA","CANADA","HEATHROW","ST JOHNS",234,234,0
2022,"CANADA","CANADA","HEATHROW","TORONTO",786519,786519,0
2022,"CANADA","CANADA","HEATHROW","VANCOUVER",475180,475180,0
2022,"CANADA","CANADA","HEATHROW","WINNIPEG",0,0,0
2022,"CANADA","CANADA","STANSTED","TORONTO",14,0,14
2022,"UNITED STATES OF AMERICA","USA","GATWICK","AUSTIN (BERGSTROM)",0,0,0
2022,"UNITED STATES OF AMERICA","USA","GATWICK","BOSTON",27342,27342,0
2022,"UNITED STATES OF AMERICA","USA","GATWICK","BUFFALO",2,0,2
2022,"UNITED STATES OF AMERICA","USA","GATWICK","MELBOURNE FLATS",41550,0,41550
2022,"UNITED STATES OF AMERICA","USA","GATWICK","MIAMI INTERNATIONAL",543,543,0
2022,"UNITED STATES OF AMERICA","USA","GATWICK","NEW YORK (JF KENNEDY)",271409,271317,92
2022,"UNITED STATES OF AMERICA","USA","GATWICK","ORLANDO",239729,239257,472
2022,"UNITED STATES OF AMERICA","USA","GATWICK","TAMPA",152908,152908,0
2022,"UNITED STATES OF AMERICA","USA","GATWICK","WILLIAM P HOBBY AIRPORT",0,0,0
2022,"UNITED STATES OF AMERICA","USA","HEATHROW","ATLANTA",499431,499431,0
2022,"UNITED STATES OF AMERICA","USA","HEATHROW","AUSTIN (BERGSTROM)",180717,180717,0
2022,"UNITED STATES OF AMERICA","USA","HEATHROW","BALTIMORE",79250,79250,0
2022,"UNITED STATES OF AMERICA","USA","HEATHROW","BOSTON",800673,800673,0
2022,"UNITED STATES OF AMERICA","USA","HEATHROW","CHARLOTTE",286536,286395,141
2022,"UNITED STATES OF AMERICA","USA","HEATHROW","CHICAGO (O'HARE)",896746,896746,0
2022,"UNITED STATES OF AMERICA","USA","HEATHROW","DALLAS/FORT WORTH",715621,715621,0
2022,"UNITED STATES OF AMERICA","USA","HEATHROW","DENVER INTERNATIONAL",331250,330820,430
2022,"UNITED STATES OF AMERICA","USA","HEATHROW","DETROIT",137762,137762,0
2022,"UNITED STATES OF AMERICA","USA","HEATHROW","GREEN BAY WISCONSIN",171,0,171
2022,"UNITED STATES OF AMERICA","USA","HEATHROW","HOUSTON",381967,381967,0
2022,"UNITED STATES OF AMERICA","USA","HEATHROW","JACKSONVILLE",0,0,0
2022,"UNITED STATES OF AMERICA","USA","HEATHROW","LAS VEGAS",350388,350388,0
2022,"UNITED STATES OF AMERICA","USA","HEATHROW","LOS ANGELES INTERNATIONAL",1225487,1225487,0
2022,"UNITED STATES OF AMERICA","USA","HEATHROW","MIAMI INTERNATIONAL",821184,821184,0
2022,"UNITED STATES OF AMERICA","USA","HEATHROW","MILWAUKEE",0,0,0
2022,"UNITED STATES OF AMERICA","USA","HEATHROW","MINNEAPOLIS-ST PAUL",96720,96367,353
2022,"UNITED STATES OF AMERICA","USA","HEATHROW","NASHVILLE METROPOLITAN",78661,78661,0
2022,"UNITED STATES OF AMERICA","USA","HEATHROW","NEW ORLEANS",45425,45425,0
2022,"UNITED STATES OF AMERICA","USA","HEATHROW","NEW YORK (JF KENNEDY)",2373529,2373529,0
2022,"UNITED STATES OF AMERICA","USA","HEATHROW","NEW YORK (NEWARK)",810084,810084,0
2022,"UNITED STATES OF AMERICA","USA","HEATHROW","ORLANDO",456014,454506,1508
2022,"UNITED STATES OF AMERICA","USA","HEATHROW","PHILADELPHIA INTERNATIONAL",353258,353258,0
2022,"UNITED STATES OF AMERICA","USA","HEATHROW","PHOENIX",284571,284571,0
2022,"UNITED STATES OF AMERICA","USA","HEATHROW","PITTSBURGH",37958,37958,0
2022,"UNITED STATES OF AMERICA","USA","HEATHROW","PORTLAND (OREGON)",48840,48840,0
2022,"UNITED STATES OF AMERICA","USA","HEATHROW","RALEIGH",68451,68451,0
2022,"UNITED STATES OF AMERICA","USA","HEATHROW","SALT LAKE CITY",72839,72839,0
2022,"UNITED STATES OF AMERICA","USA","HEATHROW","SAN DIEGO",154420,154420,0
2022,"UNITED STATES OF AMERICA","USA","HEATHROW","SAN FRANCISCO",878892,878892,0
2022,"UNITED STATES OF AMERICA","USA","HEATHROW","SAN JOSE",52833,52833,0
2022,"UNITED STATES OF AMERICA","USA","HEATHROW","SEATTLE (TACOMA)",365574,365574,0
2022,"UNITED STATES OF AMERICA","USA","HEATHROW","TAMPA",17344,17344,0
2022,"UNITED STATES OF AMERICA","USA","HEATHROW","WASHINGTON (DULLES)",626436,626436,0
2022,"UNITED STATES OF AMERICA","USA","STANSTED","ATLANTA",0,0,0
2022,"UNITED STATES OF AMERICA","USA","STANSTED","CINCINNATI",335,0,335
2022,"UNITED STATES OF AMERICA","USA","STANSTED","MIAMI INTERNATIONAL",0,0,0
2022,"UNITED STATES OF AMERICA","USA","STANSTED","NEW YORK (NEWARK)",206,0,206
2022,"UNITED STATES OF AMERICA","USA","STANSTED","ORLANDO",229,0,229
2022,"CENTRAL AMERICA","COSTA RICA","GATWICK","LIBERIA",27821,0,27821
2022,"CENTRAL AMERICA","COSTA RICA","GATWICK","SAN JOSE COST RICA",38932,38932,0
2022,"CENTRAL AMERICA","CUBA","GATWICK","VARADERO",0,0,0
2022,"CENTRAL AMERICA","DOMINICAN REPUBLIC","GATWICK","PUNTA CANA",179017,77173,101844
2022,"CENTRAL AMERICA","MEXICO","GATWICK","CANCUN",401759,401474,285
2022,"CENTRAL AMERICA","MEXICO","GATWICK","MEXICO CITY",0,0,0
2022,"CENTRAL AMERICA","MEXICO","GATWICK","PUERTO VALLARTA",28710,0,28710
2022,"CENTRAL AMERICA","MEXICO","HEATHROW","CANCUN",1,1,0
2022,"CENTRAL AMERICA","MEXICO","HEATHROW","MEXICO CITY",219943,219943,0
2022,"SOUTH AMERICA","ARGENTINA","HEATHROW","BUENOS AIRES",124981,124553,428
2022,"SOUTH AMERICA","BRAZIL","HEATHROW","RIO DE JANEIRO (GALEAO)",85934,85933,1
2022,"SOUTH AMERICA","BRAZIL","HEATHROW","SAO PAULO (GUARULHOS)",398189,398189,0
2022,"SOUTH AMERICA","CHILE","HEATHROW","SANTIAGO DE CHILE",60144,60144,0
2022,"SOUTH AMERICA","COLOMBIA","HEATHROW","BOGOTA",125965,125965,0
2022,"SOUTH AMERICA","GUYANA","HEATHROW","GEORGETOWN (GUYANA)",0,0,0
2022,"SOUTH AMERICA","GUYANA","STANSTED","GEORGETOWN (GUYANA)",0,0,0
2022,"SOUTH AMERICA","SURINAM","STANSTED","PARAMARIBO",0,0,0
2022,"CARIBBEAN AREA","ANTIGUA AND BARBUDA","GATWICK","ANTIGUA",113636,113636,0
2022,"CARIBBEAN AREA","ANTIGUA AND BARBUDA","HEATHROW","ANTIGUA",69821,69788,33
2022,"CARIBBEAN AREA","BAHAMAS","HEATHROW","NASSAU",62347,62051,296
2022,"CARIBBEAN AREA","BARBADOS","GATWICK","BRIDGETOWN",90457,48921,41536
2022,"CARIBBEAN AREA","BARBADOS","HEATHROW","BRIDGETOWN",330203,327929,2274
2022,"CARIBBEAN AREA","BERMUDA","GATWICK","BERMUDA",0,0,0
2022,"CARIBBEAN AREA","BERMUDA","HEATHROW","BERMUDA",86893,86893,0
2022,"CARIBBEAN AREA","CAYMAN ISLANDS","HEATHROW","GRAND CAYMAN",64110,64110,0
2022,"CARIBBEAN AREA","GRENADA","GATWICK","GRENADA",33969,33969,0
2022,"CARIBBEAN AREA","GRENADA","HEATHROW","GRENADA",20823,20823,0
2022,"CARIBBEAN AREA","ISLE OF CURACAO NETH.ANTILLES","GATWICK","ARUBA",14283,0,14283
2022,"CARIBBEAN AREA","JAMAICA","GATWICK","KINGSTON",99861,99811,50
2022,"CARIBBEAN AREA","JAMAICA","GATWICK","MONTEGO BAY",120883,18335,102548
2022,"CARIBBEAN AREA","JAMAICA","HEATHROW","MONTEGO BAY",90166,90166,0
2022,"CARIBBEAN AREA","SAINT KITTS AND NEVIS","GATWICK","ST KITTS",15707,15707,0
2022,"CARIBBEAN AREA","SAINT VINCENT AND THE GRENADINES","HEATHROW","E T JOSHUA",21865,21865,0
2022,"CARIBBEAN AREA","ST LUCIA","GATWICK","ST LUCIA (HEWANORRA)",142621,112963,29658
2022,"CARIBBEAN AREA","ST LUCIA","HEATHROW","ST LUCIA (HEWANORRA)",37794,37526,268
2022,"CARIBBEAN AREA","TRINIDAD AND TOBAGO","GATWICK","PORT OF SPAIN",52928,52928,0
2022,"CARIBBEAN AREA","TRINIDAD AND TOBAGO","GATWICK","TOBAGO",17668,17668,0
2022,"CARIBBEAN AREA","TRINIDAD AND TOBAGO","HEATHROW","TOBAGO",11915,11915,0
2022,"CARIBBEAN AREA","TURKS AND CAICOS ISLANDS","GATWICK","PROVIDENCIALES",8372,8372,0
2022,"CARIBBEAN AREA","TURKS AND CAICOS ISLANDS","HEATHROW","PROVIDENCIALES",5628,5628,0
2022,"INDIAN OCEAN ISLANDS","MALDIVE ISLANDS","HEATHROW","MALE INTERNATIONAL",75844,75844,0
2022,"INDIAN OCEAN ISLANDS","MAURITIUS","GATWICK","MAURITIUS",95897,95897,0
2022,"INDIAN OCEAN ISLANDS","MAURITIUS","HEATHROW","MAURITIUS",110362,110362,0
2022,"INDIAN OCEAN ISLANDS","SEYCHELLES","HEATHROW","SEYCHELLES",0,0,0
2022,"ATLANTIC OCEAN ISLANDS","ASCENSION ISLAND","STANSTED","SAINT HELENA",627,0,627
2022,"ATLANTIC OCEAN ISLANDS","CAPE VERDE ISLANDS","GATWICK","BOA VISTA (RABIL)",63018,62834,184
2022,"ATLANTIC OCEAN ISLANDS","CAPE VERDE ISLANDS","GATWICK","ILHA DO SAL C.VERDE",73102,72805,297
2022,"ATLANTIC OCEAN ISLANDS","CAPE VERDE ISLANDS","GATWICK","PRAIA",195,0,195
2022,"ATLANTIC OCEAN ISLANDS","CAPE VERDE ISLANDS","STANSTED","PRAIA",0,0,0
2022,"ATLANTIC OCEAN ISLANDS","GREENLAND","STANSTED","SONDRE STROMFJORD",0,0,0
2023,"WESTERN EUROPE-EU","AUSTRIA","GATWICK","INNSBRUCK",160547,137098,23449
2023,"WESTERN EUROPE-EU","AUSTRIA","GATWICK","SALZBURG",146614,131897,14717
2023,"WESTERN EUROPE-EU","AUSTRIA","GATWICK","VIENNA",278357,278357,0
2023,"WESTERN EUROPE-EU","AUSTRIA","HEATHROW","INNSBRUCK",40397,40397,0
2023,"WESTERN EUROPE-EU","AUSTRIA","HEATHROW","SALZBURG",20205,20205,0
2023,"WESTERN EUROPE-EU","AUSTRIA","HEATHROW","VIENNA",717923,717923,0
2023,"WESTERN EUROPE-EU","AUSTRIA","LONDON CITY","SALZBURG",2417,2417,0
2023,"WESTERN EUROPE-EU","AUSTRIA","LUTON","INNSBRUCK",11040,5583,5457
2023,"WESTERN EUROPE-EU","AUSTRIA","LUTON","SALZBURG",8813,8813,0
2023,"WESTERN EUROPE-EU","AUSTRIA","LUTON","VIENNA",0,0,0
2023,"WESTERN EUROPE-EU","AUSTRIA","STANSTED","INNSBRUCK",9672,4656,5016
2023,"WESTERN EUROPE-EU","AUSTRIA","STANSTED","KLAGENFURT",30050,29588,462
2023,"WESTERN EUROPE-EU","AUSTRIA","STANSTED","SALZBURG",91553,88062,3491
2023,"WESTERN EUROPE-EU","AUSTRIA","STANSTED","VIENNA",262015,262015,0
2023,"WESTERN EUROPE-EU","BELGIUM","GATWICK","BRUSSELS",63,63,0
2023,"WESTERN EUROPE-EU","BELGIUM","HEATHROW","BRUSSELS",585429,585429,0
2023,"WESTERN EUROPE-EU","BELGIUM","LONDON CITY","ANTWERP",11152,11152,0
2023,"WESTERN EUROPE-EU","BELGIUM","LUTON","BRUSSELS",251,251,0
2023,"WESTERN EUROPE-EU","BELGIUM","LUTON","OSTEND",0,0,0
2023,"WESTERN EUROPE-EU","BELGIUM","STANSTED","BRUSSELS",0,0,0
2023,"WESTERN EUROPE-EU","BELGIUM","STANSTED","CHARLEROI",349,349,0
2023,"WESTERN EUROPE-EU","CROATIA","GATWICK","DUBROVNIK",256527,253044,3483
2023,"WESTERN EUROPE-EU","CROATIA","GATWICK","PULA",44318,32372,11946
2023,"WESTERN EUROPE-EU","CROATIA","GATWICK","RIJEKA",11352,11352,0
2023,"WESTERN EUROPE-EU","CROATIA","GATWICK","SPLIT",174500,159342,15158
2023,"WESTERN EUROPE-EU","CROATIA","GATWICK","ZADAR",5990,5990,0
2023,"WESTERN EUROPE-EU","CROATIA","GATWICK","ZAGREB",116,116,0
2023,"WESTERN EUROPE-EU","CROATIA","HEATHROW","DUBROVNIK",23575,23575,0
2023,"WESTERN EUROPE-EU","CROATIA","HEATHROW","PULA",4568,4568,0
2023,"WESTERN EUROPE-EU","CROATIA","HEATHROW","SPLIT",62598,62598,0
2023,"WESTERN EUROPE-EU","CROATIA","HEATHROW","ZAGREB",101168,101168,0
2023,"WESTERN EUROPE-EU","CROATIA","LONDON CITY","SPLIT",3245,3245,0
2023,"WESTERN EUROPE-EU","CROATIA","LUTON","DUBROVNIK",20698,20698,0
2023,"WESTERN EUROPE-EU","CROATIA","LUTON","PULA",11314,11314,0
2023,"WESTERN EUROPE-EU","CROATIA","LUTON","SPLIT",130558,130558,0
2023,"WESTERN EUROPE-EU","CROATIA","LUTON","ZAGREB",0,0,0
2023,"WESTERN EUROPE-EU","CROATIA","STANSTED","DUBROVNIK",39292,39292,0
2023,"WESTERN EUROPE-EU","CROATIA","STANSTED","OSIJEK",13260,13260,0
2023,"WESTERN EUROPE-EU","CROATIA","STANSTED","PULA",23415,23415,0
2023,"WESTERN EUROPE-EU","CROATIA","STANSTED","RIJEKA",11314,11314,0
2023,"WESTERN EUROPE-EU","CROATIA","STANSTED","SPLIT",25425,25425,0
2023,"WESTERN EUROPE-EU","CROATIA","STANSTED","ZADAR",33825,33825,0
2023,"WESTERN EUROPE-EU","CROATIA","STANSTED","ZAGREB",118078,118078,0
2023,"WESTERN EUROPE-EU","CYPRUS","GATWICK","LARNACA",333814,284855,48959
2023,"WESTERN EUROPE-EU","CYPRUS","GATWICK","PAPHOS",392831,321266,71565
2023,"WESTERN EUROPE-EU","CYPRUS","HEATHROW","LARNACA",379982,379982,0
2023,"WESTERN EUROPE-EU","CYPRUS","HEATHROW","PAPHOS",9488,9488,0
2023,"WESTERN EUROPE-EU","CYPRUS","LUTON","LARNACA",209139,208960,179
2023,"WESTERN EUROPE-EU","CYPRUS","LUTON","PAPHOS",59919,59919,0
2023,"WESTERN EUROPE-EU","CYPRUS","STANSTED","LARNACA",52396,52396,0
2023,"WESTERN EUROPE-EU","CYPRUS","STANSTED","PAPHOS",226761,203635,23126
2023,"WESTERN EUROPE-EU","DENMARK","GATWICK","COPENHAGEN",595588,595588,0
2023,"WESTERN EUROPE-EU","DENMARK","HEATHROW","BILLUND",70331,70331,0
2023,"WESTERN EUROPE-EU","DENMARK","HEATHROW","COPENHAGEN",868873,868873,0
2023,"WESTERN EUROPE-EU","DENMARK","LONDON CITY","BILLUND",7430,7430,0
2023,"WESTERN EUROPE-EU","DENMARK","LUTON","COPENHAGEN",0,0,0
2023,"WESTERN EUROPE-EU","DENMARK","STANSTED","AALBORG",39615,39615,0
2023,"WESTERN EUROPE-EU","DENMARK","STANSTED","AARHUS (TIRSTRUP)",105437,105437,0
2023,"WESTERN EUROPE-EU","DENMARK","STANSTED","BILLUND",252276,252276,0
2023,"WESTERN EUROPE-EU","DENMARK","STANSTED","COPENHAGEN",357506,357410,96
2023,"WESTERN EUROPE-EU","FINLAND","GATWICK","ENONTEKIO",5542,0,5542
2023,"WESTERN EUROPE-EU","FINLAND","GATWICK","HELSINKI",74167,74167,0
2023,"WESTERN EUROPE-EU","FINLAND","GATWICK","IVALO",8505,0,8505
2023,"WESTERN EUROPE-EU","FINLAND","GATWICK","KITTILA",22146,3311,18835
2023,"WESTERN EUROPE-EU","FINLAND","GATWICK","KUUSAMO",8439,0,8439
2023,"WESTERN EUROPE-EU","FINLAND","GATWICK","ROVANIEMI",31076,17932,13144
2023,"WESTERN EUROPE-EU","FINLAND","HEATHROW","HELSINKI",536365,536365,0
2023,"WESTERN EUROPE-EU","FINLAND","HEATHROW","KITTILA",2351,0,2351
2023,"WESTERN EUROPE-EU","FINLAND","LUTON","IVALO",858,0,858
2023,"WESTERN EUROPE-EU","FINLAND","LUTON","ROVANIEMI",2190,2190,0
2023,"WESTERN EUROPE-EU","FINLAND","STANSTED","ENONTEKIO",1504,0,1504
2023,"WESTERN EUROPE-EU","FINLAND","STANSTED","HELSINKI",119132,119132,0
2023,"WESTERN EUROPE-EU","FINLAND","STANSTED","IVALO",2597,0,2597
2023,"WESTERN EUROPE-EU","FINLAND","STANSTED","KITTILA",186,0,186
2023,"WESTERN EUROPE-EU","FINLAND","STANSTED","KUUSAMO",4492,0,4492
2023,"WESTERN EUROPE-EU","FINLAND","STANSTED","ROVANIEMI",33662,33511,151
2023,"WESTERN EUROPE-EU","FINLAND","STANSTED","TAMPERE",28252,28252,0
2023,"WESTERN EUROPE-EU","FRANCE","GATWICK","BASTIA",17877,17877,0
2023,"WESTERN EUROPE-EU","FRANCE","GATWICK","BIARRITZ",35247,35247,0
2023,"WESTERN EUROPE-EU","FRANCE","GATWICK","BORDEAUX",297257,297257,0
2023,"WESTERN EUROPE-EU","FRANCE","GATWICK","CALVI",4633,4633,0
2023,"WESTERN EUROPE-EU","FRANCE","GATWICK","CHALONS (VATRY)",0,0,0
2023,"WESTERN EUROPE-EU","FRANCE","GATWICK","CHAMBERY",43962,181,43781
2023,"WESTERN EUROPE-EU","FRANCE","GATWICK","FIGARI",5787,5787,0
2023,"WESTERN EUROPE-EU","FRANCE","GATWICK","GRENOBLE",60880,40731,20149
2023,"WESTERN EUROPE-EU","FRANCE","GATWICK","LA ROCHELLE",20360,20360,0
2023,"WESTERN EUROPE-EU","FRANCE","GATWICK","LILLE",0,0,0
2023,"WESTERN EUROPE-EU","FRANCE","GATWICK","LIMOGES",21754,21754,0
2023,"WESTERN EUROPE-EU","FRANCE","GATWICK","LYON",270778,254270,16508
2023,"WESTERN EUROPE-EU","FRANCE","GATWICK","MARSEILLE",145866,143840,2026
2023,"WESTERN EUROPE-EU","FRANCE","GATWICK","MONTPELLIER",148556,148556,0
2023,"WESTERN EUROPE-EU","FRANCE","GATWICK","NANTES",136853,136853,0
2023,"WESTERN EUROPE-EU","FRANCE","GATWICK","NICE",584645,582820,1825
2023,"WESTERN EUROPE-EU","FRANCE","GATWICK","PARIS (CHARLES DE GAULLE)",422014,421946,68
2023,"WESTERN EUROPE-EU","FRANCE","GATWICK","PARIS (LE BOURGET)",0,0,0
2023,"WESTERN EUROPE-EU","FRANCE","GATWICK","PARIS (ORLY)",256505,256505,0
2023,"WESTERN EUROPE-EU","FRANCE","GATWICK","RENNES",37398,37398,0
2023,"WESTERN EUROPE-EU","FRANCE","GATWICK","STRASBOURG",5013,5013,0
2023,"WESTERN EUROPE-EU","FRANCE","GATWICK","TOULON / HYERES",11318,11318,0
2023,"WESTERN EUROPE-EU","FRANCE","GATWICK","TOULOUSE (BLAGNAC)",111422,95919,15503
2023,"WESTERN EUROPE-EU","FRANCE","HEATHROW","BASTIA",4171,4171,0
2023,"WESTERN EUROPE-EU","FRANCE","HEATHROW","BORDEAUX",0,0,0
2023,"WESTERN EUROPE-EU","FRANCE","HEATHROW","FIGARI",9143,9143,0
2023,"WESTERN EUROPE-EU","FRANCE","HEATHROW","GRENOBLE",14552,8789,5763
2023,"WESTERN EUROPE-EU","FRANCE","HEATHROW","LE TOUQUET",55,0,55
2023,"WESTERN EUROPE-EU","FRANCE","HEATHROW","LYON",251545,245182,6363
2023,"WESTERN EUROPE-EU","FRANCE","HEATHROW","MARSEILLE",261533,260057,1476
2023,"WESTERN EUROPE-EU","FRANCE","HEATHROW","NICE",633101,632517,584
2023,"WESTERN EUROPE-EU","FRANCE","HEATHROW","PARIS (CHARLES DE GAULLE)",1058813,1058625,188
2023,"WESTERN EUROPE-EU","FRANCE","HEATHROW","TOULON / HYERES",313,0,313
2023,"WESTERN EUROPE-EU","FRANCE","HEATHROW","TOULOUSE (BLAGNAC)",242787,242787,0
2023,"WESTERN EUROPE-EU","FRANCE","LONDON CITY","BERGERAC",9509,9509,0
2023,"WESTERN EUROPE-EU","FRANCE","LONDON CITY","CHAMBERY",4479,4479,0
2023,"WESTERN EUROPE-EU","FRANCE","LONDON CITY","LYON",61,61,0
2023,"WESTERN EUROPE-EU","FRANCE","LONDON CITY","NICE",61539,61539,0
2023,"WESTERN EUROPE-EU","FRANCE","LONDON CITY","QUIMPER",3852,3852,0
2023,"WESTERN EUROPE-EU","FRANCE","LUTON","BEZIERS",28116,28116,0
2023,"WESTERN EUROPE-EU","FRANCE","LUTON","BORDEAUX",26805,26805,0
2023,"WESTERN EUROPE-EU","FRANCE","LUTON","GRENOBLE",21599,21599,0
2023,"WESTERN EUROPE-EU","FRANCE","LUTON","LYON",102332,101972,360
2023,"WESTERN EUROPE-EU","FRANCE","LUTON","MARSEILLE",0,0,0
2023,"WESTERN EUROPE-EU","FRANCE","LUTON","MONTPELLIER",8567,8567,0
2023,"WESTERN EUROPE-EU","FRANCE","LUTON","NANTES",0,0,0
2023,"WESTERN EUROPE-EU","FRANCE","LUTON","NICE",149511,149511,0
2023,"WESTERN EUROPE-EU","FRANCE","LUTON","PARIS (CHARLES DE GAULLE)",327484,327484,0
2023,"WESTERN EUROPE-EU","FRANCE","LUTON","PARIS (LE BOURGET)",164,164,0
2023,"WESTERN EUROPE-EU","FRANCE","LUTON","TOULOUSE (BLAGNAC)",154,154,0
2023,"WESTERN EUROPE-EU","FRANCE","SOUTHEND","MARSEILLE",0,0,0
2023,"WESTERN EUROPE-EU","FRANCE","SOUTHEND","PARIS (CHARLES DE GAULLE)",8412,8412,0
2023,"WESTERN EUROPE-EU","FRANCE","STANSTED","AJACCIO",0,0,0
2023,"WESTERN EUROPE-EU","FRANCE","STANSTED","BEAUVAIS",146,146,0
2023,"WESTERN EUROPE-EU","FRANCE","STANSTED","BERGERAC",76007,76007,0
2023,"WESTERN EUROPE-EU","FRANCE","STANSTED","BEZIERS",21984,21984,0
2023,"WESTERN EUROPE-EU","FRANCE","STANSTED","BIARRITZ",85066,85066,0
2023,"WESTERN EUROPE-EU","FRANCE","STANSTED","BORDEAUX",113954,113954,0
2023,"WESTERN EUROPE-EU","FRANCE","STANSTED","BRIVE-LA-GAILLARDE",16269,16269,0
2023,"WESTERN EUROPE-EU","FRANCE","STANSTED","CALVI",2779,0,2779
2023,"WESTERN EUROPE-EU","FRANCE","STANSTED","CARCASSONNE",68483,68483,0
2023,"WESTERN EUROPE-EU","FRANCE","STANSTED","CHAMBERY",16271,9843,6428
2023,"WESTERN EUROPE-EU","FRANCE","STANSTED","CLERMONT FERRAND",0,0,0
2023,"WESTERN EUROPE-EU","FRANCE","STANSTED","DOLE",0,0,0
2023,"WESTERN EUROPE-EU","FRANCE","STANSTED","GRENOBLE",19386,19029,357
2023,"WESTERN EUROPE-EU","FRANCE","STANSTED","LA ROCHELLE",42902,42902,0
2023,"WESTERN EUROPE-EU","FRANCE","STANSTED","LIMOGES",90628,90628,0
2023,"WESTERN EUROPE-EU","FRANCE","STANSTED","LYON",0,0,0
2023,"WESTERN EUROPE-EU","FRANCE","STANSTED","MARSEILLE",196190,194527,1663
2023,"WESTERN EUROPE-EU","FRANCE","STANSTED","MONTPELLIER",54,54,0
2023,"WESTERN EUROPE-EU","FRANCE","STANSTED","NANTES",130213,130213,0
2023,"WESTERN EUROPE-EU","FRANCE","STANSTED","NICE",62565,61799,766
2023,"WESTERN EUROPE-EU","FRANCE","STANSTED","NIMES",25865,25865,0
2023,"WESTERN EUROPE-EU","FRANCE","STANSTED","PARIS (ORLY)",322,322,0
2023,"WESTERN EUROPE-EU","FRANCE","STANSTED","PERPIGNAN",41358,41358,0
2023,"WESTERN EUROPE-EU","FRANCE","STANSTED","POITIERS",50081,50081,0
2023,"WESTERN EUROPE-EU","FRANCE","STANSTED","RODEZ",9049,9049,0
2023,"WESTERN EUROPE-EU","FRANCE","STANSTED","TARBES-LOURDES INTERNATIONAL",73607,70362,3245
2023,"WESTERN EUROPE-EU","FRANCE","STANSTED","TOULOUSE (BLAGNAC)",167556,167555,1
2023,"WESTERN EUROPE-EU","FRANCE","STANSTED","TOURS",37530,37530,0
2023,"WESTERN EUROPE-EU","GERMANY","GATWICK","BERLIN BRANDENBURG",290482,290482,0
2023,"WESTERN EUROPE-EU","GERMANY","GATWICK","COLOGNE BONN",162,0,162
2023,"WESTERN EUROPE-EU","GERMANY","GATWICK","DORTMUND",103,0,103
2023,"WESTERN EUROPE-EU","GERMANY","GATWICK","DUSSELDORF",632,104,528
2023,"WESTERN EUROPE-EU","GERMANY","GATWICK","FRANKFURT MAIN",115579,113398,2181
2023,"WESTERN EUROPE-EU","GERMANY","GATWICK","FRIEDRICHSHAFEN",3600,3600,0
2023,"WESTERN EUROPE-EU","GERMANY","GATWICK","HAMBURG",99791,99304,487
2023,"WESTERN EUROPE-EU","GERMANY","GATWICK","MUNICH",159082,159082,0
2023,"WESTERN EUROPE-EU","GERMANY","GATWICK","NUREMBERG",2458,2458,0
2023,"WESTERN EUROPE-EU","GERMANY","HEATHROW","BERLIN BRANDENBURG",539471,539471,0
2023,"WESTERN EUROPE-EU","GERMANY","HEATHROW","COLOGNE BONN",196832,196832,0
2023,"WESTERN EUROPE-EU","GERMANY","HEATHROW","DORTMUND",248,248,0
2023,"WESTERN EUROPE-EU","GERMANY","HEATHROW","DUSSELDORF",602968,602968,0
2023,"WESTERN EUROPE-EU","GERMANY","HEATHROW","FRANKFURT MAIN",1333000,1333000,0
2023,"WESTERN EUROPE-EU","GERMANY","HEATHROW","HAMBURG",551429,551429,0
2023,"WESTERN EUROPE-EU","GERMANY","HEATHROW","HANOVER",181052,181052,0
2023,"WESTERN EUROPE-EU","GERMANY","HEATHROW","LEIPZIG",0,0,0
2023,"WESTERN EUROPE-EU","GERMANY","HEATHROW","MUNICH",1209739,1209739,0
2023,"WESTERN EUROPE-EU","GERMANY","HEATHROW","NUREMBERG",57144,57144,0
2023,"WESTERN EUROPE-EU","GERMANY","HEATHROW","STUTTGART",354902,354902,0
2023,"WESTERN EUROPE-EU","GERMANY","LONDON CITY","BERLIN BRANDENBURG",175042,175042,0
2023,"WESTERN EUROPE-EU","GERMANY","LONDON CITY","DUSSELDORF",128443,128443,0
2023,"WESTERN EUROPE-EU","GERMANY","LONDON CITY","FRANKFURT MAIN",250450,250450,0
2023,"WESTERN EUROPE-EU","GERMANY","LUTON","BERLIN BRANDENBURG",87040,87040,0
2023,"WESTERN EUROPE-EU","GERMANY","LUTON","COLOGNE BONN",374,374,0
2023,"WESTERN EUROPE-EU","GERMANY","LUTON","FRANKFURT MAIN",0,0,0
2023,"WESTERN EUROPE-EU","GERMANY","LUTON","HAHN",151,151,0
2023,"WESTERN EUROPE-EU","GERMANY","LUTON","HAMBURG",180,180,0
2023,"WESTERN EUROPE-EU","GERMANY","LUTON","LUBECK",164,0,164
2023,"WESTERN EUROPE-EU","GERMANY","LUTON","MUNSTER-OSNABRUCK",0,0,0
2023,"WESTERN EUROPE-EU","GERMANY","LUTON","NUREMBERG",57,0,57
2023,"WESTERN EUROPE-EU","GERMANY","LUTON","PADERBORN",0,0,0
2023,"WESTERN EUROPE-EU","GERMANY","STANSTED","BERLIN BRANDENBURG",405098,404973,125
2023,"WESTERN EUROPE-EU","GERMANY","STANSTED","BRAUNSCHWEIG",0,0,0
2023,"WESTERN EUROPE-EU","GERMANY","STANSTED","BREMEN",155729,155729,0
2023,"WESTERN EUROPE-EU","GERMANY","STANSTED","COLOGNE BONN",309690,309690,0
2023,"WESTERN EUROPE-EU","GERMANY","STANSTED","DORTMUND",106647,106402,245
2023,"WESTERN EUROPE-EU","GERMANY","STANSTED","DRESDEN",30960,30864,96
2023,"WESTERN EUROPE-EU","GERMANY","STANSTED","DUSSELDORF",90,90,0
2023,"WESTERN EUROPE-EU","GERMANY","STANSTED","FRANKFURT MAIN",96,96,0
2023,"WESTERN EUROPE-EU","GERMANY","STANSTED","HAHN",136151,136151,0
2023,"WESTERN EUROPE-EU","GERMANY","STANSTED","HAMBURG",192497,191891,606
2023,"WESTERN EUROPE-EU","GERMANY","STANSTED","KARLSRUHE/BADEN BADEN",138786,138786,0
2023,"WESTERN EUROPE-EU","GERMANY","STANSTED","LEIPZIG",53433,53433,0
2023,"WESTERN EUROPE-EU","GERMANY","STANSTED","MEMMINGEN ALLGAU",87438,87438,0
2023,"WESTERN EUROPE-EU","GERMANY","STANSTED","MUNICH",5612,5612,0
2023,"WESTERN EUROPE-EU","GERMANY","STANSTED","MUNSTER-OSNABRUCK",189,189,0
2023,"WESTERN EUROPE-EU","GERMANY","STANSTED","NIEDERRHEIN",860,860,0
2023,"WESTERN EUROPE-EU","GERMANY","STANSTED","NUREMBERG",144049,144049,0
2023,"WESTERN EUROPE-EU","GIBRALTAR","GATWICK","GIBRALTAR",160867,160867,0
2023,"WESTERN EUROPE-EU","GIBRALTAR","HEATHROW","GIBRALTAR",173014,173014,0
2023,"WESTERN EUROPE-EU","GIBRALTAR","LUTON","GIBRALTAR",0,0,0
2023,"WESTERN EUROPE-EU","GIBRALTAR","STANSTED","GIBRALTAR",172,172,0
2023,"WESTERN EUROPE-EU","GREECE","GATWICK","ATHENS",454082,453928,154
2023,"WESTERN EUROPE-EU","GREECE","GATWICK","CHANIA",161930,138379,23551
2023,"WESTERN EUROPE-EU","GREECE","GATWICK","CORFU",298404,257048,41356
2023,"WESTERN EUROPE-EU","GREECE","GATWICK","HERAKLION",288170,247590,40580
2023,"WESTERN EUROPE-EU","GREECE","GATWICK","KALAMATA",30665,30665,0
2023,"WESTERN EUROPE-EU","GREECE","GATWICK","KAVALA",12564,0,12564
2023,"WESTERN EUROPE-EU","GREECE","GATWICK","KEFALLINIA",133057,108863,24194
2023,"WESTERN EUROPE-EU","GREECE","GATWICK","KOS",175754,117952,57802
2023,"WESTERN EUROPE-EU","GREECE","GATWICK","LEMNOS",5868,5868,0
2023,"WESTERN EUROPE-EU","GREECE","GATWICK","MIKONOS",102154,102154,0
2023,"WESTERN EUROPE-EU","GREECE","GATWICK","MYTILINI",5203,5203,0
2023,"WESTERN EUROPE-EU","GREECE","GATWICK","NEA ANCHIALOS",7333,7333,0
2023,"WESTERN EUROPE-EU","GREECE","GATWICK","PREVEZA",95128,73816,21312
2023,"WESTERN EUROPE-EU","GREECE","GATWICK","RHODES",318735,261915,56820
2023,"WESTERN EUROPE-EU","GREECE","GATWICK","SALONIKA",205888,190482,15406
2023,"WESTERN EUROPE-EU","GREECE","GATWICK","SAMOS",6823,0,6823
2023,"WESTERN EUROPE-EU","GREECE","GATWICK","SKIATHOS",23086,3215,19871
2023,"WESTERN EUROPE-EU","GREECE","GATWICK","THIRA (SANTORINI)",166041,166041,0
2023,"WESTERN EUROPE-EU","GREECE","GATWICK","ZAKINTHOS",135373,91110,44263
2023,"WESTERN EUROPE-EU","GREECE","HEATHROW","ATHENS",801150,801006,144
2023,"WESTERN EUROPE-EU","GREECE","HEATHROW","CHANIA",37525,37525,0
2023,"WESTERN EUROPE-EU","GREECE","HEATHROW","CORFU",105914,105914,0
2023,"WESTERN EUROPE-EU","GREECE","HEATHROW","HERAKLION",26675,26675,0
2023,"WESTERN EUROPE-EU","GREECE","HEATHROW","KALAMATA",18511,18511,0
2023,"WESTERN EUROPE-EU","GREECE","HEATHROW","KEFALLINIA",15070,15070,0
2023,"WESTERN EUROPE-EU","GREECE","HEATHROW","KOS",0,0,0
2023,"WESTERN EUROPE-EU","GREECE","HEATHROW","MIKONOS",57765,57765,0
2023,"WESTERN EUROPE-EU","GREECE","HEATHROW","PREVEZA",23540,23540,0
2023,"WESTERN EUROPE-EU","GREECE","HEATHROW","RHODES",7379,7379,0
2023,"WESTERN EUROPE-EU","GREECE","HEATHROW","SALONIKA",32798,32798,0
2023,"WESTERN EUROPE-EU","GREECE","HEATHROW","THIRA (SANTORINI)",65277,65277,0
2023,"WESTERN EUROPE-EU","GREECE","HEATHROW","ZAKINTHOS",16014,16014,0
2023,"WESTERN EUROPE-EU","GREECE","LONDON CITY","MIKONOS",11719,11719,0
2023,"WESTERN EUROPE-EU","GREECE","LONDON CITY","SALONIKA",3073,3073,0
2023,"WESTERN EUROPE-EU","GREECE","LONDON CITY","SKIATHOS",4721,4721,0
2023,"WESTERN EUROPE-EU","GREECE","LONDON CITY","THIRA (SANTORINI)",0,0,0
2023,"WESTERN EUROPE-EU","GREECE","LUTON","ATHENS",148365,148365,0
2023,"WESTERN EUROPE-EU","GREECE","LUTON","CHANIA",31367,31367,0
2023,"WESTERN EUROPE-EU","GREECE","LUTON","CORFU",83643,67759,15884
2023,"WESTERN EUROPE-EU","GREECE","LUTON","HERAKLION",44992,44992,0
2023,"WESTERN EUROPE-EU","GREECE","LUTON","KALAMATA",0,0,0
2023,"WESTERN EUROPE-EU","GREECE","LUTON","KAVALA",172,0,172
2023,"WESTERN EUROPE-EU","GREECE","LUTON","KEFALLINIA",9685,9685,0
2023,"WESTERN EUROPE-EU","GREECE","LUTON","KOS",6978,0,6978
2023,"WESTERN EUROPE-EU","GREECE","LUTON","MIKONOS",13799,13799,0
2023,"WESTERN EUROPE-EU","GREECE","LUTON","PREVEZA",9832,9830,2
2023,"WESTERN EUROPE-EU","GREECE","LUTON","RHODES",70468,53733,16735
2023,"WESTERN EUROPE-EU","GREECE","LUTON","SALONIKA",55830,55627,203
2023,"WESTERN EUROPE-EU","GREECE","LUTON","SKIATHOS",6385,0,6385
2023,"WESTERN EUROPE-EU","GREECE","LUTON","THIRA (SANTORINI)",15782,15782,0
2023,"WESTERN EUROPE-EU","GREECE","LUTON","ZAKINTHOS",12892,12892,0
2023,"WESTERN EUROPE-EU","GREECE","SOUTHEND","ATHENS",0,0,0
2023,"WESTERN EUROPE-EU","GREECE","SOUTHEND","THIRA (SANTORINI)",74,74,0
2023,"WESTERN EUROPE-EU","GREECE","STANSTED","ATHENS",155352,155265,87
2023,"WESTERN EUROPE-EU","GREECE","STANSTED","CHANIA",60447,60447,0
2023,"WESTERN EUROPE-EU","GREECE","STANSTED","CORFU",102092,86850,15242
2023,"WESTERN EUROPE-EU","GREECE","STANSTED","HERAKLION",104798,90086,14712
2023,"WESTERN EUROPE-EU","GREECE","STANSTED","KALAMATA",15061,15061,0
2023,"WESTERN EUROPE-EU","GREECE","STANSTED","KAVALA",99,0,99
2023,"WESTERN EUROPE-EU","GREECE","STANSTED","KEFALLINIA",62785,49087,13698
2023,"WESTERN EUROPE-EU","GREECE","STANSTED","KOS",66950,66950,0
2023,"WESTERN EUROPE-EU","GREECE","STANSTED","MYTILINI",7986,7986,0
2023,"WESTERN EUROPE-EU","GREECE","STANSTED","PREVEZA",25735,25735,0
2023,"WESTERN EUROPE-EU","GREECE","STANSTED","RHODES",152048,135605,16443
2023,"WESTERN EUROPE-EU","GREECE","STANSTED","SALONIKA",135729,135729,0
2023,"WESTERN EUROPE-EU","GREECE","STANSTED","SKIATHOS",24355,24355,0
2023,"WESTERN EUROPE-EU","GREECE","STANSTED","THIRA (SANTORINI)",43662,43662,0
2023,"WESTERN EUROPE-EU","GREECE","STANSTED","ZAKINTHOS",55666,42056,13610
2023,"WESTERN EUROPE-EU","IRISH REPUBLIC","GATWICK","CORK",120945,120945,0
2023,"WESTERN EUROPE-EU","IRISH REPUBLIC","GATWICK","DUBLIN",1279921,1279921,0
2023,"WESTERN EUROPE-EU","IRISH REPUBLIC","GATWICK","IRELAND WEST(KNOCK)",12009,12009,0
2023,"WESTERN EUROPE-EU","IRISH REPUBLIC","GATWICK","SHANNON",119205,119205,0
2023,"WESTERN EUROPE-EU","IRISH REPUBLIC","HEATHROW","CORK",375956,375956,0
2023,"WESTERN EUROPE-EU","IRISH REPUBLIC","HEATHROW","DUBLIN",1693197,1693043,154
2023,"WESTERN EUROPE-EU","IRISH REPUBLIC","HEATHROW","IRELAND WEST(KNOCK)",67866,67866,0
2023,"WESTERN EUROPE-EU","IRISH REPUBLIC","HEATHROW","SHANNON",257193,257193,0
2023,"WESTERN EUROPE-EU","IRISH REPUBLIC","LONDON CITY","DUBLIN",240789,240789,0
2023,"WESTERN EUROPE-EU","IRISH REPUBLIC","LUTON","CORK",76004,76004,0
2023,"WESTERN EUROPE-EU","IRISH REPUBLIC","LUTON","DUBLIN",379855,379855,0
2023,"WESTERN EUROPE-EU","IRISH REPUBLIC","LUTON","IRELAND WEST(KNOCK)",131912,131912,0
2023,"WESTERN EUROPE-EU","IRISH REPUBLIC","LUTON","KERRY COUNTY",109782,109782,0
2023,"WESTERN EUROPE-EU","IRISH REPUBLIC","LUTON","SHANNON",0,0,0
2023,"WESTERN EUROPE-EU","IRISH REPUBLIC","STANSTED","CORK",295367,295367,0
2023,"WESTERN EUROPE-EU","IRISH REPUBLIC","STANSTED","DUBLIN",924316,924316,0
2023,"WESTERN EUROPE-EU","IRISH REPUBLIC","STANSTED","IRELAND WEST(KNOCK)",156892,156892,0
2023,"WESTERN EUROPE-EU","IRISH REPUBLIC","STANSTED","KERRY COUNTY",70914,70914,0
2023,"WESTERN EUROPE-EU","IRISH REPUBLIC","STANSTED","SHANNON",239998,239766,232
2023,"WESTERN EUROPE-EU","ITALY","GATWICK","ANCONA",8328,8328,0
2023,"WESTERN EUROPE-EU","ITALY","GATWICK","BARI (PALESE)",118255,118255,0
2023,"WESTERN EUROPE-EU","ITALY","GATWICK","BERGAMO",52750,52750,0
2023,"WESTERN EUROPE-EU","ITALY","GATWICK","BOLOGNA",53395,53216,179
2023,"WESTERN EUROPE-EU","ITALY","GATWICK","BRINDISI",28314,28314,0
2023,"WESTERN EUROPE-EU","ITALY","GATWICK","CAGLIARI (ELMAS)",91105,91105,0
2023,"WESTERN EUROPE-EU","ITALY","GATWICK","CATANIA (FONTANAROSSA)",204343,204343,0
2023,"WESTERN EUROPE-EU","ITALY","GATWICK","COMISO",4182,4182,0
2023,"WESTERN EUROPE-EU","ITALY","GATWICK","FLORENCE",173187,173187,0
2023,"WESTERN EUROPE-EU","ITALY","GATWICK","GENOA",14979,14979,0
2023,"WESTERN EUROPE-EU","ITALY","GATWICK","LAMETIA-TERME",8950,0,8950
2023,"WESTERN EUROPE-EU","ITALY","GATWICK","MILAN (LINATE)",87656,87656,0
2023,"WESTERN EUROPE-EU","ITALY","GATWICK","MILAN (MALPENSA)",690446,690073,373
2023,"WESTERN EUROPE-EU","ITALY","GATWICK","NAPLES",317153,296439,20714
2023,"WESTERN EUROPE-EU","ITALY","GATWICK","OLBIA",92162,84465,7697
2023,"WESTERN EUROPE-EU","ITALY","GATWICK","PALERMO",56171,56171,0
2023,"WESTERN EUROPE-EU","ITALY","GATWICK","PISA",199390,199390,0
2023,"WESTERN EUROPE-EU","ITALY","GATWICK","ROME (FIUMICINO)",797154,796924,230
2023,"WESTERN EUROPE-EU","ITALY","GATWICK","TRIESTE (RONCHI DEI LEGIONARI)",0,0,0
2023,"WESTERN EUROPE-EU","ITALY","GATWICK","TURIN",211556,194418,17138
2023,"WESTERN EUROPE-EU","ITALY","GATWICK","VENICE",383082,382821,261
2023,"WESTERN EUROPE-EU","ITALY","GATWICK","VERONA VILLAFRANCA",231441,212876,18565
2023,"WESTERN EUROPE-EU","ITALY","HEATHROW","BERGAMO",421,421,0
2023,"WESTERN EUROPE-EU","ITALY","HEATHROW","BOLOGNA",255078,255078,0
2023,"WESTERN EUROPE-EU","ITALY","HEATHROW","BRINDISI",26874,26874,0
2023,"WESTERN EUROPE-EU","ITALY","HEATHROW","CATANIA (FONTANAROSSA)",0,0,0
2023,"WESTERN EUROPE-EU","ITALY","HEATHROW","FLORENCE",42533,42533,0
2023,"WESTERN EUROPE-EU","ITALY","HEATHROW","GENOA",126,126,0
2023,"WESTERN EUROPE-EU","ITALY","HEATHROW","MILAN (LINATE)",554280,554280,0
2023,"WESTERN EUROPE-EU","ITALY","HEATHROW","MILAN (MALPENSA)",314944,314944,0
2023,"WESTERN EUROPE-EU","ITALY","HEATHROW","NAPLES",198736,198736,0
2023,"WESTERN EUROPE-EU","ITALY","HEATHROW","OLBIA",25142,25142,0
2023,"WESTERN EUROPE-EU","ITALY","HEATHROW","PALERMO",26383,26383,0
2023,"WESTERN EUROPE-EU","ITALY","HEATHROW","PERUGIA",16406,16406,0
2023,"WESTERN EUROPE-EU","ITALY","HEATHROW","PISA",143049,143049,0
2023,"WESTERN EUROPE-EU","ITALY","HEATHROW","ROME (FIUMICINO)",722485,722485,0
2023,"WESTERN EUROPE-EU","ITALY","HEATHROW","TURIN",699,699,0
2023,"WESTERN EUROPE-EU","ITALY","HEATHROW","VENICE",383349,383349,0
2023,"WESTERN EUROPE-EU","ITALY","HEATHROW","VERONA VILLAFRANCA",0,0,0
2023,"WESTERN EUROPE-EU","ITALY","LONDON CITY","BOLOGNA",96,96,0
2023,"WESTERN EUROPE-EU","ITALY","LONDON CITY","FLORENCE",107178,107178,0
2023,"WESTERN EUROPE-EU","ITALY","LONDON CITY","MILAN (LINATE)",100673,100673,0
2023,"WESTERN EUROPE-EU","ITALY","LONDON CITY","MILAN (MALPENSA)",0,0,0
2023,"WESTERN EUROPE-EU","ITALY","LONDON CITY","PISA",211,211,0
2023,"WESTERN EUROPE-EU","ITALY","LUTON","BARI (PALESE)",43,0,43
2023,"WESTERN EUROPE-EU","ITALY","LUTON","BERGAMO",200,200,0
2023,"WESTERN EUROPE-EU","ITALY","LUTON","BOLOGNA",62237,62237,0
2023,"WESTERN EUROPE-EU","ITALY","LUTON","CATANIA (FONTANAROSSA)",69421,69421,0
2023,"WESTERN EUROPE-EU","ITALY","LUTON","COMISO",2267,2267,0
2023,"WESTERN EUROPE-EU","ITALY","LUTON","FLORENCE",47,0,47
2023,"WESTERN EUROPE-EU","ITALY","LUTON","FORLI",298,298,0
2023,"WESTERN EUROPE-EU","ITALY","LUTON","MILAN (MALPENSA)",96945,96872,73
2023,"WESTERN EUROPE-EU","ITALY","LUTON","NAPLES",128684,128684,0
2023,"WESTERN EUROPE-EU","ITALY","LUTON","OLBIA",20129,20129,0
2023,"WESTERN EUROPE-EU","ITALY","LUTON","PALERMO",26419,26419,0
2023,"WESTERN EUROPE-EU","ITALY","LUTON","PISA",51592,51592,0
2023,"WESTERN EUROPE-EU","ITALY","LUTON","ROME (FIUMICINO)",214,214,0
2023,"WESTERN EUROPE-EU","ITALY","LUTON","TRAPANI",1827,1827,0
2023,"WESTERN EUROPE-EU","ITALY","LUTON","TREVISO",4991,4991,0
2023,"WESTERN EUROPE-EU","ITALY","LUTON","TURIN",6458,6458,0
2023,"WESTERN EUROPE-EU","ITALY","LUTON","VENICE",23037,23037,0
2023,"WESTERN EUROPE-EU","ITALY","SOUTHEND","MILAN (MALPENSA)",100,100,0
2023,"WESTERN EUROPE-EU","ITALY","STANSTED","ALGHERO (FERTILIA)",27232,27232,0
2023,"WESTERN EUROPE-EU","ITALY","STANSTED","ANCONA",94465,94465,0
2023,"WESTERN EUROPE-EU","ITALY","STANSTED","BARI (PALESE)",126201,126201,0
2023,"WESTERN EUROPE-EU","ITALY","STANSTED","BERGAMO",514718,514718,0
2023,"WESTERN EUROPE-EU","ITALY","STANSTED","BOLOGNA",201358,201358,0
2023,"WESTERN EUROPE-EU","ITALY","STANSTED","BRINDISI",76171,76171,0
2023,"WESTERN EUROPE-EU","ITALY","STANSTED","CAGLIARI (ELMAS)",61519,61519,0
2023,"WESTERN EUROPE-EU","ITALY","STANSTED","CATANIA (FONTANAROSSA)",49362,49362,0
2023,"WESTERN EUROPE-EU","ITALY","STANSTED","FLORENCE",0,0,0
2023,"WESTERN EUROPE-EU","ITALY","STANSTED","GENOA",76061,76061,0
2023,"WESTERN EUROPE-EU","ITALY","STANSTED","LAMETIA-TERME",46106,46106,0
2023,"WESTERN EUROPE-EU","ITALY","STANSTED","MILAN (LINATE)",0,0,0
2023,"WESTERN EUROPE-EU","ITALY","STANSTED","MILAN (MALPENSA)",353601,353601,0
2023,"WESTERN EUROPE-EU","ITALY","STANSTED","NAPLES",204038,204038,0
2023,"WESTERN EUROPE-EU","ITALY","STANSTED","OLBIA",8049,8049,0
2023,"WESTERN EUROPE-EU","ITALY","STANSTED","PALERMO",121692,121692,0
2023,"WESTERN EUROPE-EU","ITALY","STANSTED","PERUGIA",99354,99264,90
2023,"WESTERN EUROPE-EU","ITALY","STANSTED","PESCARA",100686,100686,0
2023,"WESTERN EUROPE-EU","ITALY","STANSTED","PISA",292501,292501,0
2023,"WESTERN EUROPE-EU","ITALY","STANSTED","RIMINI",26562,26562,0
2023,"WESTERN EUROPE-EU","ITALY","STANSTED","ROME (CIAMPINO)",561141,561141,0
2023,"WESTERN EUROPE-EU","ITALY","STANSTED","ROME (FIUMICINO)",43943,43843,100
2023,"WESTERN EUROPE-EU","ITALY","STANSTED","TRAPANI",20616,20616,0
2023,"WESTERN EUROPE-EU","ITALY","STANSTED","TREVISO",0,0,0
2023,"WESTERN EUROPE-EU","ITALY","STANSTED","TRIESTE (RONCHI DEI LEGIONARI)",56116,56116,0
2023,"WESTERN EUROPE-EU","ITALY","STANSTED","TURIN",151380,145527,5853
2023,"WESTERN EUROPE-EU","ITALY","STANSTED","VENICE",352545,352545,0
2023,"WESTERN EUROPE-EU","ITALY","STANSTED","VERONA VILLAFRANCA",99400,99400,0
2023,"WESTERN EUROPE-EU","LUXEMBOURG","GATWICK","LUXEMBOURG",0,0,0
2023,"WESTERN EUROPE-EU","LUXEMBOURG","HEATHROW","LUXEMBOURG",118896,118896,0
2023,"WESTERN EUROPE-EU","LUXEMBOURG","LONDON CITY","LUXEMBOURG",167997,167997,0
2023,"WESTERN EUROPE-EU","LUXEMBOURG","LUTON","LUXEMBOURG",90,90,0
2023,"WESTERN EUROPE-EU","LUXEMBOURG","STANSTED","LUXEMBOURG",115239,115239,0
2023,"WESTERN EUROPE-EU","MALTA","GATWICK","MALTA",423709,402163,21546
2023,"WESTERN EUROPE-EU","MALTA","HEATHROW","MALTA",230837,230837,0
2023,"WESTERN EUROPE-EU","MALTA","LUTON","MALTA",72112,72112,0
2023,"WESTERN EUROPE-EU","MALTA","SOUTHEND","MALTA",0,0,0
2023,"WESTERN EUROPE-EU","MALTA","STANSTED","MALTA",143837,143676,161
2023,"WESTERN EUROPE-EU","NETHERLANDS","GATWICK","AMSTERDAM",831404,830958,446
2023,"WESTERN EUROPE-EU","NETHERLANDS","HEATHROW","AMSTERDAM",1385530,1385530,0
2023,"WESTERN EUROPE-EU","NETHERLANDS","LONDON CITY","AMSTERDAM",518191,518191,0
2023,"WESTERN EUROPE-EU","NETHERLANDS","LONDON CITY","ROTTERDAM",136175,136175,0
2023,"WESTERN EUROPE-EU","NETHERLANDS","LUTON","AMSTERDAM",568164,568164,0
2023,"WESTERN EUROPE-EU","NETHERLANDS","LUTON","EINDHOVEN",539,220,319
2023,"WESTERN EUROPE-EU","NETHERLANDS","SOUTHEND","AMSTERDAM",30441,30441,0
2023,"WESTERN EUROPE-EU","NETHERLANDS","STANSTED","AMSTERDAM",174564,174267,297
2023,"WESTERN EUROPE-EU","NETHERLANDS","STANSTED","EINDHOVEN",338317,338317,0
2023,"WESTERN EUROPE-EU","NETHERLANDS","STANSTED","MAASTRICHT",18269,18269,0
2023,"WESTERN EUROPE-EU","NETHERLANDS","STANSTED","ROTTERDAM",38,38,0
2023,"WESTERN EUROPE-EU","PORTUGAL(EXCLUDING MADEIRA)","GATWICK","AZORES LAJES TERCEIRA ISLAND",0,0,0
2023,"WESTERN EUROPE-EU","PORTUGAL(EXCLUDING MADEIRA)","GATWICK","FARO",847091,827913,19178
2023,"WESTERN EUROPE-EU","PORTUGAL(EXCLUDING MADEIRA)","GATWICK","LISBON",442286,442286,0
2023,"WESTERN EUROPE-EU","PORTUGAL(EXCLUDING MADEIRA)","GATWICK","OPORTO (PORTUGAL)",317786,317786,0
2023,"WESTERN EUROPE-EU","PORTUGAL(EXCLUDING MADEIRA)","HEATHROW","AZORES LAJES TERCEIRA ISLAND",0,0,0
2023,"WESTERN EUROPE-EU","PORTUGAL(EXCLUDING MADEIRA)","HEATHROW","AZORES PONTA DELGADA",3362,3362,0
2023,"WESTERN EUROPE-EU","PORTUGAL(EXCLUDING MADEIRA)","HEATHROW","FARO",122491,122491,0
2023,"WESTERN EUROPE-EU","PORTUGAL(EXCLUDING MADEIRA)","HEATHROW","LISBON",1045538,1045538,0
2023,"WESTERN EUROPE-EU","PORTUGAL(EXCLUDING MADEIRA)","HEATHROW","OPORTO (PORTUGAL)",92586,92586,0
2023,"WESTERN EUROPE-EU","PORTUGAL(EXCLUDING MADEIRA)","LONDON CITY","FARO",10883,10883,0
2023,"WESTERN EUROPE-EU","PORTUGAL(EXCLUDING MADEIRA)","LUTON","CASCAIS",424,424,0
2023,"WESTERN EUROPE-EU","PORTUGAL(EXCLUDING MADEIRA)","LUTON","FARO",300692,300692,0
2023,"WESTERN EUROPE-EU","PORTUGAL(EXCLUDING MADEIRA)","LUTON","LISBON",412793,412793,0
2023,"WESTERN EUROPE-EU","PORTUGAL(EXCLUDING MADEIRA)","LUTON","OPORTO (PORTUGAL)",91716,91716,0
2023,"WESTERN EUROPE-EU","PORTUGAL(EXCLUDING MADEIRA)","SOUTHEND","FARO",20363,20363,0
2023,"WESTERN EUROPE-EU","PORTUGAL(EXCLUDING MADEIRA)","STANSTED","AZORES LAJES TERCEIRA ISLAND",0,0,0
2023,"WESTERN EUROPE-EU","PORTUGAL(EXCLUDING MADEIRA)","STANSTED","AZORES PONTA DELGADA",10354,10354,0
2023,"WESTERN EUROPE-EU","PORTUGAL(EXCLUDING MADEIRA)","STANSTED","FARO",431094,431094,0
2023,"WESTERN EUROPE-EU","PORTUGAL(EXCLUDING MADEIRA)","STANSTED","LISBON",442482,442482,0
2023,"WESTERN EUROPE-EU","PORTUGAL(EXCLUDING MADEIRA)","STANSTED","OPORTO (PORTUGAL)",364304,364304,0
2023,"WESTERN EUROPE-EU","PORTUGAL(MADEIRA)","GATWICK","FUNCHAL",207054,206750,304
2023,"WESTERN EUROPE-EU","PORTUGAL(MADEIRA)","GATWICK","PORTO SANTO",9203,0,9203
2023,"WESTERN EUROPE-EU","PORTUGAL(MADEIRA)","HEATHROW","FUNCHAL",88016,88016,0
2023,"WESTERN EUROPE-EU","PORTUGAL(MADEIRA)","LUTON","FUNCHAL",7675,7675,0
2023,"WESTERN EUROPE-EU","PORTUGAL(MADEIRA)","STANSTED","FUNCHAL",137339,137339,0
2023,"WESTERN EUROPE-EU","SLOVENIA","GATWICK","LJUBLJANA",73911,73911,0
2023,"WESTERN EUROPE-EU","SLOVENIA","HEATHROW","LJUBLJANA",43191,43191,0
2023,"WESTERN EUROPE-EU","SLOVENIA","LUTON","LJUBLJANA",40561,40561,0
2023,"WESTERN EUROPE-EU","SLOVENIA","STANSTED","LJUBLJANA",0,0,0
2023,"WESTERN EUROPE-EU","SPAIN","GATWICK","A CORUNA",57012,57012,0
2023,"WESTERN EUROPE-EU","SPAIN","GATWICK","ALICANTE",737493,715875,21618
2023,"WESTERN EUROPE-EU","SPAIN","GATWICK","ALMERIA",86516,86516,0
2023,"WESTERN EUROPE-EU","SPAIN","GATWICK","ASTURIAS",61645,61645,0
2023,"WESTERN EUROPE-EU","SPAIN","GATWICK","BARCELONA",1276439,1276139,300
2023,"WESTERN EUROPE-EU","SPAIN","GATWICK","BILBAO",346546,346546,0
2023,"WESTERN EUROPE-EU","SPAIN","GATWICK","GIRONA",13638,0,13638
2023,"WESTERN EUROPE-EU","SPAIN","GATWICK","GRANADA",33787,33787,0
2023,"WESTERN EUROPE-EU","SPAIN","GATWICK","IBIZA",292064,244434,47630
2023,"WESTERN EUROPE-EU","SPAIN","GATWICK","JEREZ",8939,0,8939
2023,"WESTERN EUROPE-EU","SPAIN","GATWICK","MADRID",668685,668571,114
2023,"WESTERN EUROPE-EU","SPAIN","GATWICK","MAHON",249271,213350,35921
2023,"WESTERN EUROPE-EU","SPAIN","GATWICK","MALAGA",1122026,1090832,31194
2023,"WESTERN EUROPE-EU","SPAIN","GATWICK","MURCIA INTERNATIONAL",158090,158090,0
2023,"WESTERN EUROPE-EU","SPAIN","GATWICK","PALMA DE MALLORCA",678472,573758,104714
2023,"WESTERN EUROPE-EU","SPAIN","GATWICK","REUS",24360,0,24360
2023,"WESTERN EUROPE-EU","SPAIN","GATWICK","SANTIAGO DE COMPOSTELA (SPAIN)",105028,105028,0
2023,"WESTERN EUROPE-EU","SPAIN","GATWICK","SEVILLE",357848,357848,0
2023,"WESTERN EUROPE-EU","SPAIN","GATWICK","VALENCIA",356184,356184,0
2023,"WESTERN EUROPE-EU","SPAIN","HEATHROW","BARCELONA",751878,751878,0
2023,"WESTERN EUROPE-EU","SPAIN","HEATHROW","BILBAO",0,0,0
2023,"WESTERN EUROPE-EU","SPAIN","HEATHROW","IBIZA",113672,113672,0
2023,"WESTERN EUROPE-EU","SPAIN","HEATHROW","MADRID",1471836,1471836,0
2023,"WESTERN EUROPE-EU","SPAIN","HEATHROW","MALAGA",199336,199336,0
2023,"WESTERN EUROPE-EU","SPAIN","HEATHROW","PALMA DE MALLORCA",171479,171479,0
2023,"WESTERN EUROPE-EU","SPAIN","HEATHROW","SEVILLE",0,0,0
2023,"WESTERN EUROPE-EU","SPAIN","HEATHROW","VALENCIA",106952,106952,0
2023,"WESTERN EUROPE-EU","SPAIN","LONDON CITY","BARCELONA",36965,36965,0
2023,"WESTERN EUROPE-EU","SPAIN","LONDON CITY","BILBAO",72,72,0
2023,"WESTERN EUROPE-EU","SPAIN","LONDON CITY","IBIZA",97628,97538,90
2023,"WESTERN EUROPE-EU","SPAIN","LONDON CITY","MAHON",0,0,0
2023,"WESTERN EUROPE-EU","SPAIN","LONDON CITY","MALAGA",53404,53404,0
2023,"WESTERN EUROPE-EU","SPAIN","LONDON CITY","PALMA DE MALLORCA",51418,51418,0
2023,"WESTERN EUROPE-EU","SPAIN","LONDON CITY","SAN SEBASTIAN",4795,4795,0
2023,"WESTERN EUROPE-EU","SPAIN","LUTON","ALICANTE",305695,305695,0
2023,"WESTERN EUROPE-EU","SPAIN","LUTON","ALMERIA",0,0,0
2023,"WESTERN EUROPE-EU","SPAIN","LUTON","BARCELONA",243572,243572,0
2023,"WESTERN EUROPE-EU","SPAIN","LUTON","CASTELLON COSTA AZAHAR",0,0,0
2023,"WESTERN EUROPE-EU","SPAIN","LUTON","GIRONA",0,0,0
2023,"WESTERN EUROPE-EU","SPAIN","LUTON","IBIZA",69194,69194,0
2023,"WESTERN EUROPE-EU","SPAIN","LUTON","MADRID",17725,17725,0
2023,"WESTERN EUROPE-EU","SPAIN","LUTON","MAHON",44488,44488,0
2023,"WESTERN EUROPE-EU","SPAIN","LUTON","MALAGA",379242,379242,0
2023,"WESTERN EUROPE-EU","SPAIN","LUTON","MURCIA INTERNATIONAL",77127,77127,0
2023,"WESTERN EUROPE-EU","SPAIN","LUTON","PALMA DE MALLORCA",346956,318066,28890
2023,"WESTERN EUROPE-EU","SPAIN","LUTON","SANTIAGO DE COMPOSTELA (SPAIN)",145,145,0
2023,"WESTERN EUROPE-EU","SPAIN","LUTON","SEVILLE",34028,34028,0
2023,"WESTERN EUROPE-EU","SPAIN","LUTON","VALENCIA",201,201,0
2023,"WESTERN EUROPE-EU","SPAIN","SOUTHEND","ALICANTE",5819,5819,0
2023,"WESTERN EUROPE-EU","SPAIN","SOUTHEND","MALAGA",41968,41968,0
2023,"WESTERN EUROPE-EU","SPAIN","SOUTHEND","PALMA DE MALLORCA",36734,36734,0
2023,"WESTERN EUROPE-EU","SPAIN","STANSTED","ALICANTE",449744,449744,0
2023,"WESTERN EUROPE-EU","SPAIN","STANSTED","ALMERIA",32689,32689,0
2023,"WESTERN EUROPE-EU","SPAIN","STANSTED","ASTURIAS",42714,42714,0
2023,"WESTERN EUROPE-EU","SPAIN","STANSTED","BADAJOZ",263,0,263
2023,"WESTERN EUROPE-EU","SPAIN","STANSTED","BARCELONA",497446,497142,304
2023,"WESTERN EUROPE-EU","SPAIN","STANSTED","BILBAO",0,0,0
2023,"WESTERN EUROPE-EU","SPAIN","STANSTED","CASTELLON COSTA AZAHAR",49031,49031,0
2023,"WESTERN EUROPE-EU","SPAIN","STANSTED","GIRONA",151996,151996,0
2023,"WESTERN EUROPE-EU","SPAIN","STANSTED","IBIZA",232551,217512,15039
2023,"WESTERN EUROPE-EU","SPAIN","STANSTED","JEREZ",32639,32639,0
2023,"WESTERN EUROPE-EU","SPAIN","STANSTED","MADRID",429951,429589,362
2023,"WESTERN EUROPE-EU","SPAIN","STANSTED","MAHON",96720,79374,17346
2023,"WESTERN EUROPE-EU","SPAIN","STANSTED","MALAGA",416179,416111,68
2023,"WESTERN EUROPE-EU","SPAIN","STANSTED","MURCIA INTERNATIONAL",108145,108145,0
2023,"WESTERN EUROPE-EU","SPAIN","STANSTED","PALMA DE MALLORCA",479930,445242,34688
2023,"WESTERN EUROPE-EU","SPAIN","STANSTED","REUS",94697,94697,0
2023,"WESTERN EUROPE-EU","SPAIN","STANSTED","SANTANDER",83764,83764,0
2023,"WESTERN EUROPE-EU","SPAIN","STANSTED","SANTIAGO DE COMPOSTELA (SPAIN)",108038,108038,0
2023,"WESTERN EUROPE-EU","SPAIN","STANSTED","SEVILLE",174224,174018,206
2023,"WESTERN EUROPE-EU","SPAIN","STANSTED","VALENCIA",209185,208988,197
2023,"WESTERN EUROPE-EU","SPAIN","STANSTED","VIGO",34984,34984,0
2023,"WESTERN EUROPE-EU","SPAIN","STANSTED","ZARAGOZA",74025,74025,0
2023,"WESTERN EUROPE-EU","SPAIN(CANARY ISLANDS)","GATWICK","ARRECIFE",456123,395495,60628
2023,"WESTERN EUROPE-EU","SPAIN(CANARY ISLANDS)","GATWICK","FUERTEVENTURA",189751,140867,48884
2023,"WESTERN EUROPE-EU","SPAIN(CANARY ISLANDS)","GATWICK","LAS PALMAS",283217,219093,64124
2023,"WESTERN EUROPE-EU","SPAIN(CANARY ISLANDS)","GATWICK","SANTA CRUZ DE LA PALMA",16078,0,16078
2023,"WESTERN EUROPE-EU","SPAIN(CANARY ISLANDS)","GATWICK","TENERIFE (SURREINA SOFIA)",710578,577408,133170
2023,"WESTERN EUROPE-EU","SPAIN(CANARY ISLANDS)","HEATHROW","ARRECIFE",0,0,0
2023,"WESTERN EUROPE-EU","SPAIN(CANARY ISLANDS)","HEATHROW","LAS PALMAS",0,0,0
2023,"WESTERN EUROPE-EU","SPAIN(CANARY ISLANDS)","HEATHROW","TENERIFE (SURREINA SOFIA)",63511,63511,0
2023,"WESTERN EUROPE-EU","SPAIN(CANARY ISLANDS)","LUTON","ARRECIFE",113677,80726,32951
2023,"WESTERN EUROPE-EU","SPAIN(CANARY ISLANDS)","LUTON","FUERTEVENTURA",77976,77976,0
2023,"WESTERN EUROPE-EU","SPAIN(CANARY ISLANDS)","LUTON","LAS PALMAS",81238,81060,178
2023,"WESTERN EUROPE-EU","SPAIN(CANARY ISLANDS)","LUTON","TENERIFE (SURREINA SOFIA)",173604,160118,13486
2023,"WESTERN EUROPE-EU","SPAIN(CANARY ISLANDS)","STANSTED","ARRECIFE",274938,274938,0
2023,"WESTERN EUROPE-EU","SPAIN(CANARY ISLANDS)","STANSTED","FUERTEVENTURA",174984,174984,0
2023,"WESTERN EUROPE-EU","SPAIN(CANARY ISLANDS)","STANSTED","LAS PALMAS",233919,203210,30709
2023,"WESTERN EUROPE-EU","SPAIN(CANARY ISLANDS)","STANSTED","TENERIFE (SURREINA SOFIA)",518149,502304,15845
2023,"WESTERN EUROPE-EU","SWEDEN","GATWICK","GOTEBORG (LANDVETTER)",351,0,351
2023,"WESTERN EUROPE-EU","SWEDEN","GATWICK","HALMSTAD",0,0,0
2023,"WESTERN EUROPE-EU","SWEDEN","GATWICK","PAJALA YLLAS",371,0,371
2023,"WESTERN EUROPE-EU","SWEDEN","GATWICK","SCANDINAVIAN MOUNTAINS AIRPORT",902,0,902
2023,"WESTERN EUROPE-EU","SWEDEN","GATWICK","STOCKHOLM (ARLANDA)",346528,346528,0
2023,"WESTERN EUROPE-EU","SWEDEN","HEATHROW","GOTEBORG (LANDVETTER)",212294,212294,0
2023,"WESTERN EUROPE-EU","SWEDEN","HEATHROW","LULEA",2121,2121,0
2023,"WESTERN EUROPE-EU","SWEDEN","HEATHROW","SCANDINAVIAN MOUNTAINS AIRPORT",0,0,0
2023,"WESTERN EUROPE-EU","SWEDEN","HEATHROW","STOCKHOLM (ARLANDA)",812823,812823,0
2023,"WESTERN EUROPE-EU","SWEDEN","SOUTHEND","GOTEBORG (LANDVETTER)",32,32,0
2023,"WESTERN EUROPE-EU","SWEDEN","STANSTED","GOTEBORG (LANDVETTER)",156263,156263,0
2023,"WESTERN EUROPE-EU","SWEDEN","STANSTED","OREBRO",28843,28843,0
2023,"WESTERN EUROPE-EU","SWEDEN","STANSTED","STOCKHOLM (ARLANDA)",203820,203820,0
2023,"WESTERN EUROPE-EU","SWEDEN","STANSTED","VASTERAS",38196,38196,0
2023,"WESTERN EUROPE-EU","SWEDEN","STANSTED","VAXJO",25137,25137,0
2023,"WESTERN EUROPE-OTHER","BOSNIA-HERZEGOVINA","GATWICK","SARAJEVO",3028,0,3028
2023,"WESTERN EUROPE-OTHER","BOSNIA-HERZEGOVINA","LUTON","SARAJEVO",17917,17917,0
2023,"WESTERN EUROPE-OTHER","BOSNIA-HERZEGOVINA","LUTON","TUZLA",0,0,0
2023,"WESTERN EUROPE-OTHER","ICELAND","GATWICK","AKUREYRI",4358,4358,0
2023,"WESTERN EUROPE-OTHER","ICELAND","GATWICK","KEFLAVIK",183057,175278,7779
2023,"WESTERN EUROPE-OTHER","ICELAND","HEATHROW","KEFLAVIK",313265,313265,0
2023,"WESTERN EUROPE-OTHER","ICELAND","LUTON","KEFLAVIK",155048,155048,0
2023,"WESTERN EUROPE-OTHER","ICELAND","STANSTED","AKUREYRI",0,0,0
2023,"WESTERN EUROPE-OTHER","ICELAND","STANSTED","KEFLAVIK",122936,122936,0
2023,"WESTERN EUROPE-OTHER","KOSOVO","GATWICK","PRISTINA",0,0,0
2023,"WESTERN EUROPE-OTHER","KOSOVO","HEATHROW","PRISTINA",0,0,0
2023,"WESTERN EUROPE-OTHER","KOSOVO","LUTON","PRISTINA",131894,131894,0
2023,"WESTERN EUROPE-OTHER","MACEDONIA","GATWICK","OHRID",3718,0,3718
2023,"WESTERN EUROPE-OTHER","MACEDONIA","GATWICK","SKOPJE",292,0,292
2023,"WESTERN EUROPE-OTHER","MACEDONIA","LUTON","OHRID",0,0,0
2023,"WESTERN EUROPE-OTHER","MACEDONIA","LUTON","SKOPJE",61945,61945,0
2023,"WESTERN EUROPE-OTHER","MACEDONIA","STANSTED","OHRID",192,0,192
2023,"WESTERN EUROPE-OTHER","MACEDONIA","STANSTED","SKOPJE",0,0,0
2023,"WESTERN EUROPE-OTHER","NORWAY","GATWICK","ALESUND",0,0,0
2023,"WESTERN EUROPE-OTHER","NORWAY","GATWICK","BERGEN",178707,177955,752
2023,"WESTERN EUROPE-OTHER","NORWAY","GATWICK","KRISTIANSAND (KJEVIK)",276,0,276
2023,"WESTERN EUROPE-OTHER","NORWAY","GATWICK","OSLO (GARDERMOEN)",373545,372627,918
2023,"WESTERN EUROPE-OTHER","NORWAY","GATWICK","STAVANGER",104654,104654,0
2023,"WESTERN EUROPE-OTHER","NORWAY","GATWICK","TROMSOE",13116,13116,0
2023,"WESTERN EUROPE-OTHER","NORWAY","GATWICK","TRONDHEIM (VAERNES)",52474,52474,0
2023,"WESTERN EUROPE-OTHER","NORWAY","HEATHROW","BERGEN",6776,6776,0
2023,"WESTERN EUROPE-OTHER","NORWAY","HEATHROW","OSLO (GARDERMOEN)",652501,652501,0
2023,"WESTERN EUROPE-OTHER","NORWAY","HEATHROW","STAVANGER",56220,56220,0
2023,"WESTERN EUROPE-OTHER","NORWAY","LUTON","BODO",0,0,0
2023,"WESTERN EUROPE-OTHER","NORWAY","LUTON","OSLO (GARDERMOEN)",0,0,0
2023,"WESTERN EUROPE-OTHER","NORWAY","LUTON","TROMSOE",20593,20593,0
2023,"WESTERN EUROPE-OTHER","NORWAY","SOUTHEND","BERGEN",0,0,0
2023,"WESTERN EUROPE-OTHER","NORWAY","SOUTHEND","BODO",0,0,0
2023,"WESTERN EUROPE-OTHER","NORWAY","STANSTED","BARDUFOSS",68,0,68
2023,"WESTERN EUROPE-OTHER","NORWAY","STANSTED","BERGEN",13027,13027,0
2023,"WESTERN EUROPE-OTHER","NORWAY","STANSTED","BODO",0,0,0
2023,"WESTERN EUROPE-OTHER","NORWAY","STANSTED","LONGYEARBYEN (SVALBARD)",117,0,117
2023,"WESTERN EUROPE-OTHER","NORWAY","STANSTED","OSLO (GARDERMOEN)",154691,154691,0
2023,"WESTERN EUROPE-OTHER","NORWAY","STANSTED","SANDEFJORD(TORP)",67967,67967,0
2023,"WESTERN EUROPE-OTHER","REPUBLIC OF MONTENEGRO","GATWICK","PODGORICA",33057,33057,0
2023,"WESTERN EUROPE-OTHER","REPUBLIC OF MONTENEGRO","GATWICK","TIVAT",34765,34765,0
2023,"WESTERN EUROPE-OTHER","REPUBLIC OF MONTENEGRO","STANSTED","PODGORICA",57086,57086,0
2023,"WESTERN EUROPE-OTHER","REPUBLIC OF SERBIA","HEATHROW","BELGRADE",89567,89567,0
2023,"WESTERN EUROPE-OTHER","REPUBLIC OF SERBIA","LUTON","BELGRADE",102550,102550,0
2023,"WESTERN EUROPE-OTHER","SWITZERLAND","GATWICK","BALE MULHOUSE",208577,208577,0
2023,"WESTERN EUROPE-OTHER","SWITZERLAND","GATWICK","GENEVA",738182,732532,5650
2023,"WESTERN EUROPE-OTHER","SWITZERLAND","GATWICK","ZURICH",174715,174715,0
2023,"WESTERN EUROPE-OTHER","SWITZERLAND","HEATHROW","BALE MULHOUSE",265874,265874,0
2023,"WESTERN EUROPE-OTHER","SWITZERLAND","HEATHROW","GENEVA",1014401,1014401,0
2023,"WESTERN EUROPE-OTHER","SWITZERLAND","HEATHROW","ZURICH",1119529,1119043,486
2023,"WESTERN EUROPE-OTHER","SWITZERLAND","LONDON CITY","GENEVA",104732,104732,0
2023,"WESTERN EUROPE-OTHER","SWITZERLAND","LONDON CITY","ZURICH",355071,355071,0
2023,"WESTERN EUROPE-OTHER","SWITZERLAND","LUTON","BALE MULHOUSE",75,0,75
2023,"WESTERN EUROPE-OTHER","SWITZERLAND","LUTON","GENEVA",331984,331984,0
2023,"WESTERN EUROPE-OTHER","SWITZERLAND","LUTON","ZURICH",60888,60888,0
2023,"WESTERN EUROPE-OTHER","SWITZERLAND","SOUTHEND","GENEVA",2071,2071,0
2023,"WESTERN EUROPE-OTHER","SWITZERLAND","STANSTED","BALE MULHOUSE",1840,1840,0
2023,"WESTERN EUROPE-OTHER","SWITZERLAND","STANSTED","GENEVA",30149,30149,0
2023,"WESTERN EUROPE-OTHER","SWITZERLAND","STANSTED","ZURICH",1636,1528,108
2023,"WESTERN EUROPE-OTHER","TURKEY","GATWICK","ANKARA (ESENBOGA)",11,0,11
2023,"WESTERN EUROPE-OTHER","TURKEY","GATWICK","ANTALYA",694279,596587,97692
2023,"WESTERN EUROPE-OTHER","TURKEY","GATWICK","BODRUM (MILAS)",140446,124884,15562
2023,"WESTERN EUROPE-OTHER","TURKEY","GATWICK","DALAMAN",481238,380462,100776
2023,"WESTERN EUROPE-OTHER","TURKEY","GATWICK","ISTANBUL",433518,433518,0
2023,"WESTERN EUROPE-OTHER","TURKEY","GATWICK","IZMIR (ADNAN MENDERES)",63209,44918,18291
2023,"WESTERN EUROPE-OTHER","TURKEY","GATWICK","KAYSERI  ERKILET",190,190,0
2023,"WESTERN EUROPE-OTHER","TURKEY","HEATHROW","BODRUM (MILAS)",14665,14665,0
2023,"WESTERN EUROPE-OTHER","TURKEY","HEATHROW","DALAMAN",30878,30878,0
2023,"WESTERN EUROPE-OTHER","TURKEY","HEATHROW","ISTANBUL",1231667,1231667,0
2023,"WESTERN EUROPE-OTHER","TURKEY","HEATHROW","ISTANBUL (SABIHA GOKCEN)",36632,36632,0
2023,"WESTERN EUROPE-OTHER","TURKEY","LUTON","ANKARA (ESENBOGA)",0,0,0
2023,"WESTERN EUROPE-OTHER","TURKEY","LUTON","ANTALYA",129533,129236,297
2023,"WESTERN EUROPE-OTHER","TURKEY","LUTON","BODRUM (MILAS)",45771,45771,0
2023,"WESTERN EUROPE-OTHER","TURKEY","LUTON","DALAMAN",96855,86553,10302
2023,"WESTERN EUROPE-OTHER","TURKEY","LUTON","GAZIANTEP",3263,3263,0
2023,"WESTERN EUROPE-OTHER","TURKEY","LUTON","ISTANBUL",116903,116903,0
2023,"WESTERN EUROPE-OTHER","TURKEY","LUTON","ISTANBUL ATATURK",0,0,0
2023,"WESTERN EUROPE-OTHER","TURKEY","LUTON","IZMIR (ADNAN MENDERES)",44050,44050,0
2023,"WESTERN EUROPE-OTHER","TURKEY","STANSTED","ANKARA (ESENBOGA)",63116,63116,0
2023,"WESTERN EUROPE-OTHER","TURKEY","STANSTED","ANTALYA",296057,270003,26054
2023,"WESTERN EUROPE-OTHER","TURKEY","STANSTED","BODRUM (MILAS)",37906,37906,0
2023,"WESTERN EUROPE-OTHER","TURKEY","STANSTED","DALAMAN",161007,137460,23547
2023,"WESTERN EUROPE-OTHER","TURKEY","STANSTED","GAZIANTEP",79,0,79
2023,"WESTERN EUROPE-OTHER","TURKEY","STANSTED","ISTANBUL",0,0,0
2023,"WESTERN EUROPE-OTHER","TURKEY","STANSTED","ISTANBUL (SABIHA GOKCEN)",862443,862443,0
2023,"WESTERN EUROPE-OTHER","TURKEY","STANSTED","IZMIR (ADNAN MENDERES)",137193,137193,0
2023,"WESTERN EUROPE-OTHER","TURKEY","STANSTED","KAYSERI  ERKILET",131,0,131
2023,"WESTERN EUROPE-OTHER","TURKEY","STANSTED","NEVSEHIR KAPADOKYA ",52,0,52
2023,"EASTERN EUROPE-EU","BULGARIA","GATWICK","BURGAS",36089,6343,29746
2023,"EASTERN EUROPE-EU","BULGARIA","GATWICK","SOFIA",120069,112092,7977
2023,"EASTERN EUROPE-EU","BULGARIA","GATWICK","VARNA",7561,7561,0
2023,"EASTERN EUROPE-EU","BULGARIA","HEATHROW","SOFIA",123022,123022,0
2023,"EASTERN EUROPE-EU","BULGARIA","LUTON","BURGAS",102557,102557,0
2023,"EASTERN EUROPE-EU","BULGARIA","LUTON","PLOVDIV",50244,50244,0
2023,"EASTERN EUROPE-EU","BULGARIA","LUTON","SOFIA",315014,315014,0
2023,"EASTERN EUROPE-EU","BULGARIA","LUTON","VARNA",153087,153087,0
2023,"EASTERN EUROPE-EU","BULGARIA","STANSTED","BURGAS",6299,6299,0
2023,"EASTERN EUROPE-EU","BULGARIA","STANSTED","PLOVDIV",63161,63161,0
2023,"EASTERN EUROPE-EU","BULGARIA","STANSTED","SOFIA",306261,306261,0
2023,"EASTERN EUROPE-EU","CZECH REPUBLIC","GATWICK","KARLOVY VARY",0,0,0
2023,"EASTERN EUROPE-EU","CZECH REPUBLIC","GATWICK","OSTRAVA",159,159,0
2023,"EASTERN EUROPE-EU","CZECH REPUBLIC","GATWICK","PRAGUE",138657,138657,0
2023,"EASTERN EUROPE-EU","CZECH REPUBLIC","HEATHROW","PRAGUE",410263,410263,0
2023,"EASTERN EUROPE-EU","CZECH REPUBLIC","LONDON CITY","PRAGUE",12575,12396,179
2023,"EASTERN EUROPE-EU","CZECH REPUBLIC","LUTON","PRAGUE",219253,219253,0
2023,"EASTERN EUROPE-EU","CZECH REPUBLIC","STANSTED","BRNO (TURANY)",110315,110315,0
2023,"EASTERN EUROPE-EU","CZECH REPUBLIC","STANSTED","OSTRAVA",34667,34667,0
2023,"EASTERN EUROPE-EU","CZECH REPUBLIC","STANSTED","PRAGUE",317968,315913,2055
2023,"EASTERN EUROPE-EU","ESTONIA","GATWICK","TALLIN",34985,34985,0
2023,"EASTERN EUROPE-EU","ESTONIA","LUTON","TALLIN",46241,46241,0
2023,"EASTERN EUROPE-EU","ESTONIA","STANSTED","TALLIN",73863,73863,0
2023,"EASTERN EUROPE-EU","HUNGARY","GATWICK","BUDAPEST",201412,201412,0
2023,"EASTERN EUROPE-EU","HUNGARY","HEATHROW","BUDAPEST",295120,295120,0
2023,"EASTERN EUROPE-EU","HUNGARY","LUTON","BUDAPEST",429893,429893,0
2023,"EASTERN EUROPE-EU","HUNGARY","LUTON","DEBRECEN",92389,92389,0
2023,"EASTERN EUROPE-EU","HUNGARY","STANSTED","BUDAPEST",497863,497863,0
2023,"EASTERN EUROPE-EU","LATVIA","GATWICK","RIGA",127188,127188,0
2023,"EASTERN EUROPE-EU","LATVIA","HEATHROW","RIGA",6386,6386,0
2023,"EASTERN EUROPE-EU","LATVIA","LUTON","RIGA",137921,137921,0
2023,"EASTERN EUROPE-EU","LATVIA","STANSTED","RIGA",227057,227057,0
2023,"EASTERN EUROPE-EU","LITHUANIA","GATWICK","VILNIUS",0,0,0
2023,"EASTERN EUROPE-EU","LITHUANIA","LONDON CITY","VILNIUS",42821,42821,0
2023,"EASTERN EUROPE-EU","LITHUANIA","LUTON","KAUNAS",233559,233559,0
2023,"EASTERN EUROPE-EU","LITHUANIA","LUTON","PALANGA",9054,9054,0
2023,"EASTERN EUROPE-EU","LITHUANIA","LUTON","VILNIUS",213031,213031,0
2023,"EASTERN EUROPE-EU","LITHUANIA","STANSTED","KAUNAS",92669,92669,0
2023,"EASTERN EUROPE-EU","LITHUANIA","STANSTED","PALANGA",57284,57284,0
2023,"EASTERN EUROPE-EU","LITHUANIA","STANSTED","VILNIUS",132532,132532,0
2023,"EASTERN EUROPE-EU","POLAND","GATWICK","KRAKOW",248649,247412,1237
2023,"EASTERN EUROPE-EU","POLAND","GATWICK","LUBLIN (PORT LOTNICZY)",0,0,0
2023,"EASTERN EUROPE-EU","POLAND","GATWICK","RZESZOW",0,0,0
2023,"EASTERN EUROPE-EU","POLAND","GATWICK","WARSAW (CHOPIN)",0,0,0
2023,"EASTERN EUROPE-EU","POLAND","HEATHROW","KRAKOW",71525,71525,0
2023,"EASTERN EUROPE-EU","POLAND","HEATHROW","WARSAW (CHOPIN)",554086,554086,0
2023,"EASTERN EUROPE-EU","POLAND","LUTON","BYDGOSZCZ",76476,76476,0
2023,"EASTERN EUROPE-EU","POLAND","LUTON","GDANSK",259802,259802,0
2023,"EASTERN EUROPE-EU","POLAND","LUTON","KATOWICE",244611,244422,189
2023,"EASTERN EUROPE-EU","POLAND","LUTON","KRAKOW",297573,297573,0
2023,"EASTERN EUROPE-EU","POLAND","LUTON","LODZ LUBLINEK",32168,32168,0
2023,"EASTERN EUROPE-EU","POLAND","LUTON","LUBLIN (PORT LOTNICZY)",215573,215573,0
2023,"EASTERN EUROPE-EU","POLAND","LUTON","POZNAN",129296,129296,0
2023,"EASTERN EUROPE-EU","POLAND","LUTON","RZESZOW",54495,54495,0
2023,"EASTERN EUROPE-EU","POLAND","LUTON","SZYMANY (MAZURY)",32705,32705,0
2023,"EASTERN EUROPE-EU","POLAND","LUTON","WARSAW (CHOPIN)",414017,414017,0
2023,"EASTERN EUROPE-EU","POLAND","LUTON","WARSAW (MODLIN MASOVIA)",0,0,0
2023,"EASTERN EUROPE-EU","POLAND","LUTON","WROCLAW",185933,185933,0
2023,"EASTERN EUROPE-EU","POLAND","STANSTED","BYDGOSZCZ",66377,66377,0
2023,"EASTERN EUROPE-EU","POLAND","STANSTED","GDANSK",249436,249436,0
2023,"EASTERN EUROPE-EU","POLAND","STANSTED","KATOWICE",185925,185834,91
2023,"EASTERN EUROPE-EU","POLAND","STANSTED","KRAKOW",340924,339620,1304
2023,"EASTERN EUROPE-EU","POLAND","STANSTED","LODZ LUBLINEK",96083,96083,0
2023,"EASTERN EUROPE-EU","POLAND","STANSTED","LUBLIN (PORT LOTNICZY)",41,0,41
2023,"EASTERN EUROPE-EU","POLAND","STANSTED","POZNAN",156906,156906,0
2023,"EASTERN EUROPE-EU","POLAND","STANSTED","RZESZOW",127433,127348,85
2023,"EASTERN EUROPE-EU","POLAND","STANSTED","SZCZECIN (GOLENOW)",96999,96999,0
2023,"EASTERN EUROPE-EU","POLAND","STANSTED","SZYMANY (MAZURY)",31179,31179,0
2023,"EASTERN EUROPE-EU","POLAND","STANSTED","WARSAW (MODLIN MASOVIA)",361986,361986,0
2023,"EASTERN EUROPE-EU","POLAND","STANSTED","WROCLAW",212760,212760,0
2023,"EASTERN EUROPE-EU","ROMANIA","GATWICK","BRASOV-GHIMBAV",3470,3470,0
2023,"EASTERN EUROPE-EU","ROMANIA","GATWICK","BUCHAREST (OTOPENI)",130770,130130,640
2023,"EASTERN EUROPE-EU","ROMANIA","GATWICK","SIBIU",30,30,0
2023,"EASTERN EUROPE-EU","ROMANIA","HEATHROW","BUCHAREST (OTOPENI)",253023,253023,0
2023,"EASTERN EUROPE-EU","ROMANIA","HEATHROW","IASI",0,0,0
2023,"EASTERN EUROPE-EU","ROMANIA","LUTON","BACAU",150056,150056,0
2023,"EASTERN EUROPE-EU","ROMANIA","LUTON","BRASOV-GHIMBAV",26135,26135,0
2023,"EASTERN EUROPE-EU","ROMANIA","LUTON","BUCHAREST (BANEASA)",0,0,0
2023,"EASTERN EUROPE-EU","ROMANIA","LUTON","BUCHAREST (OTOPENI)",553644,553644,0
2023,"EASTERN EUROPE-EU","ROMANIA","LUTON","CLUJ NAPOCA",272666,272666,0
2023,"EASTERN EUROPE-EU","ROMANIA","LUTON","CONSTANTA",45953,45953,0
2023,"EASTERN EUROPE-EU","ROMANIA","LUTON","CRAIOVA",156128,156128,0
2023,"EASTERN EUROPE-EU","ROMANIA","LUTON","IASI",336821,336821,0
2023,"EASTERN EUROPE-EU","ROMANIA","LUTON","SATU MARE",41227,41227,0
2023,"EASTERN EUROPE-EU","ROMANIA","LUTON","SIBIU",110591,110591,0
2023,"EASTERN EUROPE-EU","ROMANIA","LUTON","SUCEAVA",195030,195030,0
2023,"EASTERN EUROPE-EU","ROMANIA","LUTON","TIMISOARA",141636,141636,0
2023,"EASTERN EUROPE-EU","ROMANIA","LUTON","TIRGU MURES",38716,38716,0
2023,"EASTERN EUROPE-EU","ROMANIA","SOUTHEND","BACAU",0,0,0
2023,"EASTERN EUROPE-EU","ROMANIA","SOUTHEND","BUCHAREST (BANEASA)",0,0,0
2023,"EASTERN EUROPE-EU","ROMANIA","SOUTHEND","BUCHAREST (OTOPENI)",0,0,0
2023,"EASTERN EUROPE-EU","ROMANIA","SOUTHEND","IASI",0,0,0
2023,"EASTERN EUROPE-EU","ROMANIA","STANSTED","BUCHAREST (OTOPENI)",428270,428132,138
2023,"EASTERN EUROPE-EU","ROMANIA","STANSTED","CLUJ NAPOCA",58461,58461,0
2023,"EASTERN EUROPE-EU","ROMANIA","STANSTED","ORADEA",7929,7929,0
2023,"EASTERN EUROPE-EU","SLOVAK REPUBLIC","GATWICK","BRATISLAVA",109,0,109
2023,"EASTERN EUROPE-EU","SLOVAK REPUBLIC","LUTON","BRATISLAVA",92174,92174,0
2023,"EASTERN EUROPE-EU","SLOVAK REPUBLIC","LUTON","KOSICE",93906,93906,0
2023,"EASTERN EUROPE-EU","SLOVAK REPUBLIC","LUTON","TATRY-POPRAD",37101,37101,0
2023,"EASTERN EUROPE-EU","SLOVAK REPUBLIC","STANSTED","BRATISLAVA",113980,113980,0
2023,"EASTERN EUROPE-EU","SLOVAK REPUBLIC","STANSTED","KOSICE",83372,83372,0
2023,"EASTERN EUROPE-EU","SLOVAK REPUBLIC","STANSTED","TATRY-POPRAD",5107,5107,0
2023,"EASTERN EUROPE -OTHER","ALBANIA","GATWICK","TIRANA",47308,44368,2940
2023,"EASTERN EUROPE -OTHER","ALBANIA","HEATHROW","TIRANA",104814,104814,0
2023,"EASTERN EUROPE -OTHER","ALBANIA","LUTON","TIRANA",367116,367116,0
2023,"EASTERN EUROPE -OTHER","ALBANIA","STANSTED","TIRANA",65905,65567,338
2023,"EASTERN EUROPE -OTHER","ARMENIA","LUTON","YEREVAN",0,0,0
2023,"EASTERN EUROPE -OTHER","AZERBAIJAN","HEATHROW","BAKU (HEYDER ALIYEV INT'L)",39411,38715,696
2023,"EASTERN EUROPE -OTHER","KAZAKHSTAN","HEATHROW","AKTAU",23654,23654,0
2023,"EASTERN EUROPE -OTHER","KAZAKHSTAN","HEATHROW","ALMATY",13353,13353,0
2023,"EASTERN EUROPE -OTHER","KAZAKHSTAN","HEATHROW","NURSULTAN NAZERBAYEV INTERNATIONAL",0,0,0
2023,"EASTERN EUROPE -OTHER","REPUBLIC OF MOLDOVA","LUTON","CHISINAU INTERNATIONAL",107502,107502,0
2023,"EASTERN EUROPE -OTHER","REPUBLIC OF MOLDOVA","STANSTED","CHISINAU INTERNATIONAL",62260,62260,0
2023,"EASTERN EUROPE -OTHER","RUSSIA","HEATHROW","MOSCOW (DOMODEDOVO)",0,0,0
2023,"EASTERN EUROPE -OTHER","RUSSIA","HEATHROW","MOSCOW (SHEREMETYEVO)",0,0,0
2023,"EASTERN EUROPE -OTHER","TURKMENISTAN","HEATHROW","ASHKHABAD",693,693,0
2023,"EASTERN EUROPE -OTHER","TURKMENISTAN","STANSTED","ASHKHABAD",1966,1966,0
2023,"EASTERN EUROPE -OTHER","UKRAINE","GATWICK","KIEV (BORISPOL)",0,0,0
2023,"EASTERN EUROPE -OTHER","UKRAINE","LUTON","KIEV (ZHULYANY)",0,0,0
2023,"EASTERN EUROPE -OTHER","UKRAINE","LUTON","LVOV",0,0,0
2023,"EASTERN EUROPE -OTHER","UKRAINE","STANSTED","KIEV (BORISPOL)",0,0,0
2023,"EASTERN EUROPE -OTHER","UKRAINE","STANSTED","LVOV",0,0,0
2023,"EASTERN EUROPE -OTHER","UZBEKISTAN","HEATHROW","TASHKENT",34771,34771,0
2023,"NEAR EAST","ISRAEL","GATWICK","TEL AVIV",111244,111086,158
2023,"NEAR EAST","ISRAEL","HEATHROW","TEL AVIV",688801,688438,363
2023,"NEAR EAST","ISRAEL","LUTON","RAMON",136,0,136
2023,"NEAR EAST","ISRAEL","LUTON","TEL AVIV",375665,375665,0
2023,"NEAR EAST","ISRAEL","STANSTED","TEL AVIV",0,0,0
2023,"NEAR EAST","JORDAN","GATWICK","AQABA",5868,5722,146
2023,"NEAR EAST","JORDAN","HEATHROW","AMMAN",242929,242929,0
2023,"NEAR EAST","JORDAN","LUTON","AMMAN",71041,71041,0
2023,"NEAR EAST","JORDAN","STANSTED","AQABA",0,0,0
2023,"NEAR EAST","LEBANON","HEATHROW","BEIRUT",181453,181453,0
2023,"NEAR EAST","LEBANON","STANSTED","BEIRUT",0,0,0
2023,"NORTH AFRICA","ALGERIA","GATWICK","ALGIERS",12558,12558,0
2023,"NORTH AFRICA","ALGERIA","GATWICK","HASSI MESSAOUD",0,0,0
2023,"NORTH AFRICA","ALGERIA","HEATHROW","ALGIERS",146439,146439,0
2023,"NORTH AFRICA","ALGERIA","STANSTED","ALGIERS",0,0,0
2023,"NORTH AFRICA","EGYPT","GATWICK","HURGHADA",186267,186267,0
2023,"NORTH AFRICA","EGYPT","GATWICK","MARSA ALAM",3538,3538,0
2023,"NORTH AFRICA","EGYPT","GATWICK","SHARM EL SHEIKH (OPHIRA)",184074,183696,378
2023,"NORTH AFRICA","EGYPT","HEATHROW","CAIRO",543116,543116,0
2023,"NORTH AFRICA","EGYPT","HEATHROW","LUXOR",8716,8716,0
2023,"NORTH AFRICA","EGYPT","HEATHROW","SHARM EL SHEIKH (OPHIRA)",0,0,0
2023,"NORTH AFRICA","EGYPT","LUTON","CAIRO WEST AFB",156,156,0
2023,"NORTH AFRICA","EGYPT","LUTON","HURGHADA",84346,84346,0
2023,"NORTH AFRICA","EGYPT","LUTON","SHARM EL SHEIKH (OPHIRA)",79980,79980,0
2023,"NORTH AFRICA","EGYPT","LUTON","SPHINX INTERNATIONAL",16892,16892,0
2023,"NORTH AFRICA","EGYPT","STANSTED","SHARM EL SHEIKH (OPHIRA)",18376,18376,0
2023,"NORTH AFRICA","MOROCCO","GATWICK","AGADIR (AL MASSIRA)",138807,138807,0
2023,"NORTH AFRICA","MOROCCO","GATWICK","CASABLANCA MOHAMED V",86566,86566,0
2023,"NORTH AFRICA","MOROCCO","GATWICK","ERRACHIDIA",0,0,0
2023,"NORTH AFRICA","MOROCCO","GATWICK","MARRAKESH",501591,501591,0
2023,"NORTH AFRICA","MOROCCO","GATWICK","OUARZAZATE",262,0,262
2023,"NORTH AFRICA","MOROCCO","GATWICK","TANGIERS (IBN BATUTA)",47560,47560,0
2023,"NORTH AFRICA","MOROCCO","HEATHROW","CASABLANCA MOHAMED V",132148,132148,0
2023,"NORTH AFRICA","MOROCCO","HEATHROW","MARRAKESH",60914,60914,0
2023,"NORTH AFRICA","MOROCCO","HEATHROW","RABAT",0,0,0
2023,"NORTH AFRICA","MOROCCO","LUTON","AGADIR (AL MASSIRA)",33246,33246,0
2023,"NORTH AFRICA","MOROCCO","LUTON","MARRAKESH",41833,41833,0
2023,"NORTH AFRICA","MOROCCO","LUTON","RABAT",181,181,0
2023,"NORTH AFRICA","MOROCCO","STANSTED","AGADIR (AL MASSIRA)",56304,56304,0
2023,"NORTH AFRICA","MOROCCO","STANSTED","ESSAOUIRA",30729,30729,0
2023,"NORTH AFRICA","MOROCCO","STANSTED","FEZ",35076,35076,0
2023,"NORTH AFRICA","MOROCCO","STANSTED","MARRAKESH",189191,189028,163
2023,"NORTH AFRICA","MOROCCO","STANSTED","OUARZAZATE",17055,17055,0
2023,"NORTH AFRICA","MOROCCO","STANSTED","RABAT",49905,49905,0
2023,"NORTH AFRICA","MOROCCO","STANSTED","TANGIERS (IBN BATUTA)",37424,37424,0
2023,"NORTH AFRICA","TUNISIA","GATWICK","ENFIDHA - HAMMAMET INTL",111233,79535,31698
2023,"NORTH AFRICA","TUNISIA","GATWICK","TUNIS",71735,71735,0
2023,"NORTH AFRICA","TUNISIA","HEATHROW","TUNIS",25851,25851,0
2023,"NORTH AFRICA","TUNISIA","LUTON","ENFIDHA - HAMMAMET INTL",22500,6945,15555
2023,"NORTH AFRICA","TUNISIA","LUTON","TUNIS",0,0,0
2023,"NORTH AFRICA","TUNISIA","STANSTED","TUNIS",972,972,0
2023,"EAST AFRICA","ETHIOPIA","GATWICK","ADDIS ABABA",8832,8832,0
2023,"EAST AFRICA","ETHIOPIA","HEATHROW","ADDIS ABABA",228092,228092,0
2023,"EAST AFRICA","KENYA","HEATHROW","NAIROBI",435856,435856,0
2023,"EAST AFRICA","RWANDA","HEATHROW","KIGALI",79843,79843,0
2023,"EAST AFRICA","SUDAN","GATWICK","KHARTOUM",690,690,0
2023,"WEST AFRICA","GAMBIA","GATWICK","BANJUL",33409,446,32963
2023,"WEST AFRICA","GAMBIA","HEATHROW","BANJUL",0,0,0
2023,"WEST AFRICA","GHANA","GATWICK","ACCRA",14237,14237,0
2023,"WEST AFRICA","GHANA","HEATHROW","ACCRA",217635,217635,0
2023,"WEST AFRICA","NIGERIA","GATWICK","LAGOS",0,0,0
2023,"WEST AFRICA","NIGERIA","HEATHROW","ABUJA",148340,148340,0
2023,"WEST AFRICA","NIGERIA","HEATHROW","LAGOS",377559,377559,0
2023,"WEST AFRICA","SENEGAL","GATWICK","DAKAR",0,0,0
2023,"WEST AFRICA","SENEGAL","GATWICK","DAKAR (BLAISE DIAGNE)",9763,0,9763
2023,"SOUTHERN AFRICA","REPUBLIC OF SOUTH AFRICA","GATWICK","CAPE TOWN",35193,35193,0
2023,"SOUTHERN AFRICA","REPUBLIC OF SOUTH AFRICA","HEATHROW","CAPE TOWN",338125,337638,487
2023,"SOUTHERN AFRICA","REPUBLIC OF SOUTH AFRICA","HEATHROW","JOHANNESBURG",735326,735326,0
2023,"SOUTHERN AFRICA","ZIMBABWE","GATWICK","ROBERT GABRIEL MUGABE INTERNATIONAL",0,0,0
2023,"MIDDLE EAST","BAHRAIN","HEATHROW","BAHRAIN",485861,485861,0
2023,"MIDDLE EAST","IRAN","HEATHROW","TEHRAN IMAM KHOMEINI",50350,50350,0
2023,"MIDDLE EAST","IRAQ","GATWICK","BAGHDAD (GECA)",0,0,0
2023,"MIDDLE EAST","IRAQ","GATWICK","SULAYMANIYAH INT",0,0,0
2023,"MIDDLE EAST","KUWAIT","HEATHROW","KUWAIT",440017,440017,0
2023,"MIDDLE EAST","OMAN","GATWICK","MUSCAT",345,0,345
2023,"MIDDLE EAST","OMAN","HEATHROW","MUSCAT",159946,159946,0
2023,"MIDDLE EAST","OMAN","STANSTED","MUSCAT",0,0,0
2023,"MIDDLE EAST","QATAR","GATWICK","DOHA HAMAD",416602,416602,0
2023,"MIDDLE EAST","QATAR","HEATHROW","DOHA HAMAD",1712158,1712158,0
2023,"MIDDLE EAST","QATAR","STANSTED","DOHA INTERNATIONAL",231,0,231
2023,"MIDDLE EAST","SAUDI ARABIA","GATWICK","JEDDAH",70841,70841,0
2023,"MIDDLE EAST","SAUDI ARABIA","GATWICK","RIYADH",0,0,0
2023,"MIDDLE EAST","SAUDI ARABIA","HEATHROW","JEDDAH",206830,205770,1060
2023,"MIDDLE EAST","SAUDI ARABIA","HEATHROW","NEOM BAY",13430,13430,0
2023,"MIDDLE EAST","SAUDI ARABIA","HEATHROW","RIYADH",536423,536328,95
2023,"MIDDLE EAST","UNITED ARAB EMIRATES","GATWICK","ABU DHABI - BATEEN",2,0,2
2023,"MIDDLE EAST","UNITED ARAB EMIRATES","GATWICK","DUBAI",969662,969662,0
2023,"MIDDLE EAST","UNITED ARAB EMIRATES","GATWICK","DUBAI (WORLD CENTRAL)",0,0,0
2023,"MIDDLE EAST","UNITED ARAB EMIRATES","GATWICK","SHARJAH",0,0,0
2023,"MIDDLE EAST","UNITED ARAB EMIRATES","HEATHROW","ABU DHABI INTERNATIONAL",887457,886890,567
2023,"MIDDLE EAST","UNITED ARAB EMIRATES","HEATHROW","DUBAI",2438593,2438593,0
2023,"MIDDLE EAST","UNITED ARAB EMIRATES","STANSTED","DUBAI",365575,365575,0
2023,"INDIAN SUB-CONTINENT","BANGLADESH","HEATHROW","DHAKHA",22617,22617,0
2023,"INDIAN SUB-CONTINENT","BANGLADESH","HEATHROW","SYLHET",96443,96443,0
2023,"INDIAN SUB-CONTINENT","INDIA","GATWICK","AHMEDABAD",56972,56972,0
2023,"INDIAN SUB-CONTINENT","INDIA","GATWICK","AMRITSAR",53331,53331,0
2023,"INDIAN SUB-CONTINENT","INDIA","GATWICK","COCHIN",58105,58105,0
2023,"INDIAN SUB-CONTINENT","INDIA","GATWICK","DELHI",232,232,0
2023,"INDIAN SUB-CONTINENT","INDIA","GATWICK","GOA",27418,20760,6658
2023,"INDIAN SUB-CONTINENT","INDIA","GATWICK","GOA INTERNATIONAL",34419,27515,6904
2023,"INDIAN SUB-CONTINENT","INDIA","GATWICK","MUMBAI",8,8,0
2023,"INDIAN SUB-CONTINENT","INDIA","HEATHROW","AHMEDABAD",22797,22797,0
2023,"INDIAN SUB-CONTINENT","INDIA","HEATHROW","AMRITSAR",17127,17127,0
2023,"INDIAN SUB-CONTINENT","INDIA","HEATHROW","BANGALORE (BENGALURU)",166693,166693,0
2023,"INDIAN SUB-CONTINENT","INDIA","HEATHROW","CHENNAI",137389,137389,0
2023,"INDIAN SUB-CONTINENT","INDIA","HEATHROW","COCHIN",16991,16991,0
2023,"INDIAN SUB-CONTINENT","INDIA","HEATHROW","DELHI",1284213,1284213,0
2023,"INDIAN SUB-CONTINENT","INDIA","HEATHROW","GOA",17280,17280,0
2023,"INDIAN SUB-CONTINENT","INDIA","HEATHROW","HYDERABAD ( RAJIV GHANDI )",153165,153165,0
2023,"INDIAN SUB-CONTINENT","INDIA","HEATHROW","KOLKATA",0,0,0
2023,"INDIAN SUB-CONTINENT","INDIA","HEATHROW","MUMBAI",1083003,1083003,0
2023,"INDIAN SUB-CONTINENT","PAKISTAN","GATWICK","BENAZIR BHUTTO INTERNATIONAL AIRPORT",0,0,0
2023,"INDIAN SUB-CONTINENT","PAKISTAN","HEATHROW","ISLAMABAD INTERNATIONAL AIRPORT",100114,100114,0
2023,"INDIAN SUB-CONTINENT","PAKISTAN","HEATHROW","LAHORE",34065,34065,0
2023,"INDIAN SUB-CONTINENT","SRI LANKA","GATWICK","COLOMBO",209,0,209
2023,"INDIAN SUB-CONTINENT","SRI LANKA","HEATHROW","COLOMBO",217406,217406,0
2023,"FAR EAST","BRUNEI","HEATHROW","BANDAR SERI BEGAWAN",39610,39610,0
2023,"FAR EAST","CHINA","GATWICK","BEIJING",18293,18293,0
2023,"FAR EAST","CHINA","GATWICK","SHANGHAI (PU DONG)",131619,131619,0
2023,"FAR EAST","CHINA","GATWICK","ZHENGZHOU XINZHENG",1893,1893,0
2023,"FAR EAST","CHINA","HEATHROW","BEIJING",190419,190419,0
2023,"FAR EAST","CHINA","HEATHROW","BEIJING DAXING INTERNATIONAL AIRPORT",151619,151619,0
2023,"FAR EAST","CHINA","HEATHROW","CHANGSHA HUANGHUA INTERNATIONAL AIRPORT",25872,25872,0
2023,"FAR EAST","CHINA","HEATHROW","CHENGDU TIANFU",34452,34452,0
2023,"FAR EAST","CHINA","HEATHROW","CHONGQING JIANGBEI INTERNATIONAL",18914,18914,0
2023,"FAR EAST","CHINA","HEATHROW","GUANGZHOU BAIYUN INTERNATIONAL",137324,137324,0
2023,"FAR EAST","CHINA","HEATHROW","HAIKOU",1724,1724,0
2023,"FAR EAST","CHINA","HEATHROW","QINGDAO",30844,30844,0
2023,"FAR EAST","CHINA","HEATHROW","SHANGHAI (PU DONG)",351077,351077,0
2023,"FAR EAST","CHINA","HEATHROW","SHENZHEN (HUANGTIAN)",68539,68539,0
2023,"FAR EAST","CHINA","HEATHROW","TIANJIN",4719,4719,0
2023,"FAR EAST","CHINA","HEATHROW","WUHAN TIANHE INTERNATIONAL",8126,8126,0
2023,"FAR EAST","CHINA","HEATHROW","XIAN XIANYANG",25299,25299,0
2023,"FAR EAST","HONG KONG","HEATHROW","HONG KONG (CHEK LAP KOK)",1184050,1184050,0
2023,"FAR EAST","JAPAN","HEATHROW","NAGOYA",277,0,277
2023,"FAR EAST","JAPAN","HEATHROW","TOKYO (HANEDA)",580113,580113,0
2023,"FAR EAST","MALAYSIA","GATWICK","KUALA LUMPUR (SEPANG)",0,0,0
2023,"FAR EAST","MALAYSIA","HEATHROW","KUALA LUMPUR (SEPANG)",362193,362193,0
2023,"FAR EAST","PHILIPPINES","HEATHROW","MANILA",0,0,0
2023,"FAR EAST","REPUBLIC OF KOREA","HEATHROW","SEOUL (INCHEON)",353945,353945,0
2023,"FAR EAST","SINGAPORE","GATWICK","SINGAPORE",1575,0,1575
2023,"FAR EAST","SINGAPORE","HEATHROW","SINGAPORE",1426108,1425090,1018
2023,"FAR EAST","TAIWAN","HEATHROW","TAIPEI",130470,130470,0
2023,"FAR EAST","THAILAND","GATWICK","BANGKOK SUVARNABHUMI ",0,0,0
2023,"FAR EAST","THAILAND","GATWICK","PHUKET",13422,0,13422
2023,"FAR EAST","THAILAND","HEATHROW","BANGKOK SUVARNABHUMI ",617042,617042,0
2023,"FAR EAST","VIETNAM","GATWICK","HANOI",21795,21795,0
2023,"FAR EAST","VIETNAM","GATWICK","HO CHI MINH CITY",18144,18144,0
2023,"FAR EAST","VIETNAM","HEATHROW","HANOI",75086,75086,0
2023,"FAR EAST","VIETNAM","HEATHROW","HO CHI MINH CITY",51566,51566,0
2023,"AUSTRALASIA","AUSTRALIA","HEATHROW","DARWIN",0,0,0
2023,"AUSTRALASIA","AUSTRALIA","HEATHROW","MELBOURNE",12993,12993,0
2023,"AUSTRALASIA","AUSTRALIA","HEATHROW","PERTH (AUSTRALIA)",142204,141573,631
2023,"AUSTRALASIA","AUSTRALIA","HEATHROW","SYDNEY",180033,178666,1367
2023,"CANADA","CANADA","GATWICK","CALGARY",102583,102583,0
2023,"CANADA","CANADA","GATWICK","HALIFAX INT",0,0,0
2023,"CANADA","CANADA","GATWICK","MONTREAL (DORVAL)",77799,77799,0
2023,"CANADA","CANADA","GATWICK","OTTAWA INTERNATIONAL",0,0,0
2023,"CANADA","CANADA","GATWICK","QUEBEC",4108,4108,0
2023,"CANADA","CANADA","GATWICK","TORONTO",215113,215113,0
2023,"CANADA","CANADA","GATWICK","VANCOUVER",63447,63447,0
2023,"CANADA","CANADA","HEATHROW","CALGARY",406289,406289,0
2023,"CANADA","CANADA","HEATHROW","HALIFAX INT",96464,96464,0
2023,"CANADA","CANADA","HEATHROW","MONTREAL (DORVAL)",425542,425542,0
2023,"CANADA","CANADA","HEATHROW","ST JOHNS",94,94,0
2023,"CANADA","CANADA","HEATHROW","TORONTO",1109113,1109113,0
2023,"CANADA","CANADA","HEATHROW","VANCOUVER",479517,479517,0
2023,"CANADA","CANADA","STANSTED","TORONTO",0,0,0
2023,"UNITED STATES OF AMERICA","USA","GATWICK","BOSTON",76579,76579,0
2023,"UNITED STATES OF AMERICA","USA","GATWICK","BUFFALO",0,0,0
2023,"UNITED STATES OF AMERICA","USA","GATWICK","FORT LAUDERDALE",31620,31620,0
2023,"UNITED STATES OF AMERICA","USA","GATWICK","LAS VEGAS",55318,55318,0
2023,"UNITED STATES OF AMERICA","USA","GATWICK","LOS ANGELES INTERNATIONAL",67115,67115,0
2023,"UNITED STATES OF AMERICA","USA","GATWICK","MELBOURNE FLATS",46891,0,46891
2023,"UNITED STATES OF AMERICA","USA","GATWICK","MIAMI INTERNATIONAL",24926,24926,0
2023,"UNITED STATES OF AMERICA","USA","GATWICK","NEW YORK (JF KENNEDY)",513780,513780,0
2023,"UNITED STATES OF AMERICA","USA","GATWICK","NEWBURGH/USA",491,491,0
2023,"UNITED STATES OF AMERICA","USA","GATWICK","ORLANDO",413249,413249,0
2023,"UNITED STATES OF AMERICA","USA","GATWICK","SAN FRANCISCO",22430,22430,0
2023,"UNITED STATES OF AMERICA","USA","GATWICK","TAMPA",161215,161215,0
2023,"UNITED STATES OF AMERICA","USA","GATWICK","WASHINGTON (DULLES)",49913,49913,0
2023,"UNITED STATES OF AMERICA","USA","HEATHROW","ATLANTA",604444,604090,354
2023,"UNITED STATES OF AMERICA","USA","HEATHROW","AUSTIN (BERGSTROM)",247743,247743,0
2023,"UNITED STATES OF AMERICA","USA","HEATHROW","BALTIMORE",106145,105956,189
2023,"UNITED STATES OF AMERICA","USA","HEATHROW","BOSTON",1019027,1019027,0
2023,"UNITED STATES OF AMERICA","USA","HEATHROW","BUFFALO",154,0,154
2023,"UNITED STATES OF AMERICA","USA","HEATHROW","CHARLOTTE",452702,452702,0
2023,"UNITED STATES OF AMERICA","USA","HEATHROW","CHICAGO (O'HARE)",1093196,1093196,0
2023,"UNITED STATES OF AMERICA","USA","HEATHROW","CINCINNATI",46571,46571,0
2023,"UNITED STATES OF AMERICA","USA","HEATHROW","DALLAS/FORT WORTH",871297,871297,0
2023,"UNITED STATES OF AMERICA","USA","HEATHROW","DENVER INTERNATIONAL",413124,413124,0
2023,"UNITED STATES OF AMERICA","USA","HEATHROW","DETROIT",193658,193658,0
2023,"UNITED STATES OF AMERICA","USA","HEATHROW","GREEN BAY WISCONSIN",0,0,0
2023,"UNITED STATES OF AMERICA","USA","HEATHROW","HOUSTON",522988,522988,0
2023,"UNITED STATES OF AMERICA","USA","HEATHROW","LAS VEGAS",381972,381405,567
2023,"UNITED STATES OF AMERICA","USA","HEATHROW","LOS ANGELES INTERNATIONAL",1662464,1662464,0
2023,"UNITED STATES OF AMERICA","USA","HEATHROW","MIAMI INTERNATIONAL",974659,974659,0
2023,"UNITED STATES OF AMERICA","USA","HEATHROW","MINNEAPOLIS-ST PAUL",131275,131275,0
2023,"UNITED STATES OF AMERICA","USA","HEATHROW","NASHVILLE METROPOLITAN",116655,116471,184
2023,"UNITED STATES OF AMERICA","USA","HEATHROW","NEW ORLEANS",74771,74771,0
2023,"UNITED STATES OF AMERICA","USA","HEATHROW","NEW YORK (JF KENNEDY)",3073200,3073200,0
2023,"UNITED STATES OF AMERICA","USA","HEATHROW","NEW YORK (NEWARK)",1056347,1056347,0
2023,"UNITED STATES OF AMERICA","USA","HEATHROW","ORLANDO",298414,297448,966
2023,"UNITED STATES OF AMERICA","USA","HEATHROW","PHILADELPHIA INTERNATIONAL",424998,424998,0
2023,"UNITED STATES OF AMERICA","USA","HEATHROW","PHOENIX",324416,324416,0
2023,"UNITED STATES OF AMERICA","USA","HEATHROW","PITTSBURGH",83548,83548,0
2023,"UNITED STATES OF AMERICA","USA","HEATHROW","PORTLAND (OREGON)",112610,112610,0
2023,"UNITED STATES OF AMERICA","USA","HEATHROW","RALEIGH",128462,128462,0
2023,"UNITED STATES OF AMERICA","USA","HEATHROW","SALT LAKE CITY",123222,123222,0
2023,"UNITED STATES OF AMERICA","USA","HEATHROW","SAN DIEGO",207088,207088,0
2023,"UNITED STATES OF AMERICA","USA","HEATHROW","SAN FRANCISCO",1065276,1065276,0
2023,"UNITED STATES OF AMERICA","USA","HEATHROW","SAN JOSE",71924,71924,0
2023,"UNITED STATES OF AMERICA","USA","HEATHROW","SEATTLE (TACOMA)",596386,596386,0
2023,"UNITED STATES OF AMERICA","USA","HEATHROW","TAMPA",135724,135724,0
2023,"UNITED STATES OF AMERICA","USA","HEATHROW","WASHINGTON (DULLES)",829785,829785,0
2023,"UNITED STATES OF AMERICA","USA","STANSTED","CINCINNATI",0,0,0
2023,"UNITED STATES OF AMERICA","USA","STANSTED","NEW YORK (NEWARK)",0,0,0
2023,"UNITED STATES OF AMERICA","USA","STANSTED","ORLANDO",0,0,0
2023,"CENTRAL AMERICA","COSTA RICA","GATWICK","LIBERIA",9969,0,9969
2023,"CENTRAL AMERICA","COSTA RICA","GATWICK","SAN JOSE COST RICA",38076,38076,0
2023,"CENTRAL AMERICA","DOMINICAN REPUBLIC","GATWICK","PUNTA CANA",191984,101034,90950
2023,"CENTRAL AMERICA","MEXICO","GATWICK","CANCUN",385678,385678,0
2023,"CENTRAL AMERICA","MEXICO","GATWICK","PUERTO VALLARTA",805,0,805
2023,"CENTRAL AMERICA","MEXICO","HEATHROW","CANCUN",0,0,0
2023,"CENTRAL AMERICA","MEXICO","HEATHROW","MEXICO CITY",285507,285507,0
2023,"SOUTH AMERICA","ARGENTINA","HEATHROW","BUENOS AIRES",98015,98015,0
2023,"SOUTH AMERICA","BRAZIL","HEATHROW","RIO DE JANEIRO (GALEAO)",99890,99890,0
2023,"SOUTH AMERICA","BRAZIL","HEATHROW","SAO PAULO (GUARULHOS)",496215,496215,0
2023,"SOUTH AMERICA","CHILE","HEATHROW","SANTIAGO DE CHILE",73455,73455,0
2023,"SOUTH AMERICA","COLOMBIA","HEATHROW","BOGOTA",165827,165827,0
2023,"SOUTH AMERICA","GUYANA","GATWICK","GEORGETOWN (GUYANA)",17045,17045,0
2023,"SOUTH AMERICA","PERU","HEATHROW","JORGE CHAVEZ INTERNATIONAL",181,181,0
2023,"CARIBBEAN AREA","ANTIGUA AND BARBUDA","GATWICK","ANTIGUA",133150,130563,2587
2023,"CARIBBEAN AREA","ANTIGUA AND BARBUDA","HEATHROW","ANTIGUA",43633,39831,3802
2023,"CARIBBEAN AREA","BAHAMAS","HEATHROW","NASSAU",109523,109523,0
2023,"CARIBBEAN AREA","BARBADOS","GATWICK","BRIDGETOWN",161770,66110,95660
2023,"CARIBBEAN AREA","BARBADOS","HEATHROW","BRIDGETOWN",367985,364461,3524
2023,"CARIBBEAN AREA","BARBADOS","STANSTED","BRIDGETOWN",537,0,537
2023,"CARIBBEAN AREA","BERMUDA","HEATHROW","BERMUDA",109325,109325,0
2023,"CARIBBEAN AREA","CAYMAN ISLANDS","HEATHROW","GRAND CAYMAN",55120,55120,0
2023,"CARIBBEAN AREA","GRENADA","GATWICK","GRENADA",41069,41069,0
2023,"CARIBBEAN AREA","GRENADA","HEATHROW","GRENADA",11263,11263,0
2023,"CARIBBEAN AREA","ISLE OF CURACAO NETH.ANTILLES","GATWICK","ARUBA",6550,6550,0
2023,"CARIBBEAN AREA","JAMAICA","GATWICK","KINGSTON",96406,96406,0
2023,"CARIBBEAN AREA","JAMAICA","GATWICK","MONTEGO BAY",100115,5690,94425
2023,"CARIBBEAN AREA","JAMAICA","HEATHROW","MONTEGO BAY",97716,97716,0
2023,"CARIBBEAN AREA","SAINT KITTS AND NEVIS","GATWICK","ST KITTS",19264,19264,0
2023,"CARIBBEAN AREA","SAINT VINCENT AND THE GRENADINES","HEATHROW","E T JOSHUA",8372,8372,0
2023,"CARIBBEAN AREA","ST LUCIA","GATWICK","ST LUCIA (HEWANORRA)",154742,126544,28198
2023,"CARIBBEAN AREA","ST LUCIA","HEATHROW","ST LUCIA (HEWANORRA)",18650,18650,0
2023,"CARIBBEAN AREA","TRINIDAD AND TOBAGO","GATWICK","PORT OF SPAIN",80451,80451,0
2023,"CARIBBEAN AREA","TRINIDAD AND TOBAGO","GATWICK","TOBAGO",20738,20738,0
2023,"CARIBBEAN AREA","TRINIDAD AND TOBAGO","HEATHROW","TOBAGO",139,139,0
2023,"CARIBBEAN AREA","TURKS AND CAICOS ISLANDS","GATWICK","PROVIDENCIALES",2023,2023,0
2023,"CARIBBEAN AREA","TURKS AND CAICOS ISLANDS","HEATHROW","PROVIDENCIALES",20119,20119,0
2023,"INDIAN OCEAN ISLANDS","MALDIVE ISLANDS","HEATHROW","MALE INTERNATIONAL",118933,118933,0
2023,"INDIAN OCEAN ISLANDS","MAURITIUS","GATWICK","MAURITIUS",125891,125891,0
2023,"INDIAN OCEAN ISLANDS","MAURITIUS","HEATHROW","MAURITIUS",120298,120298,0
2023,"ATLANTIC OCEAN ISLANDS","ASCENSION ISLAND","STANSTED","SAINT HELENA",0,0,0
2023,"ATLANTIC OCEAN ISLANDS","CAPE VERDE ISLANDS","GATWICK","BOA VISTA (RABIL)",74140,74140,0
2023,"ATLANTIC OCEAN ISLANDS","CAPE VERDE ISLANDS","GATWICK","ILHA DO SAL C.VERDE",74822,74403,419
2023,"ATLANTIC OCEAN ISLANDS","CAPE VERDE ISLANDS","GATWICK","PRAIA",0,0,0
2023,"ATLANTIC OCEAN ISLANDS","GREENLAND","STANSTED","SONDRE STROMFJORD",192,0,192
